date,breakouts,gate_pass,gate_block,ev_pass,ev_reject,fills,wins,pnl_pips
2018-01-01,9,0,9,0,0,0,0,0.0
2018-01-02,209,111,98,3,100,11,10,12.154285714284867
2018-01-03,172,133,39,0,133,0,0,0.0
2018-01-04,204,91,113,1,90,1,1,1.064285714286484
2018-01-05,245,149,96,0,149,0,0,0.0
2018-01-07,12,0,12,0,0,0,0,0.0
2018-01-08,203,115,88,0,115,0,0,0.0
2018-01-09,228,120,108,0,120,0,0,0.0
2018-01-10,186,87,99,1,86,1,0,-4.814285714285404
2018-01-11,205,103,102,1,102,1,1,2.764285714286075
2018-01-12,173,116,57,1,115,1,1,3.6285714285706376
2018-01-14,16,0,16,0,0,0,0,0.0
2018-01-15,201,95,106,1,94,1,0,-5.845714285714109
2018-01-16,197,88,109,0,88,0,0,0.0
2018-01-17,195,94,101,1,93,1,1,1.4428571428576902
2018-01-18,184,100,84,1,99,1,0,-4.379999999999484
2018-01-19,109,21,88,1,20,1,0,-5.019999999999413
2018-01-21,12,0,12,0,0,0,0,0.0
2018-01-22,237,127,110,0,127,0,0,0.0
2018-01-23,196,101,95,1,100,1,1,4.54285714285686
2018-01-24,200,95,105,1,94,1,0,-6.531428571428421
2018-01-25,203,100,103,1,99,1,1,9.421428571428237
2018-01-26,181,104,77,1,103,1,0,-6.28000000000003
2018-01-28,10,0,10,0,0,0,0,0.0
2018-01-29,235,141,94,0,141,0,0,0.0
2018-01-30,238,140,98,0,140,0,0,0.0
2018-01-31,220,125,95,0,125,0,0,0.0
2018-02-01,250,141,109,0,141,0,0,0.0
2018-02-02,241,147,94,0,147,0,0,0.0
2018-02-04,12,0,12,0,0,0,0,0.0
2018-02-05,215,104,111,0,104,0,0,0.0
2018-02-06,181,71,110,1,70,1,0,-9.028571428571752
2018-02-07,241,138,103,0,138,0,0,0.0
2018-02-08,186,116,70,0,116,0,0,0.0
2018-02-09,224,130,94,0,130,0,0,0.0
2018-02-11,14,0,14,0,0,0,0,0.0
2018-02-12,235,122,113,0,122,0,0,0.0
2018-02-13,211,105,106,0,105,0,0,0.0
2018-02-14,246,140,106,0,140,0,0,0.0
2018-02-15,244,133,111,0,133,0,0,0.0
2018-02-16,210,117,93,0,117,0,0,0.0
2018-02-18,17,0,17,0,0,0,0,0.0
2018-02-19,175,75,100,0,75,0,0,0.0
2018-02-20,242,133,109,0,133,0,0,0.0
2018-02-21,261,153,108,0,153,0,0,0.0
2018-02-22,254,140,114,0,140,0,0,0.0
2018-02-23,220,124,96,0,124,0,0,0.0
2018-02-25,5,0,5,0,0,0,0,0.0
2018-02-26,225,119,106,0,119,0,0,0.0
2018-02-27,184,111,73,0,111,0,0,0.0
2018-02-28,212,107,105,0,107,0,0,0.0
2018-03-01,258,151,107,0,151,0,0,0.0
2018-03-02,226,135,91,0,135,0,0,0.0
2018-03-04,6,0,6,0,0,0,0,0.0
2018-03-05,182,152,30,0,152,0,0,0.0
2018-03-06,235,124,111,0,124,0,0,0.0
2018-03-07,189,78,111,0,78,0,0,0.0
2018-03-08,194,88,106,0,88,0,0,0.0
2018-03-09,206,110,96,0,110,0,0,0.0
2018-03-11,26,12,14,0,12,0,0,0.0
2018-03-12,195,85,110,0,85,0,0,0.0
2018-03-13,251,143,108,0,143,0,0,0.0
2018-03-14,242,149,93,0,149,0,0,0.0
2018-03-15,246,141,105,0,141,0,0,0.0
2018-03-16,214,118,96,0,118,0,0,0.0
2018-03-18,20,12,8,0,12,0,0,0.0
2018-03-19,254,144,110,0,144,0,0,0.0
2018-03-20,200,94,106,0,94,0,0,0.0
2018-03-21,248,137,111,0,137,0,0,0.0
2018-03-22,239,125,114,0,125,0,0,0.0
2018-03-23,213,117,96,0,117,0,0,0.0
2018-03-25,20,12,8,0,12,0,0,0.0
2018-03-26,207,106,101,0,106,0,0,0.0
2018-03-27,247,143,104,0,143,0,0,0.0
2018-03-28,245,141,104,0,141,0,0,0.0
2018-03-29,246,141,105,0,141,0,0,0.0
2018-03-30,164,69,95,0,69,0,0,0.0
2018-04-01,8,6,2,0,6,0,0,0.0
2018-04-02,163,136,27,0,136,0,0,0.0
2018-04-03,198,94,104,0,94,0,0,0.0
2018-04-04,196,118,78,0,118,0,0,0.0
2018-04-05,261,151,110,0,151,0,0,0.0
2018-04-06,176,81,95,0,81,0,0,0.0
2018-04-08,19,12,7,0,12,0,0,0.0
2018-04-09,182,121,61,0,121,0,0,0.0
2018-04-10,219,112,107,0,112,0,0,0.0
2018-04-11,190,77,113,0,77,0,0,0.0
2018-04-12,192,78,114,0,78,0,0,0.0
2018-04-13,240,144,96,0,144,0,0,0.0
2018-04-15,12,12,0,0,12,0,0,0.0
2018-04-16,231,127,104,0,127,0,0,0.0
2018-04-17,251,144,107,0,144,0,0,0.0
2018-04-18,227,116,111,0,116,0,0,0.0
2018-04-19,228,123,105,0,123,0,0,0.0
2018-04-20,228,133,95,0,133,0,0,0.0
2018-04-22,22,12,10,0,12,0,0,0.0
2018-04-23,257,155,102,0,155,0,0,0.0
2018-04-24,223,124,99,0,124,0,0,0.0
2018-04-25,242,149,93,0,149,0,0,0.0
2018-04-26,248,143,105,0,143,0,0,0.0
2018-04-27,195,101,94,0,101,0,0,0.0
2018-04-29,28,12,16,0,12,0,0,0.0
2018-04-30,182,104,78,0,104,0,0,0.0
2018-05-01,258,145,113,0,145,0,0,0.0
2018-05-02,240,129,111,0,129,0,0,0.0
2018-05-03,263,150,113,0,150,0,0,0.0
2018-05-04,212,118,94,0,118,0,0,0.0
2018-05-06,25,12,13,0,12,0,0,0.0
2018-05-07,256,149,107,0,149,0,0,0.0
2018-05-08,212,111,101,0,111,0,0,0.0
2018-05-09,163,57,106,0,57,0,0,0.0
2018-05-10,204,93,111,0,93,0,0,0.0
2018-05-11,224,129,95,0,129,0,0,0.0
2018-05-13,13,12,1,0,12,0,0,0.0
2018-05-14,184,111,73,0,111,0,0,0.0
2018-05-15,246,131,115,0,131,0,0,0.0
2018-05-16,249,144,105,0,144,0,0,0.0
2018-05-17,182,89,93,0,89,0,0,0.0
2018-05-18,215,129,86,0,129,0,0,0.0
2018-05-20,15,12,3,0,12,0,0,0.0
2018-05-21,252,137,115,0,137,0,0,0.0
2018-05-22,184,85,99,0,85,0,0,0.0
2018-05-23,204,105,99,0,105,0,0,0.0
2018-05-24,231,120,111,0,120,0,0,0.0
2018-05-25,182,86,96,0,86,0,0,0.0
2018-05-27,19,12,7,0,12,0,0,0.0
2018-05-28,247,142,105,0,142,0,0,0.0
2018-05-29,246,135,111,0,135,0,0,0.0
2018-05-30,194,86,108,0,86,0,0,0.0
2018-05-31,198,90,108,0,90,0,0,0.0
2018-06-01,230,137,93,0,137,0,0,0.0
2018-06-03,15,12,3,0,12,0,0,0.0
2018-06-04,236,121,115,0,121,0,0,0.0
2018-06-05,212,118,94,0,118,0,0,0.0
2018-06-06,229,135,94,0,135,0,0,0.0
2018-06-07,252,150,102,0,150,0,0,0.0
2018-06-08,209,123,86,0,123,0,0,0.0
2018-06-10,13,12,1,0,12,0,0,0.0
2018-06-11,230,137,93,0,137,0,0,0.0
2018-06-12,219,118,101,0,118,0,0,0.0
2018-06-13,235,150,85,0,150,0,0,0.0
2018-06-14,181,114,67,0,114,0,0,0.0
2018-06-15,203,108,95,0,108,0,0,0.0
2018-06-17,23,12,11,0,12,0,0,0.0
2018-06-18,206,99,107,0,99,0,0,0.0
2018-06-19,253,145,108,0,145,0,0,0.0
2018-06-20,253,140,113,0,140,0,0,0.0
2018-06-21,255,151,104,0,151,0,0,0.0
2018-06-22,199,104,95,0,104,0,0,0.0
2018-06-24,20,12,8,0,12,0,0,0.0
2018-06-25,244,129,115,0,129,0,0,0.0
2018-06-26,230,124,106,0,124,0,0,0.0
2018-06-27,223,121,102,0,121,0,0,0.0
2018-06-28,259,156,103,0,156,0,0,0.0
2018-06-29,207,112,95,0,112,0,0,0.0
2018-07-01,17,8,9,0,8,0,0,0.0
2018-07-02,177,86,91,0,86,0,0,0.0
2018-07-03,249,136,113,0,136,0,0,0.0
2018-07-04,185,85,100,0,85,0,0,0.0
2018-07-05,219,123,96,0,123,0,0,0.0
2018-07-06,170,102,68,0,102,0,0,0.0
2018-07-08,17,12,5,0,12,0,0,0.0
2018-07-09,196,138,58,0,138,0,0,0.0
2018-07-10,244,148,96,0,148,0,0,0.0
2018-07-11,232,156,76,0,156,0,0,0.0
2018-07-12,204,90,114,0,90,0,0,0.0
2018-07-13,230,134,96,0,134,0,0,0.0
2018-07-15,25,12,13,0,12,0,0,0.0
2018-07-16,235,139,96,0,139,0,0,0.0
2018-07-17,258,149,109,0,149,0,0,0.0
2018-07-18,205,122,83,0,122,0,0,0.0
2018-07-19,231,128,103,0,128,0,0,0.0
2018-07-20,210,117,93,0,117,0,0,0.0
2018-07-22,30,12,18,0,12,0,0,0.0
2018-07-23,259,145,114,0,145,0,0,0.0
2018-07-24,229,139,90,0,139,0,0,0.0
2018-07-25,208,117,91,0,117,0,0,0.0
2018-07-26,253,150,103,0,150,0,0,0.0
2018-07-27,178,82,96,0,82,0,0,0.0
2018-07-29,12,8,4,0,8,0,0,0.0
2018-07-30,210,105,105,0,105,0,0,0.0
2018-07-31,184,74,110,0,74,0,0,0.0
2018-08-01,244,142,102,0,142,0,0,0.0
2018-08-02,253,150,103,0,150,0,0,0.0
2018-08-03,209,122,87,0,122,0,0,0.0
2018-08-05,13,12,1,0,12,0,0,0.0
2018-08-06,227,126,101,0,126,0,0,0.0
2018-08-07,271,157,114,0,157,0,0,0.0
2018-08-08,211,106,105,0,106,0,0,0.0
2018-08-09,258,144,114,0,144,0,0,0.0
2018-08-10,206,110,96,0,110,0,0,0.0
2018-08-12,12,12,0,0,12,0,0,0.0
2018-08-13,236,138,98,0,138,0,0,0.0
2018-08-14,237,140,97,0,140,0,0,0.0
2018-08-15,249,139,110,0,139,0,0,0.0
2018-08-16,246,138,108,0,138,0,0,0.0
2018-08-17,203,107,96,0,107,0,0,0.0
2018-08-19,19,12,7,0,12,0,0,0.0
2018-08-20,203,105,98,0,105,0,0,0.0
2018-08-21,253,146,107,0,146,0,0,0.0
2018-08-22,249,155,94,0,155,0,0,0.0
2018-08-23,241,143,98,0,143,0,0,0.0
2018-08-24,180,125,55,0,125,0,0,0.0
2018-08-26,19,12,7,0,12,0,0,0.0
2018-08-27,242,135,107,0,135,0,0,0.0
2018-08-28,242,136,106,0,136,0,0,0.0
2018-08-29,252,151,101,0,151,0,0,0.0
2018-08-30,249,150,99,0,150,0,0,0.0
2018-08-31,177,115,62,0,115,0,0,0.0
2018-09-02,22,12,10,0,12,0,0,0.0
2018-09-03,221,115,106,0,115,0,0,0.0
2018-09-04,231,133,98,0,133,0,0,0.0
2018-09-05,133,58,75,0,58,0,0,0.0
2018-09-06,240,128,112,0,128,0,0,0.0
2018-09-07,214,119,95,0,119,0,0,0.0
2018-09-09,19,2,17,0,2,0,0,0.0
2018-09-10,208,111,97,0,111,0,0,0.0
2018-09-11,258,153,105,0,153,0,0,0.0
2018-09-12,207,107,100,0,107,0,0,0.0
2018-09-13,260,145,115,0,145,0,0,0.0
2018-09-14,166,74,92,0,74,0,0,0.0
2018-09-16,2,0,2,0,0,0,0,0.0
2018-09-17,177,139,38,0,139,0,0,0.0
2018-09-18,240,139,101,0,139,0,0,0.0
2018-09-19,134,43,91,0,43,0,0,0.0
2018-09-20,222,123,99,0,123,0,0,0.0
2018-09-21,207,114,93,0,114,0,0,0.0
2018-09-23,18,12,6,0,12,0,0,0.0
2018-09-24,223,127,96,0,127,0,0,0.0
2018-09-25,254,152,102,0,152,0,0,0.0
2018-09-26,255,146,109,0,146,0,0,0.0
2018-09-27,261,154,107,0,154,0,0,0.0
2018-09-28,213,118,95,0,118,0,0,0.0
2018-09-30,27,12,15,0,12,0,0,0.0
2018-10-01,248,134,114,0,134,0,0,0.0
2018-10-02,238,136,102,0,136,0,0,0.0
2018-10-03,256,150,106,0,150,0,0,0.0
2018-10-04,233,123,110,0,123,0,0,0.0
2018-10-05,202,136,66,0,136,0,0,0.0
2018-10-07,18,12,6,0,12,0,0,0.0
2018-10-08,229,121,108,0,121,0,0,0.0
2018-10-09,227,125,102,0,125,0,0,0.0
2018-10-10,256,156,100,0,156,0,0,0.0
2018-10-11,180,111,69,0,111,0,0,0.0
2018-10-12,229,134,95,0,134,0,0,0.0
2018-10-14,19,12,7,0,12,0,0,0.0
2018-10-15,225,125,100,0,125,0,0,0.0
2018-10-16,221,109,112,0,109,0,0,0.0
2018-10-17,225,126,99,0,126,0,0,0.0
2018-10-18,252,149,103,0,149,0,0,0.0
2018-10-19,223,127,96,0,127,0,0,0.0
2018-10-21,28,12,16,0,12,0,0,0.0
2018-10-22,220,113,107,0,113,0,0,0.0
2018-10-23,241,137,104,0,137,0,0,0.0
2018-10-24,251,147,104,0,147,0,0,0.0
2018-10-25,225,146,79,0,146,0,0,0.0
2018-10-26,227,134,93,0,134,0,0,0.0
2018-10-28,21,12,9,0,12,0,0,0.0
2018-10-29,195,108,87,0,108,0,0,0.0
2018-10-30,234,121,113,0,121,0,0,0.0
2018-10-31,215,107,108,0,107,0,0,0.0
2018-11-01,248,144,104,0,144,0,0,0.0
2018-11-02,220,124,96,0,124,0,0,0.0
2018-11-04,15,0,15,0,0,0,0,0.0
2018-11-05,214,152,62,0,152,0,0,0.0
2018-11-06,250,146,104,0,146,0,0,0.0
2018-11-07,223,131,92,0,131,0,0,0.0
2018-11-08,239,136,103,0,136,0,0,0.0
2018-11-09,209,113,96,0,113,0,0,0.0
2018-11-11,8,0,8,0,0,0,0,0.0
2018-11-12,227,120,107,0,120,0,0,0.0
2018-11-13,234,131,103,0,131,0,0,0.0
2018-11-14,239,134,105,0,134,0,0,0.0
2018-11-15,226,140,86,0,140,0,0,0.0
2018-11-16,230,146,84,0,146,0,0,0.0
2018-11-18,14,0,14,0,0,0,0,0.0
2018-11-19,204,119,85,0,119,0,0,0.0
2018-11-20,208,132,76,0,132,0,0,0.0
2018-11-21,198,95,103,0,95,0,0,0.0
2018-11-22,144,117,27,0,117,0,0,0.0
2018-11-23,212,134,78,0,134,0,0,0.0
2018-11-25,11,0,11,0,0,0,0,0.0
2018-11-26,245,138,107,0,138,0,0,0.0
2018-11-27,234,133,101,0,133,0,0,0.0
2018-11-28,250,143,107,0,143,0,0,0.0
2018-11-29,246,150,96,0,150,0,0,0.0
2018-11-30,112,112,0,0,112,0,0,0.0
2018-12-02,14,0,14,0,0,0,0,0.0
2018-12-03,218,129,89,0,129,0,0,0.0
2018-12-04,255,149,106,0,149,0,0,0.0
2018-12-05,266,153,113,0,153,0,0,0.0
2018-12-06,266,154,112,0,154,0,0,0.0
2018-12-07,217,123,94,0,123,0,0,0.0
2018-12-09,14,0,14,0,0,0,0,0.0
2018-12-10,244,138,106,0,138,0,0,0.0
2018-12-11,249,139,110,0,139,0,0,0.0
2018-12-12,220,124,96,0,124,0,0,0.0
2018-12-13,209,113,96,0,113,0,0,0.0
2018-12-14,220,148,72,0,148,0,0,0.0
2018-12-16,18,0,18,0,0,0,0,0.0
2018-12-17,252,150,102,0,150,0,0,0.0
2018-12-18,263,152,111,0,152,0,0,0.0
2018-12-19,249,134,115,0,134,0,0,0.0
2018-12-20,246,152,94,0,152,0,0,0.0
2018-12-21,179,102,77,0,102,0,0,0.0
2018-12-23,5,0,5,0,0,0,0,0.0
2018-12-24,133,124,9,0,124,0,0,0.0
2018-12-25,117,0,117,0,0,0,0,0.0
2018-12-26,226,149,77,0,149,0,0,0.0
2018-12-27,231,119,112,0,119,0,0,0.0
2018-12-28,167,72,95,0,72,0,0,0.0
2018-12-30,13,0,13,0,0,0,0,0.0
2018-12-31,224,132,92,0,132,0,0,0.0
2019-01-01,16,0,16,0,0,0,0,0.0
2019-01-02,226,116,110,0,116,0,0,0.0
2019-01-03,160,49,111,0,49,0,0,0.0
2019-01-04,246,150,96,0,150,0,0,0.0
2019-01-06,11,0,11,0,0,0,0,0.0
2019-01-07,235,147,88,0,147,0,0,0.0
2019-01-08,232,124,108,0,124,0,0,0.0
2019-01-09,223,120,103,0,120,0,0,0.0
2019-01-10,258,153,105,0,153,0,0,0.0
2019-01-11,211,126,85,0,126,0,0,0.0
2019-01-13,13,0,13,0,0,0,0,0.0
2019-01-14,241,129,112,0,129,0,0,0.0
2019-01-15,236,139,97,0,139,0,0,0.0
2019-01-16,218,116,102,0,116,0,0,0.0
2019-01-17,223,118,105,0,118,0,0,0.0
2019-01-18,236,141,95,0,141,0,0,0.0
2019-01-20,8,0,8,0,0,0,0,0.0
2019-01-21,182,80,102,0,80,0,0,0.0
2019-01-22,228,140,88,0,140,0,0,0.0
2019-01-23,237,138,99,0,138,0,0,0.0
2019-01-24,231,144,87,0,144,0,0,0.0
2019-01-25,241,146,95,0,146,0,0,0.0
2019-01-27,17,0,17,0,0,0,0,0.0
2019-01-28,240,137,103,0,137,0,0,0.0
2019-01-29,246,157,89,0,157,0,0,0.0
2019-01-30,180,132,48,0,132,0,0,0.0
2019-01-31,251,151,100,0,151,0,0,0.0
2019-02-01,238,151,87,0,151,0,0,0.0
2019-02-03,18,0,18,0,0,0,0,0.0
2019-02-04,200,95,105,0,95,0,0,0.0
2019-02-05,195,114,81,0,114,0,0,0.0
2019-02-06,244,140,104,0,140,0,0,0.0
2019-02-07,220,132,88,0,132,0,0,0.0
2019-02-08,174,120,54,0,120,0,0,0.0
2019-02-10,8,0,8,0,0,0,0,0.0
2019-02-11,239,154,85,0,154,0,0,0.0
2019-02-12,233,133,100,0,133,0,0,0.0
2019-02-13,245,135,110,0,135,0,0,0.0
2019-02-14,249,150,99,0,150,0,0,0.0
2019-02-15,215,131,84,0,131,0,0,0.0
2019-02-17,13,0,13,0,0,0,0,0.0
2019-02-18,236,135,101,0,135,0,0,0.0
2019-02-19,248,153,95,0,153,0,0,0.0
2019-02-20,258,151,107,0,151,0,0,0.0
2019-02-21,193,98,95,0,98,0,0,0.0
2019-02-22,246,156,90,0,156,0,0,0.0
2019-02-24,17,0,17,0,0,0,0,0.0
2019-02-25,206,137,69,0,137,0,0,0.0
2019-02-26,253,156,97,0,156,0,0,0.0
2019-02-27,231,150,81,0,150,0,0,0.0
2019-02-28,245,132,113,0,132,0,0,0.0
2019-03-01,213,117,96,0,117,0,0,0.0
2019-03-03,19,0,19,0,0,0,0,0.0
2019-03-04,227,131,96,0,131,0,0,0.0
2019-03-05,241,135,106,0,135,0,0,0.0
2019-03-06,228,129,99,0,129,0,0,0.0
2019-03-07,247,158,89,0,158,0,0,0.0
2019-03-08,220,125,95,0,125,0,0,0.0
2019-03-10,20,7,13,0,7,0,0,0.0
2019-03-11,205,143,62,0,143,0,0,0.0
2019-03-12,227,135,92,0,135,0,0,0.0
2019-03-13,241,130,111,0,130,0,0,0.0
2019-03-14,214,100,114,0,100,0,0,0.0
2019-03-15,183,94,89,0,94,0,0,0.0
2019-03-17,23,12,11,0,12,0,0,0.0
2019-03-18,251,138,113,0,138,0,0,0.0
2019-03-19,237,122,115,0,122,0,0,0.0
2019-03-20,245,134,111,0,134,0,0,0.0
2019-03-21,254,154,100,0,154,0,0,0.0
2019-03-22,236,144,92,0,144,0,0,0.0
2019-03-24,25,12,13,0,12,0,0,0.0
2019-03-25,214,130,84,0,130,0,0,0.0
2019-03-26,213,123,90,0,123,0,0,0.0
2019-03-27,119,104,15,0,104,0,0,0.0
2019-03-28,176,71,105,0,71,0,0,0.0
2019-03-29,132,37,95,0,37,0,0,0.0
2019-03-31,18,12,6,0,12,0,0,0.0
2019-04-01,248,141,107,0,141,0,0,0.0
2019-04-02,188,116,72,0,116,0,0,0.0
2019-04-03,196,87,109,0,87,0,0,0.0
2019-04-04,237,128,109,0,128,0,0,0.0
2019-04-05,150,54,96,0,54,0,0,0.0
2019-04-07,14,2,12,0,2,0,0,0.0
2019-04-08,247,132,115,0,132,0,0,0.0
2019-04-09,251,141,110,0,141,0,0,0.0
2019-04-10,238,144,94,0,144,0,0,0.0
2019-04-11,237,128,109,0,128,0,0,0.0
2019-04-12,216,120,96,0,120,0,0,0.0
2019-04-14,31,12,19,0,12,0,0,0.0
2019-04-15,162,64,98,0,64,0,0,0.0
2019-04-16,148,64,84,0,64,0,0,0.0
2019-04-17,225,119,106,0,119,0,0,0.0
2019-04-18,196,99,97,0,99,0,0,0.0
2019-04-19,136,49,87,0,49,0,0,0.0
2019-04-21,27,12,15,0,12,0,0,0.0
2019-04-22,134,50,84,0,50,0,0,0.0
2019-04-23,242,133,109,0,133,0,0,0.0
2019-04-24,255,153,102,0,153,0,0,0.0
2019-04-25,249,141,108,0,141,0,0,0.0
2019-04-26,233,137,96,0,137,0,0,0.0
2019-04-28,23,12,11,0,12,0,0,0.0
2019-04-29,220,118,102,0,118,0,0,0.0
2019-04-30,211,106,105,0,106,0,0,0.0
2019-05-01,243,142,101,0,142,0,0,0.0
2019-05-02,230,124,106,0,124,0,0,0.0
2019-05-03,214,123,91,0,123,0,0,0.0
2019-05-05,27,12,15,0,12,0,0,0.0
2019-05-06,202,112,90,0,112,0,0,0.0
2019-05-07,223,148,75,0,148,0,0,0.0
2019-05-08,205,106,99,0,106,0,0,0.0
2019-05-09,248,140,108,0,140,0,0,0.0
2019-05-10,215,120,95,0,120,0,0,0.0
2019-05-12,17,12,5,0,12,0,0,0.0
2019-05-13,178,125,53,0,125,0,0,0.0
2019-05-14,256,145,111,0,145,0,0,0.0
2019-05-15,260,153,107,0,153,0,0,0.0
2019-05-16,263,157,106,0,157,0,0,0.0
2019-05-17,229,133,96,0,133,0,0,0.0
2019-05-19,22,12,10,0,12,0,0,0.0
2019-05-20,268,157,111,0,157,0,0,0.0
2019-05-21,233,123,110,0,123,0,0,0.0
2019-05-22,230,137,93,0,137,0,0,0.0
2019-05-23,258,156,102,0,156,0,0,0.0
2019-05-24,224,129,95,0,129,0,0,0.0
2019-05-26,31,12,19,0,12,0,0,0.0
2019-05-27,255,140,115,0,140,0,0,0.0
2019-05-28,207,117,90,0,117,0,0,0.0
2019-05-29,227,130,97,0,130,0,0,0.0
2019-05-30,228,120,108,0,120,0,0,0.0
2019-05-31,215,119,96,0,119,0,0,0.0
2019-06-02,18,12,6,0,12,0,0,0.0
2019-06-03,219,142,77,0,142,0,0,0.0
2019-06-04,212,127,85,0,127,0,0,0.0
2019-06-05,227,138,89,0,138,0,0,0.0
2019-06-06,199,115,84,0,115,0,0,0.0
2019-06-07,214,118,96,0,118,0,0,0.0
2019-06-09,15,12,3,0,12,0,0,0.0
2019-06-10,204,133,71,0,133,0,0,0.0
2019-06-11,253,154,99,0,154,0,0,0.0
2019-06-12,143,40,103,0,40,0,0,0.0
2019-06-13,259,152,107,0,152,0,0,0.0
2019-06-14,218,122,96,0,122,0,0,0.0
2019-06-16,11,5,6,0,5,0,0,0.0
2019-06-17,229,123,106,0,123,0,0,0.0
2019-06-18,219,110,109,0,110,0,0,0.0
2019-06-19,235,132,103,0,132,0,0,0.0
2019-06-20,248,146,102,0,146,0,0,0.0
2019-06-21,205,127,78,0,127,0,0,0.0
2019-06-23,30,12,18,0,12,0,0,0.0
2019-06-24,242,146,96,0,146,0,0,0.0
2019-06-25,242,149,93,0,149,0,0,0.0
2019-06-26,231,128,103,0,128,0,0,0.0
2019-06-27,263,154,109,0,154,0,0,0.0
2019-06-28,219,123,96,0,123,0,0,0.0
2019-06-30,29,12,17,0,12,0,0,0.0
2019-07-01,157,117,40,0,117,0,0,0.0
2019-07-02,163,133,30,0,133,0,0,0.0
2019-07-03,263,149,114,0,149,0,0,0.0
2019-07-04,164,68,96,0,68,0,0,0.0
2019-07-05,197,101,96,0,101,0,0,0.0
2019-07-07,0,0,0,0,0,0,0,0.0
2019-07-08,243,156,87,0,156,0,0,0.0
2019-07-09,198,90,108,0,90,0,0,0.0
2019-07-10,250,138,112,0,138,0,0,0.0
2019-07-11,246,139,107,0,139,0,0,0.0
2019-07-12,215,119,96,0,119,0,0,0.0
2019-07-14,19,12,7,0,12,0,0,0.0
2019-07-15,194,103,91,0,103,0,0,0.0
2019-07-16,228,123,105,0,123,0,0,0.0
2019-07-17,215,120,95,0,120,0,0,0.0
2019-07-18,236,140,96,0,140,0,0,0.0
2019-07-19,121,91,30,0,91,0,0,0.0
2019-07-21,21,5,16,0,5,0,0,0.0
2019-07-22,195,91,104,0,91,0,0,0.0
2019-07-23,241,132,109,0,132,0,0,0.0
2019-07-24,239,134,105,0,134,0,0,0.0
2019-07-25,198,117,81,0,117,0,0,0.0
2019-07-26,130,56,74,0,56,0,0,0.0
2019-07-28,6,0,6,0,0,0,0,0.0
2019-07-29,232,140,92,0,140,0,0,0.0
2019-07-30,236,135,101,0,135,0,0,0.0
2019-07-31,214,108,106,0,108,0,0,0.0
2019-08-01,261,150,111,0,150,0,0,0.0
2019-08-02,230,135,95,0,135,0,0,0.0
2019-08-04,19,12,7,0,12,0,0,0.0
2019-08-05,218,118,100,0,118,0,0,0.0
2019-08-06,151,46,105,0,46,0,0,0.0
2019-08-07,215,111,104,0,111,0,0,0.0
2019-08-08,153,104,49,0,104,0,0,0.0
2019-08-09,234,141,93,0,141,0,0,0.0
2019-08-11,27,12,15,0,12,0,0,0.0
2019-08-12,256,148,108,0,148,0,0,0.0
2019-08-13,260,139,121,0,139,0,0,0.0
2019-08-14,229,116,113,0,116,0,0,0.0
2019-08-15,197,93,104,0,93,0,0,0.0
2019-08-16,154,73,81,0,73,0,0,0.0
2019-08-18,16,1,15,0,1,0,0,0.0
2019-08-19,99,71,28,0,71,0,0,0.0
2019-08-20,177,101,76,0,101,0,0,0.0
2019-08-21,252,145,107,0,145,0,0,0.0
2019-08-22,253,148,105,0,148,0,0,0.0
2019-08-23,225,129,96,0,129,0,0,0.0
2019-08-25,22,12,10,0,12,0,0,0.0
2019-08-26,181,77,104,0,77,0,0,0.0
2019-08-27,206,101,105,0,101,0,0,0.0
2019-08-28,235,130,105,0,130,0,0,0.0
2019-08-29,263,156,107,0,156,0,0,0.0
2019-08-30,226,131,95,0,131,0,0,0.0
2019-09-01,13,12,1,0,12,0,0,0.0
2019-09-02,236,150,86,0,150,0,0,0.0
2019-09-03,240,131,109,0,131,0,0,0.0
2019-09-04,189,95,94,0,95,0,0,0.0
2019-09-05,263,152,111,0,152,0,0,0.0
2019-09-06,172,93,79,0,93,0,0,0.0
2019-09-08,7,0,7,0,0,0,0,0.0
2019-09-09,174,129,45,0,129,0,0,0.0
2019-09-10,238,134,104,0,134,0,0,0.0
2019-09-11,220,115,105,0,115,0,0,0.0
2019-09-12,240,131,109,0,131,0,0,0.0
2019-09-13,98,49,49,0,49,0,0,0.0
2019-09-15,12,12,0,0,12,0,0,0.0
2019-09-16,176,150,26,0,150,0,0,0.0
2019-09-17,132,34,98,0,34,0,0,0.0
2019-09-18,220,120,100,0,120,0,0,0.0
2019-09-19,245,143,102,0,143,0,0,0.0
2019-09-20,218,122,96,0,122,0,0,0.0
2019-09-22,18,12,6,0,12,0,0,0.0
2019-09-23,117,85,32,0,85,0,0,0.0
2019-09-24,256,148,108,0,148,0,0,0.0
2019-09-25,225,121,104,0,121,0,0,0.0
2019-09-26,244,137,107,0,137,0,0,0.0
2019-09-27,224,131,93,0,131,0,0,0.0
2019-09-29,29,12,17,0,12,0,0,0.0
2019-09-30,218,145,73,0,145,0,0,0.0
2019-10-01,229,134,95,0,134,0,0,0.0
2019-10-02,244,144,100,0,144,0,0,0.0
2019-10-03,256,155,101,0,155,0,0,0.0
2019-10-04,221,126,95,0,126,0,0,0.0
2019-10-06,26,12,14,0,12,0,0,0.0
2019-10-07,217,131,86,0,131,0,0,0.0
2019-10-08,255,141,114,0,141,0,0,0.0
2019-10-09,244,139,105,0,139,0,0,0.0
2019-10-10,202,117,85,0,117,0,0,0.0
2019-10-11,229,139,90,0,139,0,0,0.0
2019-10-13,25,9,16,0,9,0,0,0.0
2019-10-14,239,134,105,0,134,0,0,0.0
2019-10-15,250,152,98,0,152,0,0,0.0
2019-10-16,245,131,114,0,131,0,0,0.0
2019-10-17,232,127,105,0,127,0,0,0.0
2019-10-18,162,69,93,0,69,0,0,0.0
2019-10-20,4,4,0,0,4,0,0,0.0
2019-10-21,229,120,109,0,120,0,0,0.0
2019-10-22,255,143,112,0,143,0,0,0.0
2019-10-23,240,134,106,0,134,0,0,0.0
2019-10-24,186,91,95,0,91,0,0,0.0
2019-10-25,232,138,94,0,138,0,0,0.0
2019-10-27,14,12,2,0,12,0,0,0.0
2019-10-28,258,154,104,0,154,0,0,0.0
2019-10-29,172,117,55,0,117,0,0,0.0
2019-10-30,218,140,78,0,140,0,0,0.0
2019-10-31,248,151,97,0,151,0,0,0.0
2019-11-01,205,132,73,0,132,0,0,0.0
2019-11-03,2,0,2,0,0,0,0,0.0
2019-11-04,155,123,32,0,123,0,0,0.0
2019-11-05,205,109,96,0,109,0,0,0.0
2019-11-06,186,92,94,0,92,0,0,0.0
2019-11-07,241,145,96,0,145,0,0,0.0
2019-11-08,245,157,88,0,157,0,0,0.0
2019-11-10,17,0,17,0,0,0,0,0.0
2019-11-11,215,123,92,0,123,0,0,0.0
2019-11-12,238,139,99,0,139,0,0,0.0
2019-11-13,240,146,94,0,146,0,0,0.0
2019-11-14,235,148,87,0,148,0,0,0.0
2019-11-15,238,142,96,0,142,0,0,0.0
2019-11-17,13,0,13,0,0,0,0,0.0
2019-11-18,244,142,102,0,142,0,0,0.0
2019-11-19,265,158,107,0,158,0,0,0.0
2019-11-20,231,125,106,0,125,0,0,0.0
2019-11-21,111,53,58,0,53,0,0,0.0
2019-11-22,220,150,70,0,150,0,0,0.0
2019-11-24,13,0,13,0,0,0,0,0.0
2019-11-25,204,91,113,0,91,0,0,0.0
2019-11-26,218,116,102,0,116,0,0,0.0
2019-11-27,257,149,108,0,149,0,0,0.0
2019-11-28,240,145,95,0,145,0,0,0.0
2019-11-29,236,140,96,0,140,0,0,0.0
2019-12-01,11,0,11,0,0,0,0,0.0
2019-12-02,231,132,99,0,132,0,0,0.0
2019-12-03,248,151,97,0,151,0,0,0.0
2019-12-04,235,135,100,0,135,0,0,0.0
2019-12-05,205,131,74,0,131,0,0,0.0
2019-12-06,235,146,89,0,146,0,0,0.0
2019-12-08,14,0,14,0,0,0,0,0.0
2019-12-09,231,134,97,0,134,0,0,0.0
2019-12-10,257,147,110,0,147,0,0,0.0
2019-12-11,159,148,11,0,148,0,0,0.0
2019-12-12,215,138,77,0,138,0,0,0.0
2019-12-13,194,135,59,0,135,0,0,0.0
2019-12-15,17,0,17,0,0,0,0,0.0
2019-12-16,221,108,113,0,108,0,0,0.0
2019-12-17,154,119,35,0,119,0,0,0.0
2019-12-18,154,69,85,0,69,0,0,0.0
2019-12-19,195,140,55,0,140,0,0,0.0
2019-12-20,157,137,20,0,137,0,0,0.0
2019-12-22,19,0,19,0,0,0,0,0.0
2019-12-23,178,135,43,0,135,0,0,0.0
2019-12-24,211,132,79,0,132,0,0,0.0
2019-12-25,98,0,98,0,0,0,0,0.0
2019-12-26,240,144,96,0,144,0,0,0.0
2019-12-27,196,104,92,0,104,0,0,0.0
2019-12-29,4,0,4,0,0,0,0,0.0
2019-12-30,227,132,95,0,132,0,0,0.0
2019-12-31,228,141,87,0,141,0,0,0.0
2020-01-01,0,0,0,0,0,0,0,0.0
2020-01-02,141,121,20,0,121,0,0,0.0
2020-01-03,208,122,86,0,122,0,0,0.0
2020-01-05,14,0,14,0,0,0,0,0.0
2020-01-06,236,127,109,0,127,0,0,0.0
2020-01-07,220,115,105,0,115,0,0,0.0
2020-01-08,229,126,103,0,126,0,0,0.0
2020-01-09,241,145,96,0,145,0,0,0.0
2020-01-10,191,152,39,0,152,0,0,0.0
2020-01-12,15,0,15,0,0,0,0,0.0
2020-01-13,244,140,104,0,140,0,0,0.0
2020-01-14,206,102,104,0,102,0,0,0.0
2020-01-15,208,109,99,0,109,0,0,0.0
2020-01-16,255,147,108,0,147,0,0,0.0
2020-01-17,188,99,89,0,99,0,0,0.0
2020-01-19,5,0,5,0,0,0,0,0.0
2020-01-20,204,133,71,0,133,0,0,0.0
2020-01-21,239,132,107,0,132,0,0,0.0
2020-01-22,251,140,111,0,140,0,0,0.0
2020-01-23,233,120,113,0,120,0,0,0.0
2020-01-24,234,143,91,0,143,0,0,0.0
2020-01-26,13,0,13,0,0,0,0,0.0
2020-01-27,188,124,64,0,124,0,0,0.0
2020-01-28,256,152,104,0,152,0,0,0.0
2020-01-29,165,98,67,0,98,0,0,0.0
2020-01-30,240,132,108,0,132,0,0,0.0
2020-01-31,245,152,93,0,152,0,0,0.0
2020-02-02,0,0,0,0,0,0,0,0.0
2020-02-03,203,97,106,0,97,0,0,0.0
2020-02-04,214,118,96,0,118,0,0,0.0
2020-02-05,162,94,68,0,94,0,0,0.0
2020-02-06,238,134,104,0,134,0,0,0.0
2020-02-07,248,152,96,0,152,0,0,0.0
2020-02-09,18,0,18,0,0,0,0,0.0
2020-02-10,181,85,96,0,85,0,0,0.0
2020-02-11,193,96,97,0,96,0,0,0.0
2020-02-12,257,158,99,0,158,0,0,0.0
2020-02-13,246,139,107,0,139,0,0,0.0
2020-02-14,214,156,58,0,156,0,0,0.0
2020-02-16,0,0,0,0,0,0,0,0.0
2020-02-17,173,149,24,0,149,0,0,0.0
2020-02-18,214,112,102,0,112,0,0,0.0
2020-02-19,267,154,113,0,154,0,0,0.0
2020-02-20,224,120,104,0,120,0,0,0.0
2020-02-21,238,144,94,0,144,0,0,0.0
2020-02-23,13,0,13,0,0,0,0,0.0
2020-02-24,261,155,106,0,155,0,0,0.0
2020-02-25,262,147,115,0,147,0,0,0.0
2020-02-26,218,112,106,0,112,0,0,0.0
2020-02-27,228,122,106,0,122,0,0,0.0
2020-02-28,222,154,68,0,154,0,0,0.0
2020-03-01,3,0,3,0,0,0,0,0.0
2020-03-02,233,136,97,0,136,0,0,0.0
2020-03-03,209,99,110,0,99,0,0,0.0
2020-03-04,205,100,105,0,100,0,0,0.0
2020-03-05,239,133,106,0,133,0,0,0.0
2020-03-06,235,144,91,0,144,0,0,0.0
2020-03-08,27,12,15,0,12,0,0,0.0
2020-03-09,198,86,112,0,86,0,0,0.0
2020-03-10,237,136,101,1,135,1,0,-18.497142857143444
2020-03-11,213,100,113,0,100,0,0,0.0
2020-03-12,236,132,104,0,132,0,0,0.0
2020-03-13,217,122,95,0,122,0,0,0.0
2020-03-15,18,12,6,0,12,0,0,0.0
2020-03-16,191,152,39,0,152,0,0,0.0
2020-03-17,242,127,115,0,127,0,0,0.0
2020-03-18,235,133,102,0,133,0,0,0.0
2020-03-19,242,133,109,0,133,0,0,0.0
2020-03-20,223,130,93,0,130,0,0,0.0
2020-03-22,6,0,6,0,0,0,0,0.0
2020-03-23,251,143,108,0,143,0,0,0.0
2020-03-24,263,149,114,0,149,0,0,0.0
2020-03-25,253,146,107,0,146,0,0,0.0
2020-03-26,207,96,111,0,96,0,0,0.0
2020-03-27,210,114,96,0,114,0,0,0.0
2020-03-29,24,12,12,0,12,0,0,0.0
2020-03-30,163,71,92,0,71,0,0,0.0
2020-03-31,258,144,114,0,144,0,0,0.0
2020-04-01,252,141,111,0,141,0,0,0.0
2020-04-02,236,125,111,0,125,0,0,0.0
2020-04-03,129,97,32,0,97,0,0,0.0
2020-04-05,23,12,11,0,12,0,0,0.0
2020-04-06,207,94,113,0,94,0,0,0.0
2020-04-07,243,132,111,0,132,0,0,0.0
2020-04-08,238,142,96,0,142,0,0,0.0
2020-04-09,271,157,114,0,157,0,0,0.0
2020-04-10,204,115,89,0,115,0,0,0.0
2020-04-12,11,10,1,0,10,0,0,0.0
2020-04-13,216,115,101,0,115,0,0,0.0
2020-04-14,240,150,90,0,150,0,0,0.0
2020-04-15,229,124,105,0,124,0,0,0.0
2020-04-16,246,146,100,0,146,0,0,0.0
2020-04-17,219,123,96,0,123,0,0,0.0
2020-04-19,21,3,18,0,3,0,0,0.0
2020-04-20,244,135,109,0,135,0,0,0.0
2020-04-21,167,59,108,0,59,0,0,0.0
2020-04-22,165,73,92,0,73,0,0,0.0
2020-04-23,189,136,53,0,136,0,0,0.0
2020-04-24,230,136,94,0,136,0,0,0.0
2020-04-26,23,10,13,0,10,0,0,0.0
2020-04-27,249,149,100,0,149,0,0,0.0
2020-04-28,263,150,113,0,150,0,0,0.0
2020-04-29,204,108,96,0,108,0,0,0.0
2020-04-30,231,128,103,0,128,0,0,0.0
2020-05-01,181,141,40,0,141,0,0,0.0
2020-05-03,17,11,6,0,11,0,0,0.0
2020-05-04,238,126,112,0,126,0,0,0.0
2020-05-05,242,132,110,0,132,0,0,0.0
2020-05-06,252,138,114,0,138,0,0,0.0
2020-05-07,258,148,110,0,148,0,0,0.0
2020-05-08,189,94,95,0,94,0,0,0.0
2020-05-10,29,12,17,0,12,0,0,0.0
2020-05-11,230,143,87,0,143,0,0,0.0
2020-05-12,229,119,110,0,119,0,0,0.0
2020-05-13,232,131,101,0,131,0,0,0.0
2020-05-14,241,138,103,0,138,0,0,0.0
2020-05-15,208,134,74,0,134,0,0,0.0
2020-05-17,28,12,16,0,12,0,0,0.0
2020-05-18,162,130,32,0,130,0,0,0.0
2020-05-19,263,148,115,0,148,0,0,0.0
2020-05-20,191,118,73,0,118,0,0,0.0
2020-05-21,200,103,97,0,103,0,0,0.0
2020-05-22,170,90,80,0,90,0,0,0.0
2020-05-24,16,6,10,0,6,0,0,0.0
2020-05-25,165,103,62,0,103,0,0,0.0
2020-05-26,201,98,103,0,98,0,0,0.0
2020-05-27,216,140,76,0,140,0,0,0.0
2020-05-28,244,145,99,0,145,0,0,0.0
2020-05-29,209,119,90,0,119,0,0,0.0
2020-05-31,24,12,12,0,12,0,0,0.0
2020-06-01,245,142,103,0,142,0,0,0.0
2020-06-02,234,136,98,0,136,0,0,0.0
2020-06-03,248,138,110,0,138,0,0,0.0
2020-06-04,254,146,108,0,146,0,0,0.0
2020-06-05,186,101,85,0,101,0,0,0.0
2020-06-07,7,4,3,0,4,0,0,0.0
2020-06-08,255,145,110,0,145,0,0,0.0
2020-06-09,265,154,111,0,154,0,0,0.0
2020-06-10,252,145,107,0,145,0,0,0.0
2020-06-11,190,101,89,0,101,0,0,0.0
2020-06-12,194,114,80,0,114,0,0,0.0
2020-06-14,13,9,4,0,9,0,0,0.0
2020-06-15,221,120,101,0,120,0,0,0.0
2020-06-16,222,136,86,0,136,0,0,0.0
2020-06-17,199,99,100,0,99,0,0,0.0
2020-06-18,224,118,106,0,118,0,0,0.0
2020-06-19,146,61,85,0,61,0,0,0.0
2020-06-21,14,12,2,0,12,0,0,0.0
2020-06-22,212,114,98,0,114,0,0,0.0
2020-06-23,168,57,111,0,57,0,0,0.0
2020-06-24,205,115,90,0,115,0,0,0.0
2020-06-25,208,148,60,0,148,0,0,0.0
2020-06-26,224,143,81,0,143,0,0,0.0
2020-06-28,14,12,2,0,12,0,0,0.0
2020-06-29,196,133,63,0,133,0,0,0.0
2020-06-30,244,143,101,0,143,0,0,0.0
2020-07-01,157,53,104,0,53,0,0,0.0
2020-07-02,213,131,82,0,131,0,0,0.0
2020-07-03,164,106,58,0,106,0,0,0.0
2020-07-05,19,12,7,0,12,0,0,0.0
2020-07-06,231,125,106,0,125,0,0,0.0
2020-07-07,248,148,100,0,148,0,0,0.0
2020-07-08,259,153,106,0,153,0,0,0.0
2020-07-09,225,125,100,0,125,0,0,0.0
2020-07-10,229,133,96,0,133,0,0,0.0
2020-07-12,25,12,13,0,12,0,0,0.0
2020-07-13,179,95,84,0,95,0,0,0.0
2020-07-14,240,151,89,0,151,0,0,0.0
2020-07-15,204,143,61,0,143,0,0,0.0
2020-07-16,244,148,96,0,148,0,0,0.0
2020-07-17,206,113,93,0,113,0,0,0.0
2020-07-19,11,10,1,0,10,0,0,0.0
2020-07-20,248,142,106,0,142,0,0,0.0
2020-07-21,259,146,113,0,146,0,0,0.0
2020-07-22,221,143,78,0,143,0,0,0.0
2020-07-23,198,118,80,0,118,0,0,0.0
2020-07-24,220,124,96,0,124,0,0,0.0
2020-07-26,7,0,7,0,0,0,0,0.0
2020-07-27,208,113,95,0,113,0,0,0.0
2020-07-28,209,113,96,0,113,0,0,0.0
2020-07-29,213,116,97,0,116,0,0,0.0
2020-07-30,222,110,112,0,110,0,0,0.0
2020-07-31,235,139,96,0,139,0,0,0.0
2020-08-02,16,12,4,0,12,0,0,0.0
2020-08-03,236,150,86,0,150,0,0,0.0
2020-08-04,255,144,111,0,144,0,0,0.0
2020-08-05,193,93,100,0,93,0,0,0.0
2020-08-06,188,90,98,0,90,0,0,0.0
2020-08-07,207,113,94,0,113,0,0,0.0
2020-08-09,18,12,6,0,12,0,0,0.0
2020-08-10,207,105,102,0,105,0,0,0.0
2020-08-11,244,136,108,0,136,0,0,0.0
2020-08-12,239,139,100,0,139,0,0,0.0
2020-08-13,220,109,111,0,109,0,0,0.0
2020-08-14,193,116,77,0,116,0,0,0.0
2020-08-16,20,11,9,0,11,0,0,0.0
2020-08-17,243,151,92,0,151,0,0,0.0
2020-08-18,186,77,109,0,77,0,0,0.0
2020-08-19,253,148,105,0,148,0,0,0.0
2020-08-20,229,130,99,0,130,0,0,0.0
2020-08-21,237,141,96,0,141,0,0,0.0
2020-08-23,30,12,18,0,12,0,0,0.0
2020-08-24,199,141,58,0,141,0,0,0.0
2020-08-25,202,102,100,0,102,0,0,0.0
2020-08-26,234,129,105,0,129,0,0,0.0
2020-08-27,187,102,85,0,102,0,0,0.0
2020-08-28,229,133,96,0,133,0,0,0.0
2020-08-30,11,9,2,0,9,0,0,0.0
2020-08-31,174,147,27,0,147,0,0,0.0
2020-09-01,266,157,109,0,157,0,0,0.0
2020-09-02,152,41,111,0,41,0,0,0.0
2020-09-03,257,147,110,0,147,0,0,0.0
2020-09-04,190,122,68,0,122,0,0,0.0
2020-09-06,26,12,14,0,12,0,0,0.0
2020-09-07,246,142,104,0,142,0,0,0.0
2020-09-08,227,120,107,0,120,0,0,0.0
2020-09-09,110,81,29,0,81,0,0,0.0
2020-09-10,232,128,104,0,128,0,0,0.0
2020-09-11,199,112,87,0,112,0,0,0.0
2020-09-13,24,12,12,0,12,0,0,0.0
2020-09-14,253,153,100,0,153,0,0,0.0
2020-09-15,230,130,100,0,130,0,0,0.0
2020-09-16,215,101,114,0,101,0,0,0.0
2020-09-17,268,155,113,0,155,0,0,0.0
2020-09-18,197,104,93,0,104,0,0,0.0
2020-09-20,12,12,0,0,12,0,0,0.0
2020-09-21,198,111,87,0,111,0,0,0.0
2020-09-22,259,158,101,0,158,0,0,0.0
2020-09-23,231,133,98,0,133,0,0,0.0
2020-09-24,199,93,106,0,93,0,0,0.0
2020-09-25,227,142,85,0,142,0,0,0.0
2020-09-27,22,12,10,0,12,0,0,0.0
2020-09-28,211,102,109,0,102,0,0,0.0
2020-09-29,181,86,95,0,86,0,0,0.0
2020-09-30,254,154,100,0,154,0,0,0.0
2020-10-01,221,130,91,0,130,0,0,0.0
2020-10-02,201,117,84,0,117,0,0,0.0
2020-10-04,20,8,12,0,8,0,0,0.0
2020-10-05,211,109,102,0,109,0,0,0.0
2020-10-06,210,107,103,0,107,0,0,0.0
2020-10-07,246,155,91,0,155,0,0,0.0
2020-10-08,176,95,81,0,95,0,0,0.0
2020-10-09,213,117,96,0,117,0,0,0.0
2020-10-11,31,12,19,0,12,0,0,0.0
2020-10-12,188,82,106,0,82,0,0,0.0
2020-10-13,186,91,95,0,91,0,0,0.0
2020-10-14,240,135,105,0,135,0,0,0.0
2020-10-15,256,142,114,0,142,0,0,0.0
2020-10-16,208,112,96,0,112,0,0,0.0
2020-10-18,11,0,11,0,0,0,0,0.0
2020-10-19,214,148,66,0,148,0,0,0.0
2020-10-20,252,152,100,0,152,0,0,0.0
2020-10-21,241,133,108,0,133,0,0,0.0
2020-10-22,256,150,106,0,150,0,0,0.0
2020-10-23,160,65,95,0,65,0,0,0.0
2020-10-25,29,12,17,0,12,0,0,0.0
2020-10-26,246,139,107,0,139,0,0,0.0
2020-10-27,246,146,100,0,146,0,0,0.0
2020-10-28,219,120,99,0,120,0,0,0.0
2020-10-29,251,150,101,0,150,0,0,0.0
2020-10-30,188,92,96,0,92,0,0,0.0
2020-11-01,8,0,8,0,0,0,0,0.0
2020-11-02,244,148,96,0,148,0,0,0.0
2020-11-03,188,147,41,0,147,0,0,0.0
2020-11-04,248,136,112,0,136,0,0,0.0
2020-11-05,198,83,115,0,83,0,0,0.0
2020-11-06,185,97,88,0,97,0,0,0.0
2020-11-08,10,0,10,0,0,0,0,0.0
2020-11-09,240,147,93,0,147,0,0,0.0
2020-11-10,162,66,96,0,66,0,0,0.0
2020-11-11,176,81,95,0,81,0,0,0.0
2020-11-12,248,144,104,0,144,0,0,0.0
2020-11-13,240,144,96,0,144,0,0,0.0
2020-11-15,0,0,0,0,0,0,0,0.0
2020-11-16,233,151,82,0,151,0,0,0.0
2020-11-17,205,91,114,0,91,0,0,0.0
2020-11-18,231,123,108,0,123,0,0,0.0
2020-11-19,216,131,85,0,131,0,0,0.0
2020-11-20,160,71,89,0,71,0,0,0.0
2020-11-22,16,0,16,0,0,0,0,0.0
2020-11-23,174,129,45,0,129,0,0,0.0
2020-11-24,198,107,91,0,107,0,0,0.0
2020-11-25,191,87,104,0,87,0,0,0.0
2020-11-26,207,95,112,0,95,0,0,0.0
2020-11-27,224,128,96,0,128,0,0,0.0
2020-11-29,11,0,11,0,0,0,0,0.0
2020-11-30,232,128,104,0,128,0,0,0.0
2020-12-01,220,110,110,0,110,0,0,0.0
2020-12-02,250,135,115,0,135,0,0,0.0
2020-12-03,211,111,100,0,111,0,0,0.0
2020-12-04,175,121,54,0,121,0,0,0.0
2020-12-06,17,0,17,0,0,0,0,0.0
2020-12-07,211,142,69,0,142,0,0,0.0
2020-12-08,152,60,92,0,60,0,0,0.0
2020-12-09,261,152,109,0,152,0,0,0.0
2020-12-10,228,128,100,0,128,0,0,0.0
2020-12-11,219,123,96,0,123,0,0,0.0
2020-12-13,0,0,0,0,0,0,0,0.0
2020-12-14,182,148,34,0,148,0,0,0.0
2020-12-15,229,143,86,0,143,0,0,0.0
2020-12-16,257,151,106,0,151,0,0,0.0
2020-12-17,189,88,101,0,88,0,0,0.0
2020-12-18,168,72,96,0,72,0,0,0.0
2020-12-20,0,0,0,0,0,0,0,0.0
2020-12-21,148,130,18,0,130,0,0,0.0
2020-12-22,224,116,108,0,116,0,0,0.0
2020-12-23,168,57,111,0,57,0,0,0.0
2020-12-24,224,115,109,0,115,0,0,0.0
2020-12-25,58,0,58,0,0,0,0,0.0
2020-12-27,17,0,17,0,0,0,0,0.0
2020-12-28,223,145,78,0,145,0,0,0.0
2020-12-29,212,109,103,0,109,0,0,0.0
2020-12-30,244,145,99,0,145,0,0,0.0
2020-12-31,132,132,0,0,132,0,0,0.0
2021-01-03,10,0,10,0,0,0,0,0.0
2021-01-04,245,143,102,0,143,0,0,0.0
2021-01-05,245,140,105,0,140,0,0,0.0
2021-01-06,222,134,88,0,134,0,0,0.0
2021-01-07,245,145,100,0,145,0,0,0.0
2021-01-08,232,146,86,0,146,0,0,0.0
2021-01-10,18,0,18,0,0,0,0,0.0
2021-01-11,219,117,102,0,117,0,0,0.0
2021-01-12,182,107,75,0,107,0,0,0.0
2021-01-13,201,97,104,0,97,0,0,0.0
2021-01-14,207,107,100,0,107,0,0,0.0
2021-01-15,160,125,35,0,125,0,0,0.0
2021-01-17,5,0,5,0,0,0,0,0.0
2021-01-18,231,128,103,0,128,0,0,0.0
2021-01-19,201,105,96,0,105,0,0,0.0
2021-01-20,247,147,100,0,147,0,0,0.0
2021-01-21,252,155,97,0,155,0,0,0.0
2021-01-22,198,103,95,0,103,0,0,0.0
2021-01-24,1,0,1,0,0,0,0,0.0
2021-01-25,185,113,72,0,113,0,0,0.0
2021-01-26,177,107,70,0,107,0,0,0.0
2021-01-27,247,154,93,0,154,0,0,0.0
2021-01-28,218,114,104,0,114,0,0,0.0
2021-01-29,191,95,96,0,95,0,0,0.0
2021-01-31,18,0,18,0,0,0,0,0.0
2021-02-01,183,84,99,0,84,0,0,0.0
2021-02-02,220,133,87,0,133,0,0,0.0
2021-02-03,132,34,98,0,34,0,0,0.0
2021-02-04,254,151,103,0,151,0,0,0.0
2021-02-05,209,153,56,0,153,0,0,0.0
2021-02-07,17,0,17,0,0,0,0,0.0
2021-02-08,258,154,104,0,154,0,0,0.0
2021-02-09,191,82,109,0,82,0,0,0.0
2021-02-10,249,156,93,0,156,0,0,0.0
2021-02-11,158,135,23,0,135,0,0,0.0
2021-02-12,230,142,88,0,142,0,0,0.0
2021-02-14,11,0,11,0,0,0,0,0.0
2021-02-15,218,115,103,0,115,0,0,0.0
2021-02-16,265,152,113,0,152,0,0,0.0
2021-02-17,219,124,95,0,124,0,0,0.0
2021-02-18,176,87,89,0,87,0,0,0.0
2021-02-19,247,158,89,0,158,0,0,0.0
2021-02-21,14,0,14,0,0,0,0,0.0
2021-02-22,245,146,99,0,146,0,0,0.0
2021-02-23,242,146,96,0,146,0,0,0.0
2021-02-24,222,109,113,0,109,0,0,0.0
2021-02-25,239,131,108,0,131,0,0,0.0
2021-02-26,232,148,84,0,148,0,0,0.0
2021-02-28,6,0,6,0,0,0,0,0.0
2021-03-01,233,142,91,0,142,0,0,0.0
2021-03-02,238,132,106,0,132,0,0,0.0
2021-03-03,261,147,114,0,147,0,0,0.0
2021-03-04,265,156,109,0,156,0,0,0.0
2021-03-05,194,105,89,0,105,0,0,0.0
2021-03-07,13,0,13,0,0,0,0,0.0
2021-03-08,236,146,90,0,146,0,0,0.0
2021-03-09,257,146,111,0,146,0,0,0.0
2021-03-10,209,100,109,0,100,0,0,0.0
2021-03-11,214,110,104,0,110,0,0,0.0
2021-03-12,149,53,96,0,53,0,0,0.0
2021-03-14,22,4,18,0,4,0,0,0.0
2021-03-15,209,116,93,0,116,0,0,0.0
2021-03-16,178,78,100,0,78,0,0,0.0
2021-03-17,255,145,110,0,145,0,0,0.0
2021-03-18,237,146,91,0,146,0,0,0.0
2021-03-19,156,63,93,0,63,0,0,0.0
2021-03-21,21,12,9,0,12,0,0,0.0
2021-03-22,105,77,28,0,77,0,0,0.0
2021-03-23,220,117,103,0,117,0,0,0.0
2021-03-24,184,82,102,0,82,0,0,0.0
2021-03-25,229,119,110,0,119,0,0,0.0
2021-03-26,233,137,96,0,137,0,0,0.0
2021-03-28,28,12,16,0,12,0,0,0.0
2021-03-29,236,138,98,0,138,0,0,0.0
2021-03-30,179,69,110,0,69,0,0,0.0
2021-03-31,208,94,114,0,94,0,0,0.0
2021-04-01,215,122,93,0,122,0,0,0.0
2021-04-02,147,56,91,0,56,0,0,0.0
2021-04-04,12,0,12,0,0,0,0,0.0
2021-04-05,195,126,69,0,126,0,0,0.0
2021-04-06,177,73,104,0,73,0,0,0.0
2021-04-07,168,74,94,0,74,0,0,0.0
2021-04-08,240,143,97,0,143,0,0,0.0
2021-04-09,190,144,46,0,144,0,0,0.0
2021-04-11,30,11,19,0,11,0,0,0.0
2021-04-12,258,152,106,0,152,0,0,0.0
2021-04-13,254,140,114,0,140,0,0,0.0
2021-04-14,202,100,102,0,100,0,0,0.0
2021-04-15,220,117,103,0,117,0,0,0.0
2021-04-16,223,129,94,0,129,0,0,0.0
2021-04-18,29,12,17,0,12,0,0,0.0
2021-04-19,143,40,103,0,40,0,0,0.0
2021-04-20,242,139,103,0,139,0,0,0.0
2021-04-21,263,150,113,0,150,0,0,0.0
2021-04-22,240,127,113,0,127,0,0,0.0
2021-04-23,199,122,77,0,122,0,0,0.0
2021-04-25,29,12,17,0,12,0,0,0.0
2021-04-26,240,127,113,0,127,0,0,0.0
2021-04-27,252,140,112,0,140,0,0,0.0
2021-04-28,225,110,115,0,110,0,0,0.0
2021-04-29,210,102,108,0,102,0,0,0.0
2021-04-30,229,133,96,0,133,0,0,0.0
2021-05-02,13,12,1,0,12,0,0,0.0
2021-05-03,265,156,109,0,156,0,0,0.0
2021-05-04,253,145,108,0,145,0,0,0.0
2021-05-05,220,113,107,0,113,0,0,0.0
2021-05-06,265,156,109,0,156,0,0,0.0
2021-05-07,134,43,91,0,43,0,0,0.0
2021-05-09,0,0,0,0,0,0,0,0.0
2021-05-10,210,111,99,0,111,0,0,0.0
2021-05-11,223,123,100,0,123,0,0,0.0
2021-05-12,249,149,100,0,149,0,0,0.0
2021-05-13,178,93,85,0,93,0,0,0.0
2021-05-14,152,56,96,0,56,0,0,0.0
2021-05-16,31,12,19,0,12,0,0,0.0
2021-05-17,148,90,58,0,90,0,0,0.0
2021-05-18,176,80,96,0,80,0,0,0.0
2021-05-19,235,122,113,0,122,0,0,0.0
2021-05-20,253,139,114,0,139,0,0,0.0
2021-05-21,211,117,94,0,117,0,0,0.0
2021-05-23,16,12,4,0,12,0,0,0.0
2021-05-24,240,156,84,0,156,0,0,0.0
2021-05-25,224,134,90,0,134,0,0,0.0
2021-05-26,222,147,75,0,147,0,0,0.0
2021-05-27,263,155,108,0,155,0,0,0.0
2021-05-28,225,130,95,0,130,0,0,0.0
2021-05-30,23,12,11,0,12,0,0,0.0
2021-05-31,249,136,113,0,136,0,0,0.0
2021-06-01,217,115,102,0,115,0,0,0.0
2021-06-02,264,152,112,0,152,0,0,0.0
2021-06-03,262,151,111,0,151,0,0,0.0
2021-06-04,231,135,96,0,135,0,0,0.0
2021-06-06,29,12,17,0,12,0,0,0.0
2021-06-07,98,29,69,0,29,0,0,0.0
2021-06-08,253,148,105,0,148,0,0,0.0
2021-06-09,243,143,100,0,143,0,0,0.0
2021-06-10,254,151,103,0,151,0,0,0.0
2021-06-11,192,104,88,0,104,0,0,0.0
2021-06-13,3,0,3,0,0,0,0,0.0
2021-06-14,229,141,88,0,141,0,0,0.0
2021-06-15,169,71,98,0,71,0,0,0.0
2021-06-16,224,125,99,0,125,0,0,0.0
2021-06-17,246,145,101,0,145,0,0,0.0
2021-06-18,232,140,92,0,140,0,0,0.0
2021-06-20,12,12,0,0,12,0,0,0.0
2021-06-21,232,133,99,0,133,0,0,0.0
2021-06-22,184,83,101,0,83,0,0,0.0
2021-06-23,242,139,103,0,139,0,0,0.0
2021-06-24,229,135,94,0,135,0,0,0.0
2021-06-25,215,134,81,0,134,0,0,0.0
2021-06-27,12,12,0,0,12,0,0,0.0
2021-06-28,246,152,94,0,152,0,0,0.0
2021-06-29,251,150,101,0,150,0,0,0.0
2021-06-30,224,123,101,0,123,0,0,0.0
2021-07-01,244,150,94,0,150,0,0,0.0
2021-07-02,179,83,96,0,83,0,0,0.0
2021-07-04,31,12,19,0,12,0,0,0.0
2021-07-05,163,83,80,0,83,0,0,0.0
2021-07-06,246,142,104,0,142,0,0,0.0
2021-07-07,174,67,107,0,67,0,0,0.0
2021-07-08,244,131,113,0,131,0,0,0.0
2021-07-09,232,136,96,0,136,0,0,0.0
2021-07-11,20,12,8,0,12,0,0,0.0
2021-07-12,187,157,30,0,157,0,0,0.0
2021-07-13,233,123,110,0,123,0,0,0.0
2021-07-14,249,135,114,0,135,0,0,0.0
2021-07-15,215,103,112,0,103,0,0,0.0
2021-07-16,226,130,96,0,130,0,0,0.0
2021-07-18,26,12,14,0,12,0,0,0.0
2021-07-19,209,96,113,0,96,0,0,0.0
2021-07-20,259,152,107,0,152,0,0,0.0
2021-07-21,154,59,95,0,59,0,0,0.0
2021-07-22,173,70,103,0,70,0,0,0.0
2021-07-23,175,84,91,0,84,0,0,0.0
2021-07-25,4,0,4,0,0,0,0,0.0
2021-07-26,176,68,108,0,68,0,0,0.0
2021-07-27,227,117,110,0,117,0,0,0.0
2021-07-28,240,129,111,0,129,0,0,0.0
2021-07-29,219,108,111,0,108,0,0,0.0
2021-07-30,176,80,96,0,80,0,0,0.0
2021-08-01,16,12,4,0,12,0,0,0.0
2021-08-02,180,149,31,0,149,0,0,0.0
2021-08-03,255,145,110,0,145,0,0,0.0
2021-08-04,210,137,73,0,137,0,0,0.0
2021-08-05,246,143,103,0,143,0,0,0.0
2021-08-06,240,146,94,0,146,0,0,0.0
2021-08-08,18,11,7,0,11,0,0,0.0
2021-08-09,218,138,80,0,138,0,0,0.0
2021-08-10,216,145,71,0,145,0,0,0.0
2021-08-11,208,99,109,0,99,0,0,0.0
2021-08-12,247,138,109,0,138,0,0,0.0
2021-08-13,195,112,83,0,112,0,0,0.0
2021-08-15,13,12,1,0,12,0,0,0.0
2021-08-16,164,52,112,0,52,0,0,0.0
2021-08-17,208,107,101,0,107,0,0,0.0
2021-08-18,212,122,90,0,122,0,0,0.0
2021-08-19,150,48,102,0,48,0,0,0.0
2021-08-20,142,54,88,0,54,0,0,0.0
2021-08-22,30,12,18,0,12,0,0,0.0
2021-08-23,217,105,112,0,105,0,0,0.0
2021-08-24,255,151,104,0,151,0,0,0.0
2021-08-25,226,119,107,0,119,0,0,0.0
2021-08-26,241,133,108,0,133,0,0,0.0
2021-08-27,213,117,96,0,117,0,0,0.0
2021-08-29,18,12,6,0,12,0,0,0.0
2021-08-30,193,105,88,0,105,0,0,0.0
2021-08-31,247,146,101,0,146,0,0,0.0
2021-09-01,178,73,105,0,73,0,0,0.0
2021-09-02,235,129,106,0,129,0,0,0.0
2021-09-03,235,139,96,0,139,0,0,0.0
2021-09-05,11,7,4,0,7,0,0,0.0
2021-09-06,168,63,105,0,63,0,0,0.0
2021-09-07,217,107,110,0,107,0,0,0.0
2021-09-08,170,72,98,0,72,0,0,0.0
2021-09-09,211,101,110,0,101,0,0,0.0
2021-09-10,154,75,79,0,75,0,0,0.0
2021-09-12,10,7,3,0,7,0,0,0.0
2021-09-13,219,110,109,0,110,0,0,0.0
2021-09-14,247,144,103,0,144,0,0,0.0
2021-09-15,205,91,114,0,91,0,0,0.0
2021-09-16,185,79,106,0,79,0,0,0.0
2021-09-17,236,140,96,0,140,0,0,0.0
2021-09-19,13,12,1,0,12,0,0,0.0
2021-09-20,228,128,100,0,128,0,0,0.0
2021-09-21,224,110,114,0,110,0,0,0.0
2021-09-22,225,121,104,0,121,0,0,0.0
2021-09-23,245,149,96,0,149,0,0,0.0
2021-09-24,209,113,96,0,113,0,0,0.0
2021-09-26,12,12,0,0,12,0,0,0.0
2021-09-27,235,147,88,0,147,0,0,0.0
2021-09-28,207,95,112,0,95,0,0,0.0
2021-09-29,249,141,108,0,141,0,0,0.0
2021-09-30,262,153,109,0,153,0,0,0.0
2021-10-01,148,58,90,0,58,0,0,0.0
2021-10-03,12,12,0,0,12,0,0,0.0
2021-10-04,233,155,78,0,155,0,0,0.0
2021-10-05,265,153,112,0,153,0,0,0.0
2021-10-06,210,99,111,0,99,0,0,0.0
2021-10-07,237,125,112,0,125,0,0,0.0
2021-10-08,241,145,96,0,145,0,0,0.0
2021-10-10,15,12,3,0,12,0,0,0.0
2021-10-11,228,129,99,0,129,0,0,0.0
2021-10-12,142,45,97,0,45,0,0,0.0
2021-10-13,236,124,112,0,124,0,0,0.0
2021-10-14,244,138,106,0,138,0,0,0.0
2021-10-15,238,142,96,0,142,0,0,0.0
2021-10-17,14,12,2,0,12,0,0,0.0
2021-10-18,109,45,64,0,45,0,0,0.0
2021-10-19,223,115,108,0,115,0,0,0.0
2021-10-20,172,61,111,0,61,0,0,0.0
2021-10-21,207,101,106,0,101,0,0,0.0
2021-10-22,223,127,96,0,127,0,0,0.0
2021-10-24,27,12,15,0,12,0,0,0.0
2021-10-25,220,119,101,0,119,0,0,0.0
2021-10-26,207,108,99,0,108,0,0,0.0
2021-10-27,225,120,105,0,120,0,0,0.0
2021-10-28,195,98,97,0,98,0,0,0.0
2021-10-29,201,105,96,0,105,0,0,0.0
2021-10-31,19,12,7,0,12,0,0,0.0
2021-11-01,221,131,90,0,131,0,0,0.0
2021-11-02,230,133,97,0,133,0,0,0.0
2021-11-03,243,136,107,0,136,0,0,0.0
2021-11-04,266,152,114,0,152,0,0,0.0
2021-11-05,201,109,92,0,109,0,0,0.0
2021-11-07,19,0,19,0,0,0,0,0.0
2021-11-08,263,149,114,0,149,0,0,0.0
2021-11-09,244,133,111,0,133,0,0,0.0
2021-11-10,248,154,94,0,154,0,0,0.0
2021-11-11,225,124,101,0,124,0,0,0.0
2021-11-12,225,129,96,0,129,0,0,0.0
2021-11-14,17,0,17,0,0,0,0,0.0
2021-11-15,239,143,96,0,143,0,0,0.0
2021-11-16,250,136,114,0,136,0,0,0.0
2021-11-17,254,150,104,0,150,0,0,0.0
2021-11-18,132,69,63,0,69,0,0,0.0
2021-11-19,233,137,96,0,137,0,0,0.0
2021-11-21,18,0,18,0,0,0,0,0.0
2021-11-22,220,120,100,0,120,0,0,0.0
2021-11-23,182,81,101,0,81,0,0,0.0
2021-11-24,242,152,90,0,152,0,0,0.0
2021-11-25,147,100,47,0,100,0,0,0.0
2021-11-26,203,107,96,0,107,0,0,0.0
2021-11-28,11,0,11,0,0,0,0,0.0
2021-11-29,138,82,56,0,82,0,0,0.0
2021-11-30,266,155,111,0,155,0,0,0.0
2021-12-01,231,122,109,0,122,0,0,0.0
2021-12-02,247,135,112,0,135,0,0,0.0
2021-12-03,226,152,74,0,152,0,0,0.0
2021-12-05,14,0,14,0,0,0,0,0.0
2021-12-06,247,134,113,0,134,0,0,0.0
2021-12-07,164,60,104,0,60,0,0,0.0
2021-12-08,227,140,87,0,140,0,0,0.0
2021-12-09,241,134,107,0,134,0,0,0.0
2021-12-10,250,155,95,0,155,0,0,0.0
2021-12-12,17,0,17,0,0,0,0,0.0
2021-12-13,249,138,111,0,138,0,0,0.0
2021-12-14,248,146,102,0,146,0,0,0.0
2021-12-15,228,133,95,0,133,0,0,0.0
2021-12-16,247,134,113,0,134,0,0,0.0
2021-12-17,249,156,93,0,156,0,0,0.0
2021-12-19,11,0,11,0,0,0,0,0.0
2021-12-20,218,126,92,0,126,0,0,0.0
2021-12-21,241,140,101,0,140,0,0,0.0
2021-12-22,157,80,77,0,80,0,0,0.0
2021-12-23,238,123,115,0,123,0,0,0.0
2021-12-24,216,120,96,0,120,0,0,0.0
2021-12-26,2,0,2,0,0,0,0,0.0
2021-12-27,224,151,73,0,151,0,0,0.0
2021-12-28,245,144,101,0,144,0,0,0.0
2021-12-29,202,89,113,0,89,0,0,0.0
2021-12-30,193,78,115,0,78,0,0,0.0
2021-12-31,219,123,96,0,123,0,0,0.0
2022-01-02,18,0,18,0,0,0,0,0.0
2022-01-03,264,149,115,0,149,0,0,0.0
2022-01-04,267,153,114,0,153,0,0,0.0
2022-01-05,240,125,115,0,125,0,0,0.0
2022-01-06,206,91,115,0,91,0,0,0.0
2022-01-07,253,157,96,0,157,0,0,0.0
2022-01-09,6,0,6,0,0,0,0,0.0
2022-01-10,237,132,105,0,132,0,0,0.0
2022-01-11,258,146,112,0,146,0,0,0.0
2022-01-12,248,141,107,0,141,0,0,0.0
2022-01-13,238,141,97,0,141,0,0,0.0
2022-01-14,241,145,96,0,145,0,0,0.0
2022-01-16,18,0,18,0,0,0,0,0.0
2022-01-17,213,107,106,0,107,0,0,0.0
2022-01-18,237,139,98,0,139,0,0,0.0
2022-01-19,254,139,115,0,139,0,0,0.0
2022-01-20,251,143,108,0,143,0,0,0.0
2022-01-21,230,134,96,0,134,0,0,0.0
2022-01-23,16,0,16,0,0,0,0,0.0
2022-01-24,217,103,114,0,103,0,0,0.0
2022-01-25,260,153,107,0,153,0,0,0.0
2022-01-26,244,145,99,0,145,0,0,0.0
2022-01-27,218,115,103,0,115,0,0,0.0
2022-01-28,205,111,94,0,111,0,0,0.0
2022-01-30,17,0,17,0,0,0,0,0.0
2022-01-31,235,123,112,0,123,0,0,0.0
2022-02-01,226,112,114,0,112,0,0,0.0
2022-02-02,254,143,111,0,143,0,0,0.0
2022-02-03,203,115,88,0,115,0,0,0.0
2022-02-04,246,156,90,0,156,0,0,0.0
2022-02-06,3,0,3,0,0,0,0,0.0
2022-02-07,211,155,56,0,155,0,0,0.0
2022-02-08,250,139,111,0,139,0,0,0.0
2022-02-09,208,97,111,0,97,0,0,0.0
2022-02-10,269,155,114,0,155,0,0,0.0
2022-02-11,165,77,88,0,77,0,0,0.0
2022-02-13,18,0,18,0,0,0,0,0.0
2022-02-14,209,139,70,0,139,0,0,0.0
2022-02-15,214,109,105,0,109,0,0,0.0
2022-02-16,215,107,108,0,107,0,0,0.0
2022-02-17,164,61,103,0,61,0,0,0.0
2022-02-18,169,73,96,0,73,0,0,0.0
2022-02-20,17,0,17,0,0,0,0,0.0
2022-02-21,241,133,108,0,133,0,0,0.0
2022-02-22,233,126,107,0,126,0,0,0.0
2022-02-23,213,117,96,0,117,0,0,0.0
2022-02-24,217,104,113,0,104,0,0,0.0
2022-02-25,229,133,96,0,133,0,0,0.0
2022-02-27,0,0,0,0,0,0,0,0.0
2022-02-28,146,128,18,0,128,0,0,0.0
2022-03-01,195,87,108,0,87,0,0,0.0
2022-03-02,241,137,104,0,137,0,0,0.0
2022-03-03,230,120,110,0,120,0,0,0.0
2022-03-04,235,140,95,0,140,0,0,0.0
2022-03-06,2,0,2,0,0,0,0,0.0
2022-03-07,193,138,55,0,138,0,0,0.0
2022-03-08,234,128,106,0,128,0,0,0.0
2022-03-09,193,79,114,0,79,0,0,0.0
2022-03-10,256,147,109,0,147,0,0,0.0
2022-03-11,249,153,96,0,153,0,0,0.0
2022-03-13,31,12,19,0,12,0,0,0.0
2022-03-14,192,96,96,0,96,0,0,0.0
2022-03-15,205,104,101,0,104,0,0,0.0
2022-03-16,210,103,107,0,103,0,0,0.0
2022-03-17,204,142,62,0,142,0,0,0.0
2022-03-18,201,106,95,0,106,0,0,0.0
2022-03-20,24,12,12,0,12,0,0,0.0
2022-03-21,155,126,29,0,126,0,0,0.0
2022-03-22,246,136,110,0,136,0,0,0.0
2022-03-23,210,113,97,0,113,0,0,0.0
2022-03-24,208,114,94,0,114,0,0,0.0
2022-03-25,131,35,96,0,35,0,0,0.0
2022-03-27,17,0,17,0,0,0,0,0.0
2022-03-28,235,125,110,0,125,0,0,0.0
2022-03-29,168,63,105,0,63,0,0,0.0
2022-03-30,156,51,105,0,51,0,0,0.0
2022-03-31,169,65,104,0,65,0,0,0.0
2022-04-01,215,119,96,0,119,0,0,0.0
2022-04-03,14,12,2,0,12,0,0,0.0
2022-04-04,170,126,44,0,126,0,0,0.0
2022-04-05,217,114,103,0,114,0,0,0.0
2022-04-06,222,124,98,0,124,0,0,0.0
2022-04-07,145,38,107,0,38,0,0,0.0
2022-04-08,167,82,85,0,82,0,0,0.0
2022-04-10,27,12,15,0,12,0,0,0.0
2022-04-11,216,104,112,0,104,0,0,0.0
2022-04-12,220,122,98,0,122,0,0,0.0
2022-04-13,215,108,107,0,108,0,0,0.0
2022-04-14,243,134,109,0,134,0,0,0.0
2022-04-15,185,89,96,0,89,0,0,0.0
2022-04-17,11,10,1,0,10,0,0,0.0
2022-04-18,174,151,23,0,151,0,0,0.0
2022-04-19,216,119,97,0,119,0,0,0.0
2022-04-20,206,126,80,0,126,0,0,0.0
2022-04-21,195,114,81,0,114,0,0,0.0
2022-04-22,230,139,91,0,139,0,0,0.0
2022-04-24,4,3,1,0,3,0,0,0.0
2022-04-25,186,103,83,0,103,0,0,0.0
2022-04-26,207,115,92,0,115,0,0,0.0
2022-04-27,225,118,107,0,118,0,0,0.0
2022-04-28,215,113,102,0,113,0,0,0.0
2022-04-29,229,133,96,0,133,0,0,0.0
2022-05-01,14,12,2,0,12,0,0,0.0
2022-05-02,212,149,63,0,149,0,0,0.0
2022-05-03,228,131,97,0,131,0,0,0.0
2022-05-04,178,121,57,0,121,0,0,0.0
2022-05-05,193,129,64,0,129,0,0,0.0
2022-05-06,185,89,96,0,89,0,0,0.0
2022-05-08,0,0,0,0,0,0,0,0.0
2022-05-09,227,126,101,0,126,0,0,0.0
2022-05-10,211,139,72,0,139,0,0,0.0
2022-05-11,204,154,50,0,154,0,0,0.0
2022-05-12,182,85,97,0,85,0,0,0.0
2022-05-13,224,134,90,0,134,0,0,0.0
2022-05-15,23,11,12,0,11,0,0,0.0
2022-05-16,127,30,97,0,30,0,0,0.0
2022-05-17,253,144,109,0,144,0,0,0.0
2022-05-18,262,156,106,0,156,0,0,0.0
2022-05-19,244,149,95,0,149,0,0,0.0
2022-05-20,165,87,78,0,87,0,0,0.0
2022-05-22,2,2,0,0,2,0,0,0.0
2022-05-23,189,96,93,0,96,0,0,0.0
2022-05-24,220,117,103,0,117,0,0,0.0
2022-05-25,218,107,111,0,107,0,0,0.0
2022-05-26,206,95,111,0,95,0,0,0.0
2022-05-27,211,117,94,0,117,0,0,0.0
2022-05-29,24,8,16,0,8,0,0,0.0
2022-05-30,243,131,112,0,131,0,0,0.0
2022-05-31,188,74,114,0,74,0,0,0.0
2022-06-01,245,137,108,0,137,0,0,0.0
2022-06-02,253,147,106,0,147,0,0,0.0
2022-06-03,204,129,75,0,129,0,0,0.0
2022-06-05,22,12,10,0,12,0,0,0.0
2022-06-06,232,127,105,0,127,0,0,0.0
2022-06-07,223,115,108,0,115,0,0,0.0
2022-06-08,239,124,115,0,124,0,0,0.0
2022-06-09,219,133,86,0,133,0,0,0.0
2022-06-10,213,117,96,0,117,0,0,0.0
2022-06-12,21,12,9,0,12,0,0,0.0
2022-06-13,211,109,102,0,109,0,0,0.0
2022-06-14,232,121,111,0,121,0,0,0.0
2022-06-15,255,152,103,0,152,0,0,0.0
2022-06-16,242,136,106,0,136,0,0,0.0
2022-06-17,236,140,96,0,140,0,0,0.0
2022-06-19,20,12,8,0,12,0,0,0.0
2022-06-20,145,54,91,0,54,0,0,0.0
2022-06-21,206,116,90,0,116,0,0,0.0
2022-06-22,216,107,109,0,107,0,0,0.0
2022-06-23,184,74,110,0,74,0,0,0.0
2022-06-24,216,120,96,0,120,0,0,0.0
2022-06-26,12,1,11,0,1,0,0,0.0
2022-06-27,203,104,99,0,104,0,0,0.0
2022-06-28,171,68,103,0,68,0,0,0.0
2022-06-29,171,72,99,0,72,0,0,0.0
2022-06-30,203,127,76,0,127,0,0,0.0
2022-07-01,170,74,96,0,74,0,0,0.0
2022-07-03,12,0,12,0,0,0,0,0.0
2022-07-04,217,117,100,0,117,0,0,0.0
2022-07-05,178,65,113,0,65,0,0,0.0
2022-07-06,233,122,111,0,122,0,0,0.0
2022-07-07,238,133,105,0,133,0,0,0.0
2022-07-08,223,134,89,0,134,0,0,0.0
2022-07-10,31,12,19,0,12,0,0,0.0
2022-07-11,256,154,102,0,154,0,0,0.0
2022-07-12,226,121,105,0,121,0,0,0.0
2022-07-13,224,112,112,0,112,0,0,0.0
2022-07-14,239,138,101,0,138,0,0,0.0
2022-07-15,188,114,74,0,114,0,0,0.0
2022-07-17,23,10,13,0,10,0,0,0.0
2022-07-18,268,153,115,0,153,0,0,0.0
2022-07-19,231,128,103,0,128,0,0,0.0
2022-07-20,248,136,112,0,136,0,0,0.0
2022-07-21,259,150,109,0,150,0,0,0.0
2022-07-22,221,138,83,0,138,0,0,0.0
2022-07-24,25,12,13,0,12,0,0,0.0
2022-07-25,219,129,90,0,129,0,0,0.0
2022-07-26,234,129,105,0,129,0,0,0.0
2022-07-27,236,133,103,0,133,0,0,0.0
2022-07-28,176,73,103,0,73,0,0,0.0
2022-07-29,208,136,72,0,136,0,0,0.0
2022-07-31,25,12,13,0,12,0,0,0.0
2022-08-01,233,121,112,0,121,0,0,0.0
2022-08-02,219,114,105,0,114,0,0,0.0
2022-08-03,217,142,75,0,142,0,0,0.0
2022-08-04,245,135,110,0,135,0,0,0.0
2022-08-05,219,126,93,0,126,0,0,0.0
2022-08-07,16,6,10,0,6,0,0,0.0
2022-08-08,180,121,59,0,121,0,0,0.0
2022-08-09,175,71,104,0,71,0,0,0.0
2022-08-10,225,126,99,0,126,0,0,0.0
2022-08-11,219,126,93,0,126,0,0,0.0
2022-08-12,199,103,96,0,103,0,0,0.0
2022-08-14,23,11,12,0,11,0,0,0.0
2022-08-15,245,140,105,0,140,0,0,0.0
2022-08-16,253,148,105,0,148,0,0,0.0
2022-08-17,201,98,103,0,98,0,0,0.0
2022-08-18,227,130,97,0,130,0,0,0.0
2022-08-19,169,73,96,0,73,0,0,0.0
2022-08-21,10,0,10,0,0,0,0,0.0
2022-08-22,252,143,109,0,143,0,0,0.0
2022-08-23,260,145,115,0,145,0,0,0.0
2022-08-24,166,62,104,0,62,0,0,0.0
2022-08-25,205,96,109,0,96,0,0,0.0
2022-08-26,231,135,96,0,135,0,0,0.0
2022-08-28,25,12,13,0,12,0,0,0.0
2022-08-29,255,155,100,0,155,0,0,0.0
2022-08-30,218,111,107,0,111,0,0,0.0
2022-08-31,202,95,107,0,95,0,0,0.0
2022-09-01,221,112,109,0,112,0,0,0.0
2022-09-02,144,52,92,0,52,0,0,0.0
2022-09-04,17,0,17,0,0,0,0,0.0
2022-09-05,178,96,82,0,96,0,0,0.0
2022-09-06,247,143,104,0,143,0,0,0.0
2022-09-07,255,142,113,0,142,0,0,0.0
2022-09-08,127,42,85,0,42,0,0,0.0
2022-09-09,202,107,95,0,107,0,0,0.0
2022-09-11,18,4,14,0,4,0,0,0.0
2022-09-12,197,106,91,0,106,0,0,0.0
2022-09-13,149,65,84,0,65,0,0,0.0
2022-09-14,173,73,100,0,73,0,0,0.0
2022-09-15,159,70,89,0,70,0,0,0.0
2022-09-16,206,133,73,0,133,0,0,0.0
2022-09-18,27,11,16,0,11,0,0,0.0
2022-09-19,205,101,104,0,101,0,0,0.0
2022-09-20,129,22,107,0,22,0,0,0.0
2022-09-21,245,130,115,0,130,0,0,0.0
2022-09-22,231,134,97,0,134,0,0,0.0
2022-09-23,233,141,92,0,141,0,0,0.0
2022-09-25,20,12,8,0,12,0,0,0.0
2022-09-26,257,148,109,0,148,0,0,0.0
2022-09-27,230,126,104,0,126,0,0,0.0
2022-09-28,237,128,109,0,128,0,0,0.0
2022-09-29,184,86,98,0,86,0,0,0.0
2022-09-30,210,124,86,0,124,0,0,0.0
2022-10-02,25,9,16,0,9,0,0,0.0
2022-10-03,259,145,114,0,145,0,0,0.0
2022-10-04,249,141,108,0,141,0,0,0.0
2022-10-05,170,92,78,0,92,0,0,0.0
2022-10-06,214,149,65,0,149,0,0,0.0
2022-10-07,176,113,63,0,113,0,0,0.0
2022-10-09,15,6,9,0,6,0,0,0.0
2022-10-10,223,134,89,0,134,0,0,0.0
2022-10-11,215,117,98,0,117,0,0,0.0
2022-10-12,240,127,113,0,127,0,0,0.0
2022-10-13,101,48,53,0,48,0,0,0.0
2022-10-14,230,140,90,0,140,0,0,0.0
2022-10-16,18,12,6,0,12,0,0,0.0
2022-10-17,176,112,64,0,112,0,0,0.0
2022-10-18,245,138,107,0,138,0,0,0.0
2022-10-19,207,141,66,0,141,0,0,0.0
2022-10-20,231,124,107,0,124,0,0,0.0
2022-10-21,226,130,96,0,130,0,0,0.0
2022-10-23,25,11,14,0,11,0,0,0.0
2022-10-24,181,154,27,0,154,0,0,0.0
2022-10-25,154,126,28,0,126,0,0,0.0
2022-10-26,161,119,42,0,119,0,0,0.0
2022-10-27,174,84,90,0,84,0,0,0.0
2022-10-28,148,71,77,0,71,0,0,0.0
2022-10-30,9,6,3,0,6,0,0,0.0
2022-10-31,226,113,113,0,113,0,0,0.0
2022-11-01,249,145,104,0,145,0,0,0.0
2022-11-02,186,73,113,0,73,0,0,0.0
2022-11-03,183,81,102,0,81,0,0,0.0
2022-11-04,115,59,56,0,59,0,0,0.0
2022-11-06,0,0,0,0,0,0,0,0.0
2022-11-07,148,81,67,0,81,0,0,0.0
2022-11-08,251,140,111,0,140,0,0,0.0
2022-11-09,190,86,104,0,86,0,0,0.0
2022-11-10,266,152,114,0,152,0,0,0.0
2022-11-11,228,132,96,0,132,0,0,0.0
2022-11-13,0,0,0,0,0,0,0,0.0
2022-11-14,171,137,34,0,137,0,0,0.0
2022-11-15,219,110,109,0,110,0,0,0.0
2022-11-16,185,73,112,0,73,0,0,0.0
2022-11-17,203,105,98,0,105,0,0,0.0
2022-11-18,186,90,96,0,90,0,0,0.0
2022-11-20,15,0,15,0,0,0,0,0.0
2022-11-21,232,137,95,0,137,0,0,0.0
2022-11-22,231,118,113,0,118,0,0,0.0
2022-11-23,249,141,108,0,141,0,0,0.0
2022-11-24,244,135,109,0,135,0,0,0.0
2022-11-25,236,145,91,0,145,0,0,0.0
2022-11-27,10,0,10,0,0,0,0,0.0
2022-11-28,220,118,102,0,118,0,0,0.0
2022-11-29,230,122,108,0,122,0,0,0.0
2022-11-30,238,140,98,0,140,0,0,0.0
2022-12-01,239,124,115,0,124,0,0,0.0
2022-12-02,253,157,96,0,157,0,0,0.0
2022-12-04,2,0,2,0,0,0,0,0.0
2022-12-05,219,157,62,0,157,0,0,0.0
2022-12-06,251,145,106,0,145,0,0,0.0
2022-12-07,214,109,105,0,109,0,0,0.0
2022-12-08,180,75,105,0,75,0,0,0.0
2022-12-09,244,148,96,0,148,0,0,0.0
2022-12-11,17,0,17,0,0,0,0,0.0
2022-12-12,201,104,97,0,104,0,0,0.0
2022-12-13,217,124,93,0,124,0,0,0.0
2022-12-14,228,123,105,0,123,0,0,0.0
2022-12-15,265,151,114,0,151,0,0,0.0
2022-12-16,218,122,96,0,122,0,0,0.0
2022-12-18,12,0,12,0,0,0,0,0.0
2022-12-19,174,142,32,0,142,0,0,0.0
2022-12-20,230,121,109,0,121,0,0,0.0
2022-12-21,237,141,96,0,141,0,0,0.0
2022-12-22,236,126,110,0,126,0,0,0.0
2022-12-23,202,107,95,0,107,0,0,0.0
2022-12-25,11,0,11,0,0,0,0,0.0
2022-12-26,263,154,109,0,154,0,0,0.0
2022-12-27,208,126,82,0,126,0,0,0.0
2022-12-28,248,133,115,0,133,0,0,0.0
2022-12-29,229,120,109,0,120,0,0,0.0
2022-12-30,192,96,96,0,96,0,0,0.0
2023-01-01,8,0,8,0,0,0,0,0.0
2023-01-02,155,116,39,0,116,0,0,0.0
2023-01-03,180,66,114,0,66,0,0,0.0
2023-01-04,262,151,111,0,151,0,0,0.0
2023-01-05,154,51,103,0,51,0,0,0.0
2023-01-06,226,130,96,0,130,0,0,0.0
2023-01-08,17,0,17,0,0,0,0,0.0
2023-01-09,219,119,100,0,119,0,0,0.0
2023-01-10,179,107,72,0,107,0,0,0.0
2023-01-11,213,110,103,0,110,0,0,0.0
2023-01-12,254,147,107,0,147,0,0,0.0
2023-01-13,208,126,82,0,126,0,0,0.0
2023-01-15,15,0,15,0,0,0,0,0.0
2023-01-16,161,47,114,0,47,0,0,0.0
2023-01-17,247,132,115,0,132,0,0,0.0
2023-01-18,192,91,101,0,91,0,0,0.0
2023-01-19,180,81,99,0,81,0,0,0.0
2023-01-20,252,156,96,0,156,0,0,0.0
2023-01-22,16,0,16,0,0,0,0,0.0
2023-01-23,256,148,108,0,148,0,0,0.0
2023-01-24,262,153,109,0,153,0,0,0.0
2023-01-25,253,143,110,0,143,0,0,0.0
2023-01-26,252,142,110,0,142,0,0,0.0
2023-01-27,142,46,96,0,46,0,0,0.0
2023-01-29,6,0,6,0,0,0,0,0.0
2023-01-30,249,137,112,0,137,0,0,0.0
2023-01-31,257,144,113,0,144,0,0,0.0
2023-02-01,258,148,110,0,148,0,0,0.0
2023-02-02,230,120,110,0,120,0,0,0.0
2023-02-03,233,144,89,0,144,0,0,0.0
2023-02-05,4,0,4,0,0,0,0,0.0
2023-02-06,158,141,17,0,141,0,0,0.0
2023-02-07,218,126,92,0,126,0,0,0.0
2023-02-08,198,107,91,0,107,0,0,0.0
2023-02-09,233,134,99,0,134,0,0,0.0
2023-02-10,233,139,94,0,139,0,0,0.0
2023-02-12,13,0,13,0,0,0,0,0.0
2023-02-13,204,100,104,0,100,0,0,0.0
2023-02-14,242,136,106,0,136,0,0,0.0
2023-02-15,239,134,105,0,134,0,0,0.0
2023-02-16,219,114,105,0,114,0,0,0.0
2023-02-17,226,130,96,0,130,0,0,0.0
2023-02-19,15,0,15,0,0,0,0,0.0
2023-02-20,186,86,100,0,86,0,0,0.0
2023-02-21,191,85,106,0,85,0,0,0.0
2023-02-22,250,148,102,0,148,0,0,0.0
2023-02-23,232,133,99,0,133,0,0,0.0
2023-02-24,227,153,74,0,153,0,0,0.0
2023-02-26,12,0,12,0,0,0,0,0.0
2023-02-27,238,140,98,0,140,0,0,0.0
2023-02-28,206,108,98,0,108,0,0,0.0
2023-03-01,267,155,112,0,155,0,0,0.0
2023-03-02,188,90,98,0,90,0,0,0.0
2023-03-03,181,124,57,0,124,0,0,0.0
2023-03-05,16,0,16,0,0,0,0,0.0
2023-03-06,208,97,111,0,97,0,0,0.0
2023-03-07,248,140,108,0,140,0,0,0.0
2023-03-08,180,73,107,0,73,0,0,0.0
2023-03-09,240,129,111,0,129,0,0,0.0
2023-03-10,253,157,96,0,157,0,0,0.0
2023-03-12,16,12,4,0,12,0,0,0.0
2023-03-13,174,147,27,0,147,0,0,0.0
2023-03-14,184,76,108,0,76,0,0,0.0
2023-03-15,249,145,104,0,145,0,0,0.0
2023-03-16,206,98,108,0,98,0,0,0.0
2023-03-17,192,96,96,0,96,0,0,0.0
2023-03-19,30,12,18,0,12,0,0,0.0
2023-03-20,159,78,81,0,78,0,0,0.0
2023-03-21,232,136,96,0,136,0,0,0.0
2023-03-22,216,127,89,0,127,0,0,0.0
2023-03-23,243,135,108,0,135,0,0,0.0
2023-03-24,211,116,95,0,116,0,0,0.0
2023-03-26,15,12,3,0,12,0,0,0.0
2023-03-27,185,125,60,0,125,0,0,0.0
2023-03-28,216,105,111,0,105,0,0,0.0
2023-03-29,259,145,114,0,145,0,0,0.0
2023-03-30,253,141,112,0,141,0,0,0.0
2023-03-31,206,110,96,0,110,0,0,0.0
2023-04-02,13,12,1,0,12,0,0,0.0
2023-04-03,247,147,100,0,147,0,0,0.0
2023-04-04,258,153,105,0,153,0,0,0.0
2023-04-05,205,108,97,0,108,0,0,0.0
2023-04-06,183,88,95,0,88,0,0,0.0
2023-04-07,129,59,70,0,59,0,0,0.0
2023-04-09,5,0,5,0,0,0,0,0.0
2023-04-10,242,142,100,0,142,0,0,0.0
2023-04-11,239,124,115,0,124,0,0,0.0
2023-04-12,242,136,106,0,136,0,0,0.0
2023-04-13,166,117,49,0,117,0,0,0.0
2023-04-14,236,143,93,0,143,0,0,0.0
2023-04-16,27,10,17,0,10,0,0,0.0
2023-04-17,206,124,82,0,124,0,0,0.0
2023-04-18,228,144,84,0,144,0,0,0.0
2023-04-19,230,135,95,0,135,0,0,0.0
2023-04-20,170,91,79,0,91,0,0,0.0
2023-04-21,236,141,95,0,141,0,0,0.0
2023-04-23,29,12,17,0,12,0,0,0.0
2023-04-24,232,141,91,0,141,0,0,0.0
2023-04-25,199,111,88,0,111,0,0,0.0
2023-04-26,204,96,108,0,96,0,0,0.0
2023-04-27,134,56,78,0,56,0,0,0.0
2023-04-28,219,131,88,0,131,0,0,0.0
2023-04-30,23,12,11,0,12,0,0,0.0
2023-05-01,243,136,107,0,136,0,0,0.0
2023-05-02,243,139,104,0,139,0,0,0.0
2023-05-03,206,110,96,0,110,0,0,0.0
2023-05-04,181,141,40,0,141,0,0,0.0
2023-05-05,162,66,96,0,66,0,0,0.0
2023-05-07,18,0,18,0,0,0,0,0.0
2023-05-08,221,132,89,0,132,0,0,0.0
2023-05-09,178,83,95,0,83,0,0,0.0
2023-05-10,172,71,101,0,71,0,0,0.0
2023-05-11,245,144,101,0,144,0,0,0.0
2023-05-12,190,119,71,0,119,0,0,0.0
2023-05-14,18,12,6,0,12,0,0,0.0
2023-05-15,166,69,97,0,69,0,0,0.0
2023-05-16,250,141,109,0,141,0,0,0.0
2023-05-17,225,128,97,0,128,0,0,0.0
2023-05-18,200,116,84,0,116,0,0,0.0
2023-05-19,223,127,96,0,127,0,0,0.0
2023-05-21,31,12,19,0,12,0,0,0.0
2023-05-22,195,124,71,0,124,0,0,0.0
2023-05-23,140,37,103,0,37,0,0,0.0
2023-05-24,248,138,110,0,138,0,0,0.0
2023-05-25,234,133,101,0,133,0,0,0.0
2023-05-26,217,127,90,0,127,0,0,0.0
2023-05-28,14,12,2,0,12,0,0,0.0
2023-05-29,261,155,106,0,155,0,0,0.0
2023-05-30,163,73,90,0,73,0,0,0.0
2023-05-31,217,130,87,0,130,0,0,0.0
2023-06-01,234,144,90,0,144,0,0,0.0
2023-06-02,228,144,84,0,144,0,0,0.0
2023-06-04,24,12,12,0,12,0,0,0.0
2023-06-05,198,107,91,0,107,0,0,0.0
2023-06-06,158,84,74,0,84,0,0,0.0
2023-06-07,264,154,110,0,154,0,0,0.0
2023-06-08,247,138,109,0,138,0,0,0.0
2023-06-09,186,90,96,0,90,0,0,0.0
2023-06-11,13,4,9,0,4,0,0,0.0
2023-06-12,241,158,83,0,158,0,0,0.0
2023-06-13,225,119,106,0,119,0,0,0.0
2023-06-14,236,126,110,0,126,0,0,0.0
2023-06-15,246,133,113,0,133,0,0,0.0
2023-06-16,234,139,95,0,139,0,0,0.0
2023-06-18,20,12,8,0,12,0,0,0.0
2023-06-19,208,143,65,0,143,0,0,0.0
2023-06-20,258,154,104,0,154,0,0,0.0
2023-06-21,246,132,114,0,132,0,0,0.0
2023-06-22,224,140,84,0,140,0,0,0.0
2023-06-23,233,143,90,0,143,0,0,0.0
2023-06-25,24,11,13,0,11,0,0,0.0
2023-06-26,233,126,107,0,126,0,0,0.0
2023-06-27,233,135,98,0,135,0,0,0.0
2023-06-28,181,86,95,0,86,0,0,0.0
2023-06-29,130,48,82,0,48,0,0,0.0
2023-06-30,219,136,83,0,136,0,0,0.0
2023-07-02,24,12,12,0,12,0,0,0.0
2023-07-03,226,126,100,0,126,0,0,0.0
2023-07-04,233,144,89,0,144,0,0,0.0
2023-07-05,237,128,109,0,128,0,0,0.0
2023-07-06,198,88,110,0,88,0,0,0.0
2023-07-07,227,135,92,0,135,0,0,0.0
2023-07-09,10,10,0,0,10,0,0,0.0
2023-07-10,240,142,98,0,142,0,0,0.0
2023-07-11,216,105,111,0,105,0,0,0.0
2023-07-12,238,125,113,0,125,0,0,0.0
2023-07-13,240,137,103,0,137,0,0,0.0
2023-07-14,207,112,95,0,112,0,0,0.0
2023-07-16,14,11,3,0,11,0,0,0.0
2023-07-17,242,137,105,0,137,0,0,0.0
2023-07-18,244,136,108,0,136,0,0,0.0
2023-07-19,221,113,108,0,113,0,0,0.0
2023-07-20,258,149,109,0,149,0,0,0.0
2023-07-21,190,97,93,0,97,0,0,0.0
2023-07-23,23,12,11,0,12,0,0,0.0
2023-07-24,266,151,115,0,151,0,0,0.0
2023-07-25,195,113,82,0,113,0,0,0.0
2023-07-26,248,141,107,0,141,0,0,0.0
2023-07-27,238,144,94,0,144,0,0,0.0
2023-07-28,171,122,49,0,122,0,0,0.0
2023-07-30,28,12,16,0,12,0,0,0.0
2023-07-31,199,96,103,0,96,0,0,0.0
2023-08-01,224,125,99,0,125,0,0,0.0
2023-08-02,219,130,89,0,130,0,0,0.0
2023-08-03,199,95,104,0,95,0,0,0.0
2023-08-04,214,123,91,0,123,0,0,0.0
2023-08-06,26,12,14,0,12,0,0,0.0
2023-08-07,228,123,105,0,123,0,0,0.0
2023-08-08,217,104,113,0,104,0,0,0.0
2023-08-09,247,142,105,0,142,0,0,0.0
2023-08-10,230,121,109,0,121,0,0,0.0
2023-08-11,154,96,58,0,96,0,0,0.0
2023-08-13,20,11,9,0,11,0,0,0.0
2023-08-14,185,134,51,0,134,0,0,0.0
2023-08-15,168,75,93,0,75,0,0,0.0
2023-08-16,226,123,103,0,123,0,0,0.0
2023-08-17,246,132,114,0,132,0,0,0.0
2023-08-18,223,127,96,0,127,0,0,0.0
2023-08-20,19,12,7,0,12,0,0,0.0
2023-08-21,176,120,56,0,120,0,0,0.0
2023-08-22,246,143,103,0,143,0,0,0.0
2023-08-23,256,147,109,0,147,0,0,0.0
2023-08-24,193,85,108,0,85,0,0,0.0
2023-08-25,221,126,95,0,126,0,0,0.0
2023-08-27,28,12,16,0,12,0,0,0.0
2023-08-28,159,65,94,0,65,0,0,0.0
2023-08-29,243,155,88,0,155,0,0,0.0
2023-08-30,234,119,115,0,119,0,0,0.0
2023-08-31,220,121,99,0,121,0,0,0.0
2023-09-01,185,112,73,0,112,0,0,0.0
2023-09-03,26,12,14,0,12,0,0,0.0
2023-09-04,183,100,83,0,100,0,0,0.0
2023-09-05,264,153,111,0,153,0,0,0.0
2023-09-06,249,138,111,0,138,0,0,0.0
2023-09-07,157,59,98,0,59,0,0,0.0
2023-09-08,214,123,91,0,123,0,0,0.0
2023-09-10,12,12,0,0,12,0,0,0.0
2023-09-11,168,92,76,0,92,0,0,0.0
2023-09-12,189,82,107,0,82,0,0,0.0
2023-09-13,175,70,105,0,70,0,0,0.0
2023-09-14,197,97,100,0,97,0,0,0.0
2023-09-15,127,54,73,0,54,0,0,0.0
2023-09-17,30,12,18,0,12,0,0,0.0
2023-09-18,236,132,104,0,132,0,0,0.0
2023-09-19,240,132,108,0,132,0,0,0.0
2023-09-20,261,155,106,0,155,0,0,0.0
2023-09-21,241,138,103,0,138,0,0,0.0
2023-09-22,207,111,96,0,111,0,0,0.0
2023-09-24,20,7,13,0,7,0,0,0.0
2023-09-25,202,141,61,0,141,0,0,0.0
2023-09-26,195,95,100,0,95,0,0,0.0
2023-09-27,211,152,59,0,152,0,0,0.0
2023-09-28,191,89,102,0,89,0,0,0.0
2023-09-29,233,137,96,0,137,0,0,0.0
2023-10-01,29,12,17,0,12,0,0,0.0
2023-10-02,240,134,106,0,134,0,0,0.0
2023-10-03,256,137,119,0,137,0,0,0.0
2023-10-04,228,127,101,0,127,0,0,0.0
2023-10-05,246,137,109,0,137,0,0,0.0
2023-10-06,166,70,96,0,70,0,0,0.0
2023-10-08,17,12,5,0,12,0,0,0.0
2023-10-09,152,140,12,0,140,0,0,0.0
2023-10-10,243,140,103,0,140,0,0,0.0
2023-10-11,218,118,100,0,118,0,0,0.0
2023-10-12,219,127,92,0,127,0,0,0.0
2023-10-13,167,77,90,0,77,0,0,0.0
2023-10-15,25,11,14,0,11,0,0,0.0
2023-10-16,155,107,48,0,107,0,0,0.0
2023-10-17,136,77,59,0,77,0,0,0.0
2023-10-18,256,151,105,0,151,0,0,0.0
2023-10-19,174,105,69,0,105,0,0,0.0
2023-10-20,182,86,96,0,86,0,0,0.0
2023-10-22,14,12,2,0,12,0,0,0.0
2023-10-23,232,148,84,0,148,0,0,0.0
2023-10-24,221,132,89,0,132,0,0,0.0
2023-10-25,206,138,68,0,138,0,0,0.0
2023-10-26,229,132,97,0,132,0,0,0.0
2023-10-27,221,129,92,0,129,0,0,0.0
2023-10-29,29,12,17,0,12,0,0,0.0
2023-10-30,214,142,72,0,142,0,0,0.0
2023-10-31,261,147,114,0,147,0,0,0.0
2023-11-01,261,146,115,0,146,0,0,0.0
2023-11-02,252,148,104,0,148,0,0,0.0
2023-11-03,157,69,88,0,69,0,0,0.0
2023-11-05,13,0,13,0,0,0,0,0.0
2023-11-06,181,75,106,0,75,0,0,0.0
2023-11-07,185,96,89,0,96,0,0,0.0
2023-11-08,232,131,101,0,131,0,0,0.0
2023-11-09,175,115,60,0,115,0,0,0.0
2023-11-10,229,151,78,0,151,0,0,0.0
2023-11-12,18,0,18,0,0,0,0,0.0
2023-11-13,216,119,97,0,119,0,0,0.0
2023-11-14,210,134,76,0,134,0,0,0.0
2023-11-15,257,158,99,0,158,0,0,0.0
2023-11-16,210,156,54,0,156,0,0,0.0
2023-11-17,186,157,29,0,157,0,0,0.0
2023-11-19,17,0,17,0,0,0,0,0.0
2023-11-20,187,86,101,0,86,0,0,0.0
2023-11-21,251,142,109,0,142,0,0,0.0
2023-11-22,234,139,95,0,139,0,0,0.0
2023-11-23,210,102,108,0,102,0,0,0.0
2023-11-24,177,103,74,0,103,0,0,0.0
2023-11-26,12,0,12,0,0,0,0,0.0
2023-11-27,209,103,106,0,103,0,0,0.0
2023-11-28,230,122,108,0,122,0,0,0.0
2023-11-29,253,141,112,0,141,0,0,0.0
2023-11-30,239,152,87,0,152,0,0,0.0
2023-12-01,223,127,96,0,127,0,0,0.0
2023-12-03,13,0,13,0,0,0,0,0.0
2023-12-04,249,150,99,0,150,0,0,0.0
2023-12-05,233,151,82,0,151,0,0,0.0
2023-12-06,192,99,93,0,99,0,0,0.0
2023-12-07,269,155,114,0,155,0,0,0.0
2023-12-08,244,148,96,0,148,0,0,0.0
2023-12-10,6,0,6,0,0,0,0,0.0
2023-12-11,186,77,109,0,77,0,0,0.0
2023-12-12,253,143,110,0,143,0,0,0.0
2023-12-13,237,128,109,0,128,0,0,0.0
2023-12-14,188,78,110,0,78,0,0,0.0
2023-12-15,239,146,93,0,146,0,0,0.0
2023-12-17,18,0,18,0,0,0,0,0.0
2023-12-18,249,140,109,0,140,0,0,0.0
2023-12-19,266,151,115,0,151,0,0,0.0
2023-12-20,241,135,106,0,135,0,0,0.0
2023-12-21,247,153,94,0,153,0,0,0.0
2023-12-22,244,154,90,0,154,0,0,0.0
2023-12-24,0,0,0,0,0,0,0,0.0
2023-12-25,91,0,91,0,0,0,0,0.0
2023-12-26,209,137,72,0,137,0,0,0.0
2023-12-27,198,94,104,0,94,0,0,0.0
2023-12-28,231,125,106,0,125,0,0,0.0
2023-12-29,231,149,82,0,149,0,0,0.0
2024-01-01,12,0,12,0,0,0,0,0.0
2024-01-02,236,126,110,0,126,0,0,0.0
2024-01-03,234,149,85,0,149,0,0,0.0
2024-01-04,265,155,110,0,155,0,0,0.0
2024-01-05,248,152,96,0,152,0,0,0.0
2024-01-07,12,0,12,0,0,0,0,0.0
2024-01-08,194,130,64,0,130,0,0,0.0
2024-01-09,247,135,112,0,135,0,0,0.0
2024-01-10,235,133,102,0,133,0,0,0.0
2024-01-11,236,121,115,0,121,0,0,0.0
2024-01-12,231,135,96,0,135,0,0,0.0
2024-01-14,16,0,16,0,0,0,0,0.0
2024-01-15,262,151,111,0,151,0,0,0.0
2024-01-16,266,152,114,0,152,0,0,0.0
2024-01-17,230,134,96,0,134,0,0,0.0
2024-01-18,232,137,95,0,137,0,0,0.0
2024-01-19,221,126,95,0,126,0,0,0.0
2024-01-21,1,0,1,0,0,0,0,0.0
2024-01-22,200,131,69,0,131,0,0,0.0
2024-01-23,235,145,90,0,145,0,0,0.0
2024-01-24,238,131,107,0,131,0,0,0.0
2024-01-25,232,124,108,0,124,0,0,0.0
2024-01-26,212,142,70,0,142,0,0,0.0
2024-01-28,15,0,15,0,0,0,0,0.0
2024-01-29,222,112,110,0,112,0,0,0.0
2024-01-30,204,101,103,0,101,0,0,0.0
2024-01-31,262,156,106,0,156,0,0,0.0
2024-02-01,232,133,99,0,133,0,0,0.0
2024-02-02,179,146,33,0,146,0,0,0.0
2024-02-04,12,0,12,0,0,0,0,0.0
2024-02-05,162,101,61,0,101,0,0,0.0
2024-02-06,250,140,110,0,140,0,0,0.0
2024-02-07,189,90,99,0,90,0,0,0.0
2024-02-08,229,129,100,0,129,0,0,0.0
2024-02-09,210,123,87,0,123,0,0,0.0
2024-02-11,12,0,12,0,0,0,0,0.0
2024-02-12,212,127,85,0,127,0,0,0.0
2024-02-13,245,136,109,0,136,0,0,0.0
2024-02-14,222,111,111,0,111,0,0,0.0
2024-02-15,191,83,108,0,83,0,0,0.0
2024-02-16,211,115,96,0,115,0,0,0.0
2024-02-18,3,0,3,0,0,0,0,0.0
2024-02-19,209,102,107,0,102,0,0,0.0
2024-02-20,258,152,106,0,152,0,0,0.0
2024-02-21,238,147,91,0,147,0,0,0.0
2024-02-22,248,154,94,0,154,0,0,0.0
2024-02-23,179,106,73,0,106,0,0,0.0
2024-02-25,11,0,11,0,0,0,0,0.0
2024-02-26,177,153,24,0,153,0,0,0.0
2024-02-27,243,140,103,0,140,0,0,0.0
2024-02-28,188,82,106,0,82,0,0,0.0
2024-02-29,261,153,108,0,153,0,0,0.0
2024-03-01,234,138,96,0,138,0,0,0.0
2024-03-03,15,0,15,0,0,0,0,0.0
2024-03-04,156,54,102,0,54,0,0,0.0
2024-03-05,180,102,78,0,102,0,0,0.0
2024-03-06,249,147,102,0,147,0,0,0.0
2024-03-07,240,126,114,0,126,0,0,0.0
2024-03-08,164,76,88,0,76,0,0,0.0
2024-03-10,17,5,12,0,5,0,0,0.0
2024-03-11,197,125,72,0,125,0,0,0.0
2024-03-12,132,31,101,0,31,0,0,0.0
2024-03-13,249,152,97,0,152,0,0,0.0
2024-03-14,243,131,112,0,131,0,0,0.0
2024-03-15,201,108,93,0,108,0,0,0.0
2024-03-17,13,12,1,0,12,0,0,0.0
2024-03-18,208,111,97,0,111,0,0,0.0
2024-03-19,250,142,108,0,142,0,0,0.0
2024-03-20,260,146,114,0,146,0,0,0.0
2024-03-21,241,135,106,0,135,0,0,0.0
2024-03-22,223,127,96,0,127,0,0,0.0
2024-03-24,25,11,14,0,11,0,0,0.0
2024-03-25,229,132,97,0,132,0,0,0.0
2024-03-26,221,123,98,0,123,0,0,0.0
2024-03-27,227,125,102,0,125,0,0,0.0
2024-03-28,151,100,51,0,100,0,0,0.0
2024-03-29,177,93,84,0,93,0,0,0.0
2024-03-31,22,5,17,0,5,0,0,0.0
2024-04-01,244,148,96,0,148,0,0,0.0
2024-04-02,196,97,99,0,97,0,0,0.0
2024-04-03,233,152,81,0,152,0,0,0.0
2024-04-04,188,102,86,0,102,0,0,0.0
2024-04-05,159,93,66,0,93,0,0,0.0
2024-04-07,12,12,0,0,12,0,0,0.0
2024-04-08,198,98,100,0,98,0,0,0.0
2024-04-09,234,137,97,0,137,0,0,0.0
2024-04-10,207,138,69,0,138,0,0,0.0
2024-04-11,220,138,82,0,138,0,0,0.0
2024-04-12,204,134,70,0,134,0,0,0.0
2024-04-14,23,12,11,0,12,0,0,0.0
2024-04-15,124,26,98,0,26,0,0,0.0
2024-04-16,205,107,98,0,107,0,0,0.0
2024-04-17,203,117,86,0,117,0,0,0.0
2024-04-18,243,156,87,0,156,0,0,0.0
2024-04-19,164,74,90,0,74,0,0,0.0
2024-04-21,7,7,0,0,7,0,0,0.0
2024-04-22,205,146,59,0,146,0,0,0.0
2024-04-23,206,111,95,0,111,0,0,0.0
2024-04-24,231,136,95,0,136,0,0,0.0
2024-04-25,144,43,101,0,43,0,0,0.0
2024-04-26,204,120,84,0,120,0,0,0.0
2024-04-28,12,12,0,0,12,0,0,0.0
2024-04-29,211,122,89,0,122,0,0,0.0
2024-04-30,205,109,96,0,109,0,0,0.0
2024-05-01,206,94,112,0,94,0,0,0.0
2024-05-02,260,152,108,0,152,0,0,0.0
2024-05-03,235,139,96,0,139,0,0,0.0
2024-05-05,30,12,18,0,12,0,0,0.0
2024-05-06,257,143,114,0,143,0,0,0.0
2024-05-07,259,147,112,0,147,0,0,0.0
2024-05-08,207,94,113,0,94,0,0,0.0
2024-05-09,231,140,91,0,140,0,0,0.0
2024-05-10,172,77,95,0,77,0,0,0.0
2024-05-12,19,1,18,0,1,0,0,0.0
2024-05-13,220,109,111,0,109,0,0,0.0
2024-05-14,133,28,105,0,28,0,0,0.0
2024-05-15,245,148,97,0,148,0,0,0.0
2024-05-16,177,66,111,0,66,0,0,0.0
2024-05-17,204,108,96,0,108,0,0,0.0
2024-05-19,31,12,19,0,12,0,0,0.0
2024-05-20,220,113,107,0,113,0,0,0.0
2024-05-21,187,74,113,0,74,0,0,0.0
2024-05-22,191,92,99,0,92,0,0,0.0
2024-05-23,207,149,58,0,149,0,0,0.0
2024-05-24,229,134,95,0,134,0,0,0.0
2024-05-26,14,12,2,0,12,0,0,0.0
2024-05-27,199,126,73,0,126,0,0,0.0
2024-05-28,247,150,97,0,150,0,0,0.0
2024-05-29,233,137,96,0,137,0,0,0.0
2024-05-30,226,120,106,0,120,0,0,0.0
2024-05-31,196,119,77,0,119,0,0,0.0
2024-06-02,17,12,5,0,12,0,0,0.0
2024-06-03,221,149,72,0,149,0,0,0.0
2024-06-04,250,144,106,0,144,0,0,0.0
2024-06-05,189,79,110,0,79,0,0,0.0
2024-06-06,255,150,105,0,150,0,0,0.0
2024-06-07,165,70,95,0,70,0,0,0.0
2024-06-09,3,2,1,0,2,0,0,0.0
2024-06-10,190,95,95,0,95,0,0,0.0
2024-06-11,255,141,114,0,141,0,0,0.0
2024-06-12,240,122,118,0,122,0,0,0.0
2024-06-13,208,96,112,0,96,0,0,0.0
2024-06-14,167,71,96,0,71,0,0,0.0
2024-06-16,21,5,16,0,5,0,0,0.0
2024-06-17,154,128,26,0,128,0,0,0.0
2024-06-18,130,44,86,0,44,0,0,0.0
2024-06-19,210,141,69,0,141,0,0,0.0
2024-06-20,229,127,102,0,127,0,0,0.0
2024-06-21,221,139,82,0,139,0,0,0.0
2024-06-23,25,12,13,0,12,0,0,0.0
2024-06-24,203,151,52,0,151,0,0,0.0
2024-06-25,193,88,105,0,88,0,0,0.0
2024-06-26,257,150,107,0,150,0,0,0.0
2024-06-27,256,151,105,0,151,0,0,0.0
2024-06-28,231,136,95,0,136,0,0,0.0
2024-06-30,19,12,7,0,12,0,0,0.0
2024-07-01,210,136,74,0,136,0,0,0.0
2024-07-02,227,115,112,0,115,0,0,0.0
2024-07-03,216,110,106,0,110,0,0,0.0
2024-07-04,227,124,103,0,124,0,0,0.0
2024-07-05,195,99,96,0,99,0,0,0.0
2024-07-07,17,10,7,0,10,0,0,0.0
2024-07-08,233,128,105,0,128,0,0,0.0
2024-07-09,265,152,113,0,152,0,0,0.0
2024-07-10,229,127,102,0,127,0,0,0.0
2024-07-11,219,117,102,0,117,0,0,0.0
2024-07-12,76,36,40,0,36,0,0,0.0
2024-07-14,16,0,16,0,0,0,0,0.0
2024-07-15,190,134,56,0,134,0,0,0.0
2024-07-16,243,146,97,0,146,0,0,0.0
2024-07-17,224,128,96,0,128,0,0,0.0
2024-07-18,238,148,90,0,148,0,0,0.0
2024-07-19,197,102,95,0,102,0,0,0.0
2024-07-21,28,12,16,0,12,0,0,0.0
2024-07-22,217,139,78,0,139,0,0,0.0
2024-07-23,216,105,111,0,105,0,0,0.0
2024-07-24,221,120,101,0,120,0,0,0.0
2024-07-25,166,55,111,0,55,0,0,0.0
2024-07-26,154,58,96,0,58,0,0,0.0
2024-07-28,20,4,16,0,4,0,0,0.0
2024-07-29,161,52,109,0,52,0,0,0.0
2024-07-30,211,105,106,0,105,0,0,0.0
2024-07-31,212,105,107,0,105,0,0,0.0
2024-08-01,241,139,102,0,139,0,0,0.0
2024-08-02,196,124,72,0,124,0,0,0.0
2024-08-04,21,12,9,0,12,0,0,0.0
2024-08-05,262,149,113,0,149,0,0,0.0
2024-08-06,178,80,98,0,80,0,0,0.0
2024-08-07,253,147,106,0,147,0,0,0.0
2024-08-08,156,68,88,0,68,0,0,0.0
2024-08-09,128,39,89,0,39,0,0,0.0
2024-08-11,20,7,13,0,7,0,0,0.0
2024-08-12,187,122,65,0,122,0,0,0.0
2024-08-13,210,99,111,0,99,0,0,0.0
2024-08-14,215,103,112,0,103,0,0,0.0
2024-08-15,132,44,88,0,44,0,0,0.0
2024-08-16,193,109,84,0,109,0,0,0.0
2024-08-18,24,12,12,0,12,0,0,0.0
2024-08-19,180,80,100,0,80,0,0,0.0
2024-08-20,224,115,109,0,115,0,0,0.0
2024-08-21,233,129,104,0,129,0,0,0.0
2024-08-22,251,148,103,0,148,0,0,0.0
2024-08-23,240,145,95,0,145,0,0,0.0
2024-08-25,28,12,16,0,12,0,0,0.0
2024-08-26,250,147,103,0,147,0,0,0.0
2024-08-27,244,146,98,0,146,0,0,0.0
2024-08-28,243,138,105,0,138,0,0,0.0
2024-08-29,215,121,94,0,121,0,0,0.0
2024-08-30,212,135,77,0,135,0,0,0.0
2024-09-01,30,11,19,0,11,0,0,0.0
2024-09-02,177,115,62,0,115,0,0,0.0
2024-09-03,171,56,115,0,56,0,0,0.0
2024-09-04,215,126,89,0,126,0,0,0.0
2024-09-05,245,144,101,0,144,0,0,0.0
2024-09-06,231,135,96,0,135,0,0,0.0
2024-09-08,22,12,10,0,12,0,0,0.0
2024-09-09,220,112,108,0,112,0,0,0.0
2024-09-10,250,150,100,0,150,0,0,0.0
2024-09-11,184,70,114,0,70,0,0,0.0
2024-09-12,216,108,108,0,108,0,0,0.0
2024-09-13,168,72,96,0,72,0,0,0.0
2024-09-15,21,10,11,0,10,0,0,0.0
2024-09-16,218,138,80,0,138,0,0,0.0
2024-09-17,242,135,107,0,135,0,0,0.0
2024-09-18,234,120,114,0,120,0,0,0.0
2024-09-19,250,137,113,0,137,0,0,0.0
2024-09-20,215,119,96,0,119,0,0,0.0
2024-09-22,12,2,10,0,2,0,0,0.0
2024-09-23,223,120,103,0,120,0,0,0.0
2024-09-24,248,146,102,0,146,0,0,0.0
2024-09-25,243,140,103,0,140,0,0,0.0
2024-09-26,243,136,107,0,136,0,0,0.0
2024-09-27,172,76,96,0,76,0,0,0.0
2024-09-29,28,9,19,0,9,0,0,0.0
2024-09-30,224,147,77,0,147,0,0,0.0
2024-10-01,256,147,109,0,147,0,0,0.0
2024-10-02,259,157,102,0,157,0,0,0.0
2024-10-03,225,130,95,0,130,0,0,0.0
2024-10-04,206,112,94,0,112,0,0,0.0
2024-10-06,1,1,0,0,1,0,0,0.0
2024-10-07,165,50,115,0,50,0,0,0.0
2024-10-08,259,154,105,0,154,0,0,0.0
2024-10-09,232,144,88,0,144,0,0,0.0
2024-10-10,157,81,76,0,81,0,0,0.0
2024-10-11,172,80,92,0,80,0,0,0.0
2024-10-13,26,9,17,0,9,0,0,0.0
2024-10-14,163,100,63,0,100,0,0,0.0
2024-10-15,211,101,110,0,101,0,0,0.0
2024-10-16,233,130,103,0,130,0,0,0.0
2024-10-17,255,152,103,0,152,0,0,0.0
2024-10-18,231,135,96,0,135,0,0,0.0
2024-10-20,18,12,6,0,12,0,0,0.0
2024-10-21,258,153,105,0,153,0,0,0.0
2024-10-22,215,112,103,0,112,0,0,0.0
2024-10-23,226,123,103,0,123,0,0,0.0
2024-10-24,256,148,108,0,148,0,0,0.0
2024-10-25,184,94,90,0,94,0,0,0.0
2024-10-27,12,12,0,0,12,0,0,0.0
2024-10-28,251,151,100,0,151,0,0,0.0
2024-10-29,271,156,115,0,156,0,0,0.0
2024-10-30,155,86,69,0,86,0,0,0.0
2024-10-31,263,152,111,0,152,0,0,0.0
2024-11-01,220,126,94,0,126,0,0,0.0
2024-11-03,4,0,4,0,0,0,0,0.0
2024-11-04,236,127,109,0,127,0,0,0.0
2024-11-05,256,145,111,0,145,0,0,0.0
2024-11-06,215,107,108,0,107,0,0,0.0
2024-11-07,222,117,105,0,117,0,0,0.0
2024-11-08,181,99,82,0,99,0,0,0.0
2024-11-10,18,0,18,0,0,0,0,0.0
2024-11-11,161,47,114,0,47,0,0,0.0
2024-11-12,264,155,109,0,155,0,0,0.0
2024-11-13,252,153,99,0,153,0,0,0.0
2024-11-14,233,120,113,0,120,0,0,0.0
2024-11-15,245,149,96,0,149,0,0,0.0
2024-11-17,16,0,16,0,0,0,0,0.0
2024-11-18,242,146,96,0,146,0,0,0.0
2024-11-19,261,154,107,0,154,0,0,0.0
2024-11-20,246,138,108,0,138,0,0,0.0
2024-11-21,210,102,108,0,102,0,0,0.0
2024-11-22,231,153,78,0,153,0,0,0.0
2024-11-24,4,0,4,0,0,0,0,0.0
2024-11-25,181,97,84,0,97,0,0,0.0
2024-11-26,191,86,105,0,86,0,0,0.0
2024-11-27,243,130,113,0,130,0,0,0.0
2024-11-28,246,137,109,0,137,0,0,0.0
2024-11-29,215,119,96,0,119,0,0,0.0
2024-12-01,16,0,16,0,0,0,0,0.0
2024-12-02,254,143,111,0,143,0,0,0.0
2024-12-03,228,115,113,0,115,0,0,0.0
2024-12-04,258,146,112,0,146,0,0,0.0
2024-12-05,268,153,115,0,153,0,0,0.0
2024-12-06,239,157,82,0,157,0,0,0.0
2024-12-08,0,0,0,0,0,0,0,0.0
2024-12-09,170,118,52,0,118,0,0,0.0
2024-12-10,206,117,89,0,117,0,0,0.0
2024-12-11,245,141,104,0,141,0,0,0.0
2024-12-12,199,116,83,0,116,0,0,0.0
2024-12-13,253,157,96,0,157,0,0,0.0
2024-12-15,15,0,15,0,0,0,0,0.0
2024-12-16,239,146,93,0,146,0,0,0.0
2024-12-17,250,156,94,0,156,0,0,0.0
2024-12-18,208,132,76,0,132,0,0,0.0
2024-12-19,266,153,113,0,153,0,0,0.0
2024-12-20,234,139,95,0,139,0,0,0.0
2024-12-22,13,0,13,0,0,0,0,0.0
2024-12-23,188,92,96,0,92,0,0,0.0
2024-12-24,180,110,70,0,110,0,0,0.0
2024-12-25,119,0,119,0,0,0,0,0.0
2024-12-26,265,156,109,0,156,0,0,0.0
2024-12-27,204,108,96,0,108,0,0,0.0
2024-12-29,12,0,12,0,0,0,0,0.0
2024-12-30,248,140,108,0,140,0,0,0.0
2024-12-31,242,146,96,0,146,0,0,0.0
