date,breakouts,gate_pass,gate_block,ev_pass,ev_reject,fills,wins,pnl_pips
2018-01-01,10,0,10,0,0,0,0,0.0
2018-01-02,139,37,102,7,25,12,10,6.176657078615288
2018-01-03,204,147,57,0,147,0,0,0.0
2018-01-04,194,81,113,1,80,1,0,-4.587514281375549
2018-01-05,151,55,96,1,54,1,1,3.8706308337627147
2018-01-07,12,0,12,0,0,0,0,0.0
2018-01-08,235,147,88,0,147,0,0,0.0
2018-01-09,124,16,108,2,14,2,1,-2.5456667841503258
2018-01-10,119,14,105,2,12,2,1,-0.5872125361273239
2018-01-11,107,3,104,2,1,2,1,-0.13485341585795485
2018-01-12,62,5,57,2,3,2,1,-0.3960404811271516
2018-01-14,17,0,17,0,0,0,0,0.0
2018-01-15,165,58,107,2,56,2,1,-1.2014720280211044
2018-01-16,119,2,117,2,0,2,0,-6.675603296480235
2018-01-17,127,22,105,2,20,2,0,-8.941458628105224
2018-01-18,90,5,85,2,3,2,1,-0.6542433668380996
2018-01-19,92,3,89,2,1,2,0,-8.083274609275776
2018-01-21,12,0,12,0,0,0,0,0.0
2018-01-22,163,50,113,2,48,2,2,6.4867779608887535
2018-01-23,106,3,103,2,1,2,0,-8.378187619663377
2018-01-24,109,2,107,2,0,2,0,-10.11310962932425
2018-01-25,120,9,111,2,7,2,1,1.9936022517735488
2018-01-26,83,3,80,2,1,2,0,-9.7483990411845
2018-01-28,13,0,13,0,0,0,0,0.0
2018-01-29,182,85,97,1,84,1,1,5.04172225170257
2018-01-30,111,13,98,2,11,2,1,-0.5695633012435386
2018-01-31,143,46,97,1,45,1,0,-5.4168012665428
2018-02-01,161,48,113,1,47,1,0,-5.2822518374109775
2018-02-02,146,52,94,1,51,1,1,5.123776741475561
2018-02-04,20,0,20,0,0,0,0,0.0
2018-02-05,133,21,112,2,19,2,0,-10.992850898682807
2018-02-06,119,6,113,2,4,2,1,2.0282665823614012
2018-02-07,208,104,104,1,103,1,1,3.987448857006603
2018-02-08,146,75,71,1,74,1,1,4.764692630436587
2018-02-09,144,50,94,2,48,2,1,-0.9718210369398985
2018-02-11,15,0,15,0,0,0,0,0.0
2018-02-12,127,14,113,2,12,2,1,-4.914707963219678
2018-02-13,110,2,108,2,0,2,0,-12.778699472775996
2018-02-14,152,46,106,1,45,1,0,-6.40494272614747
2018-02-15,113,2,111,2,0,2,0,-9.635809115081525
2018-02-16,133,40,93,1,39,1,0,-4.362063392571229
2018-02-18,20,0,20,0,0,0,0,0.0
2018-02-19,245,139,106,0,139,0,0,0.0
2018-02-20,159,48,111,1,47,1,0,-4.422961424623198
2018-02-21,264,155,109,0,155,0,0,0.0
2018-02-22,162,46,116,1,45,1,0,-4.747289443620654
2018-02-23,239,143,96,0,143,0,0,0.0
2018-02-25,6,0,6,0,0,0,0,0.0
2018-02-26,235,122,113,0,122,0,0,0.0
2018-02-27,137,27,110,1,26,1,0,-4.903676303088089
2018-02-28,235,130,105,0,130,0,0,0.0
2018-03-01,239,128,111,1,127,1,1,9.380176309209782
2018-03-02,151,58,93,1,57,1,0,-5.922749197340876
2018-03-04,6,0,6,0,0,0,0,0.0
2018-03-05,188,158,30,0,158,0,0,0.0
2018-03-06,238,125,113,0,125,0,0,0.0
2018-03-07,230,119,111,0,119,0,0,0.0
2018-03-08,228,120,108,0,120,0,0,0.0
2018-03-09,223,121,102,0,121,0,0,0.0
2018-03-11,30,12,18,0,12,0,0,0.0
2018-03-12,227,113,114,0,113,0,0,0.0
2018-03-13,167,57,110,1,56,1,0,-5.9794799554440825
2018-03-14,244,151,93,0,151,0,0,0.0
2018-03-15,254,149,105,0,149,0,0,0.0
2018-03-16,219,123,96,0,123,0,0,0.0
2018-03-18,27,12,15,0,12,0,0,0.0
2018-03-19,263,151,112,0,151,0,0,0.0
2018-03-20,212,105,107,0,105,0,0,0.0
2018-03-21,213,102,111,1,101,1,1,10.620344840367611
2018-03-22,166,49,117,1,48,1,0,-6.220875118224068
2018-03-23,221,125,96,0,125,0,0,0.0
2018-03-25,27,12,15,0,12,0,0,0.0
2018-03-26,214,111,103,0,111,0,0,0.0
2018-03-27,256,147,109,0,147,0,0,0.0
2018-03-28,262,158,104,0,158,0,0,0.0
2018-03-29,252,147,105,0,147,0,0,0.0
2018-03-30,165,70,95,0,70,0,0,0.0
2018-04-01,8,6,2,0,6,0,0,0.0
2018-04-02,185,156,29,0,156,0,0,0.0
2018-04-03,254,140,114,0,140,0,0,0.0
2018-04-04,214,119,95,0,119,0,0,0.0
2018-04-05,270,156,114,0,156,0,0,0.0
2018-04-06,129,34,95,1,33,1,0,-5.75671813842163
2018-04-08,8,0,8,0,0,0,0,0.0
2018-04-09,192,130,62,0,130,0,0,0.0
2018-04-10,256,146,110,0,146,0,0,0.0
2018-04-11,217,102,115,0,102,0,0,0.0
2018-04-12,231,116,115,0,116,0,0,0.0
2018-04-13,242,146,96,0,146,0,0,0.0
2018-04-15,18,12,6,0,12,0,0,0.0
2018-04-16,238,128,110,0,128,0,0,0.0
2018-04-17,259,146,113,0,146,0,0,0.0
2018-04-18,261,145,116,0,145,0,0,0.0
2018-04-19,230,125,105,0,125,0,0,0.0
2018-04-20,237,142,95,0,142,0,0,0.0
2018-04-22,22,12,10,0,12,0,0,0.0
2018-04-23,262,160,102,0,160,0,0,0.0
2018-04-24,241,141,100,0,141,0,0,0.0
2018-04-25,250,157,93,0,157,0,0,0.0
2018-04-26,252,146,106,0,146,0,0,0.0
2018-04-27,198,103,95,0,103,0,0,0.0
2018-04-29,32,12,20,0,12,0,0,0.0
2018-04-30,196,106,90,0,106,0,0,0.0
2018-05-01,262,148,114,0,148,0,0,0.0
2018-05-02,270,158,112,0,158,0,0,0.0
2018-05-03,270,155,115,0,155,0,0,0.0
2018-05-04,218,122,96,0,122,0,0,0.0
2018-05-06,26,12,14,0,12,0,0,0.0
2018-05-07,262,155,107,0,155,0,0,0.0
2018-05-08,213,112,101,0,112,0,0,0.0
2018-05-09,227,121,106,0,121,0,0,0.0
2018-05-10,223,111,112,0,111,0,0,0.0
2018-05-11,231,136,95,0,136,0,0,0.0
2018-05-13,13,12,1,0,12,0,0,0.0
2018-05-14,196,122,74,0,122,0,0,0.0
2018-05-15,255,140,115,0,140,0,0,0.0
2018-05-16,253,146,107,0,146,0,0,0.0
2018-05-17,201,99,102,0,99,0,0,0.0
2018-05-18,237,141,96,0,141,0,0,0.0
2018-05-20,16,12,4,0,12,0,0,0.0
2018-05-21,267,152,115,0,152,0,0,0.0
2018-05-22,205,105,100,0,105,0,0,0.0
2018-05-23,220,121,99,0,121,0,0,0.0
2018-05-24,272,155,117,0,155,0,0,0.0
2018-05-25,208,112,96,0,112,0,0,0.0
2018-05-27,20,12,8,0,12,0,0,0.0
2018-05-28,250,144,106,0,144,0,0,0.0
2018-05-29,228,111,117,1,110,1,1,11.482896630856555
2018-05-30,202,91,111,0,91,0,0,0.0
2018-05-31,174,62,112,1,61,1,1,6.726979532072443
2018-06-01,144,49,95,1,48,1,0,-4.9813897010896975
2018-06-03,4,0,4,0,0,0,0,0.0
2018-06-04,242,126,116,0,126,0,0,0.0
2018-06-05,234,120,114,0,120,0,0,0.0
2018-06-06,261,154,107,0,154,0,0,0.0
2018-06-07,268,157,111,0,157,0,0,0.0
2018-06-08,218,125,93,0,125,0,0,0.0
2018-06-10,18,12,6,0,12,0,0,0.0
2018-06-11,238,137,101,0,137,0,0,0.0
2018-06-12,273,156,117,0,156,0,0,0.0
2018-06-13,213,114,99,1,113,1,1,5.733935655312692
2018-06-14,198,124,74,0,124,0,0,0.0
2018-06-15,215,120,95,0,120,0,0,0.0
2018-06-17,23,12,11,0,12,0,0,0.0
2018-06-18,211,101,110,0,101,0,0,0.0
2018-06-19,260,152,108,0,152,0,0,0.0
2018-06-20,172,56,116,1,55,1,1,3.463683857944673
2018-06-21,158,53,105,1,52,1,1,2.8673511490086128
2018-06-22,130,35,95,1,34,1,1,0.5124479598292551
2018-06-24,9,0,9,0,0,0,0,0.0
2018-06-25,152,37,115,1,36,1,1,-0.7333672794517527
2018-06-26,158,51,107,1,50,1,0,-7.651364830443742
2018-06-27,154,52,102,1,51,1,0,-5.24895442177459
2018-06-28,161,56,105,1,55,1,1,4.582909471649633
2018-06-29,135,40,95,1,39,1,1,2.984656546508304
2018-07-01,10,0,10,0,0,0,0,0.0
2018-07-02,135,37,98,1,36,1,0,-6.500098406330922
2018-07-03,176,62,114,1,61,1,1,-0.2691370550807468
2018-07-04,197,97,100,1,96,1,0,-6.919544724109928
2018-07-05,125,29,96,1,28,1,0,-4.781821164697396
2018-07-06,126,58,68,1,57,1,0,-4.444249297128003
2018-07-08,6,0,6,0,0,0,0,0.0
2018-07-09,203,141,62,0,141,0,0,0.0
2018-07-10,263,148,115,1,147,1,1,3.016173334237523
2018-07-11,147,57,90,1,56,1,0,-5.98191556757614
2018-07-12,170,55,115,1,54,1,0,-4.474373033907151
2018-07-13,170,74,96,1,73,1,1,3.0287091164052296
2018-07-15,13,0,13,0,0,0,0,0.0
2018-07-16,240,143,97,0,143,0,0,0.0
2018-07-17,177,62,115,1,61,1,1,1.9343251760213898
2018-07-18,156,56,100,1,55,1,0,-5.700233180730787
2018-07-19,143,35,108,1,34,1,0,-3.9779133185888313
2018-07-20,146,51,95,1,50,1,0,-6.230999239076354
2018-07-22,19,0,19,0,0,0,0,0.0
2018-07-23,261,147,114,0,147,0,0,0.0
2018-07-24,237,147,90,0,147,0,0,0.0
2018-07-25,162,71,91,1,70,1,0,-5.203171749526044
2018-07-26,168,65,103,1,64,1,1,4.715609344757446
2018-07-27,153,57,96,1,56,1,0,-3.9809611532918483
2018-07-29,8,0,8,0,0,0,0,0.0
2018-07-30,227,112,115,0,112,0,0,0.0
2018-07-31,166,54,112,1,53,1,0,-3.8116638232154227
2018-08-01,215,112,103,1,111,1,1,4.065935418549525
2018-08-02,259,155,104,0,155,0,0,0.0
2018-08-03,209,122,87,0,122,0,0,0.0
2018-08-05,13,12,1,0,12,0,0,0.0
2018-08-06,232,131,101,0,131,0,0,0.0
2018-08-07,277,161,116,0,161,0,0,0.0
2018-08-08,162,54,108,1,53,1,1,3.0095758235594188
2018-08-09,261,147,114,0,147,0,0,0.0
2018-08-10,154,58,96,1,57,1,0,-4.122315245184305
2018-08-12,1,0,1,0,0,0,0,0.0
2018-08-13,235,137,98,1,136,1,1,7.004456741509193
2018-08-14,203,104,99,1,103,1,1,2.863424117622158
2018-08-15,153,37,116,1,36,1,0,-2.43391059092241
2018-08-16,148,39,109,1,38,1,0,-3.9080967909549154
2018-08-17,147,51,96,1,50,1,1,2.5859902381487547
2018-08-19,7,0,7,0,0,0,0,0.0
2018-08-20,149,51,98,1,50,1,0,-5.428808924928365
2018-08-21,252,144,108,1,143,1,0,-5.34950115241152
2018-08-22,255,156,99,0,156,0,0,0.0
2018-08-23,163,62,101,1,61,1,1,3.2290349924748423
2018-08-24,117,51,66,1,50,1,0,-5.4380920719321955
2018-08-26,8,0,8,0,0,0,0,0.0
2018-08-27,261,153,108,0,153,0,0,0.0
2018-08-28,251,145,106,0,145,0,0,0.0
2018-08-29,162,60,102,1,59,1,1,3.175835505389995
2018-08-30,164,62,102,1,61,1,0,-3.8926105744868695
2018-08-31,184,118,66,0,118,0,0,0.0
2018-09-02,32,12,20,0,12,0,0,0.0
2018-09-03,256,148,108,0,148,0,0,0.0
2018-09-04,172,62,110,1,61,1,1,2.6449887305004287
2018-09-05,134,47,87,1,46,1,0,-5.280015481898268
2018-09-06,142,29,113,1,28,1,0,-3.7388836965491703
2018-09-07,148,52,96,1,51,1,0,-4.166425394307936
2018-09-09,17,0,17,0,0,0,0,0.0
2018-09-10,209,112,97,0,112,0,0,0.0
2018-09-11,270,158,112,0,158,0,0,0.0
2018-09-12,155,48,107,1,47,1,1,3.9156668487955724
2018-09-13,160,45,115,1,44,1,0,-5.509873965681678
2018-09-14,133,41,92,1,40,1,0,-4.517167416146985
2018-09-16,10,0,10,0,0,0,0,0.0
2018-09-17,190,143,47,0,143,0,0,0.0
2018-09-18,247,143,104,0,143,0,0,0.0
2018-09-19,215,120,95,0,120,0,0,0.0
2018-09-20,147,46,101,1,45,1,1,4.392780067405308
2018-09-21,221,128,93,0,128,0,0,0.0
2018-09-23,21,12,9,0,12,0,0,0.0
2018-09-24,154,58,96,1,57,1,1,3.239755219915578
2018-09-25,264,155,109,0,155,0,0,0.0
2018-09-26,216,104,112,1,103,1,1,2.6797043037036423
2018-09-27,178,69,109,1,68,1,1,1.7393748456809446
2018-09-28,133,38,95,1,37,1,0,-5.29846843326117
2018-09-30,17,0,17,0,0,0,0,0.0
2018-10-01,184,70,114,1,69,1,0,-4.806563826707913
2018-10-02,177,75,102,1,74,1,1,2.6977338401271576
2018-10-03,175,67,108,1,66,1,1,1.4716078814029538
2018-10-04,145,34,111,2,32,2,1,0.24010270413570556
2018-10-05,134,56,78,2,54,2,0,-8.838419044687896
2018-10-07,19,0,19,0,0,0,0,0.0
2018-10-08,169,59,110,1,58,1,0,-5.100585658143537
2018-10-09,135,30,105,1,29,1,0,-4.229629233289984
2018-10-10,171,69,102,1,68,1,1,5.721408456047231
2018-10-11,86,5,81,2,3,2,0,-9.910757065936096
2018-10-12,149,53,96,1,52,1,1,2.720388912434479
2018-10-14,8,0,8,0,0,0,0,0.0
2018-10-15,148,46,102,1,45,1,0,-4.5575571890062205
2018-10-16,154,42,112,1,41,1,0,-5.389268530127364
2018-10-17,166,51,115,1,50,1,1,3.197015723903541
2018-10-18,169,56,113,1,55,1,0,-5.381051845062533
2018-10-19,146,50,96,1,49,1,1,3.386606223326094
2018-10-21,21,0,21,0,0,0,0,0.0
2018-10-22,169,60,109,1,59,1,0,-4.243824353983342
2018-10-23,170,66,104,1,65,1,0,-4.9856053770730675
2018-10-24,169,65,104,1,64,1,1,4.182329100569987
2018-10-25,127,48,79,1,47,1,0,-5.453907425099235
2018-10-26,144,51,93,1,50,1,0,-3.7287727216558233
2018-10-28,10,0,10,0,0,0,0,0.0
2018-10-29,166,77,89,1,76,1,1,5.048060386716832
2018-10-30,176,60,116,1,59,1,1,5.613585507726946
2018-10-31,146,38,108,1,37,1,1,2.546549065255277
2018-11-01,157,49,108,1,48,1,1,1.826444807776495
2018-11-02,150,54,96,1,53,1,0,-5.8681994996494
2018-11-04,17,0,17,0,0,0,0,0.0
2018-11-05,146,80,66,1,79,1,1,1.3892986502299243
2018-11-06,262,151,111,0,151,0,0,0.0
2018-11-07,149,56,93,1,55,1,1,0.779344945037745
2018-11-08,217,113,104,1,112,1,1,0.627255357986559
2018-11-09,128,32,96,1,31,1,0,-4.60307816049151
2018-11-11,8,0,8,0,0,0,0,0.0
2018-11-12,170,63,107,1,62,1,0,-5.4323406769877405
2018-11-13,156,53,103,1,52,1,0,-4.630708774317329
2018-11-14,152,47,105,1,46,1,1,1.6130481325491997
2018-11-15,134,48,86,1,47,1,0,-5.232865686581007
2018-11-16,132,48,84,1,47,1,1,2.7167187741000833
2018-11-18,16,0,16,0,0,0,0,0.0
2018-11-19,127,36,91,1,35,1,0,-5.262644388073126
2018-11-20,139,44,95,1,43,1,1,1.8755271425895284
2018-11-21,157,54,103,1,53,1,1,1.4132231994085291
2018-11-22,151,123,28,0,123,0,0,0.0
2018-11-23,140,62,78,1,61,1,1,0.29990171176864955
2018-11-25,12,0,12,0,0,0,0,0.0
2018-11-26,169,56,113,1,55,1,1,0.83671992280044
2018-11-27,124,23,101,2,21,2,1,-0.9203208391751061
2018-11-28,181,74,107,1,73,1,1,-0.5162753212961109
2018-11-29,149,53,96,1,52,1,0,-5.5291056810117745
2018-11-30,68,68,0,1,67,1,0,-4.679376064588208
2018-12-02,14,0,14,0,0,0,0,0.0
2018-12-03,170,81,89,1,80,1,0,-3.8285816646074258
2018-12-04,184,72,112,1,71,1,1,0.6131428325401638
2018-12-05,188,73,115,1,72,1,1,0.134768522767148
2018-12-06,171,57,114,1,56,1,0,-3.4971417749765346
2018-12-07,147,53,94,1,52,1,0,-4.991672791754242
2018-12-09,14,0,14,0,0,0,0,0.0
2018-12-10,160,46,114,1,45,1,0,-4.901154763934023
2018-12-11,157,47,110,1,46,1,1,1.0127133639250352
2018-12-12,132,36,96,1,35,1,0,-4.906329207478472
2018-12-13,140,44,96,1,43,1,1,1.143098553257156
2018-12-14,130,58,72,1,57,1,1,0.8075502185339969
2018-12-16,18,0,18,0,0,0,0,0.0
2018-12-17,160,57,103,1,56,1,1,0.3587195324261696
2018-12-18,167,56,111,1,55,1,0,-3.4322350754555444
2018-12-19,168,69,99,1,68,1,1,0.44834576780543856
2018-12-20,163,64,99,1,63,1,1,1.7026613248540783
2018-12-21,91,14,77,2,12,2,1,-0.05131404851520305
2018-12-23,5,0,5,0,0,0,0,0.0
2018-12-24,49,40,9,1,39,1,0,-5.06119981028418
2018-12-25,117,0,117,0,0,0,0,0.0
2018-12-26,139,61,78,1,60,1,1,0.9051487889574394
2018-12-27,114,2,112,2,0,2,0,-7.324779800345343
2018-12-28,146,51,95,1,50,1,1,1.4696142263668732
2018-12-30,19,0,19,0,0,0,0,0.0
2018-12-31,142,47,95,1,46,1,0,-3.849557172841316
2019-01-01,18,0,18,0,0,0,0,0.0
2019-01-02,118,5,113,2,3,2,1,-1.5070953468761221
2019-01-03,113,2,111,2,0,2,0,-9.017908086761192
2019-01-04,102,6,96,2,4,2,1,1.163070349124653
2019-01-06,12,0,12,0,0,0,0,0.0
2019-01-07,140,51,89,1,50,1,0,-3.6989689407544644
2019-01-08,159,50,109,1,49,1,0,-3.5536874706556976
2019-01-09,129,26,103,1,25,1,1,2.105723507402139
2019-01-10,164,57,107,1,56,1,0,-4.996553057430284
2019-01-11,112,27,85,1,26,1,0,-4.9869305119866665
2019-01-13,13,0,13,0,0,0,0,0.0
2019-01-14,154,42,112,1,41,1,1,1.7978099923664936
2019-01-15,154,57,97,1,56,1,0,-3.3661143415732955
2019-01-16,166,64,102,1,63,1,0,-4.652648085887231
2019-01-17,131,26,105,1,25,1,1,2.3826355014857787
2019-01-18,141,46,95,1,45,1,0,-4.906940459079955
2019-01-20,8,0,8,0,0,0,0,0.0
2019-01-21,216,113,103,0,113,0,0,0.0
2019-01-22,167,69,98,1,68,1,0,-3.771079118837112
2019-01-23,148,49,99,1,48,1,1,2.590043410333097
2019-01-24,155,60,95,1,59,1,1,2.1004925870406224
2019-01-25,160,65,95,1,64,1,1,2.0743977939075613
2019-01-27,18,0,18,0,0,0,0,0.0
2019-01-28,159,51,108,1,50,1,1,0.8686934955982819
2019-01-29,170,73,97,1,72,1,1,0.8025683536409787
2019-01-30,114,66,48,1,65,1,1,3.472225187489215
2019-01-31,158,54,104,1,53,1,1,1.8713557803407506
2019-02-01,140,52,88,1,51,1,0,-5.6345159344971805
2019-02-03,20,0,20,0,0,0,0,0.0
2019-02-04,171,58,113,1,57,1,1,-0.30675870836558783
2019-02-05,153,59,94,1,58,1,1,-0.662248228364168
2019-02-06,167,62,105,1,61,1,0,-5.035924765007643
2019-02-07,144,53,91,1,52,1,1,2.9463796994106217
2019-02-08,125,62,63,1,61,1,1,-0.7465750145122914
2019-02-10,10,0,10,0,0,0,0,0.0
2019-02-11,150,58,92,1,57,1,0,-5.510107091182958
2019-02-12,182,80,102,1,79,1,1,-0.2505873180153908
2019-02-13,150,39,111,1,38,1,1,2.0610149409263983
2019-02-14,159,51,108,1,50,1,1,1.8436698271947352
2019-02-15,142,58,84,1,57,1,1,-1.448908156363339
2019-02-17,13,0,13,0,0,0,0,0.0
2019-02-18,254,146,108,0,146,0,0,0.0
2019-02-19,156,61,95,1,60,1,1,-1.5839439970448477
2019-02-20,166,58,108,1,57,1,0,-4.739505749682128
2019-02-21,124,28,96,1,27,1,0,-4.450157569779635
2019-02-22,150,60,90,1,59,1,1,-0.3532184539146721
2019-02-24,17,0,17,0,0,0,0,0.0
2019-02-25,143,73,70,1,72,1,1,-0.930687636153757
2019-02-26,157,58,99,1,57,1,1,-0.6052897158855144
2019-02-27,147,63,84,1,62,1,1,0.7500016416703084
2019-02-28,143,30,113,1,29,1,0,-4.337580959808215
2019-03-01,123,27,96,1,26,1,0,-3.3916955848793386
2019-03-03,21,0,21,0,0,0,0,0.0
2019-03-04,144,46,98,1,45,1,1,-0.857956722806243
2019-03-05,165,59,106,1,58,1,0,-4.606693104735182
2019-03-06,149,50,99,1,49,1,0,-3.40065536481643
2019-03-07,150,61,89,1,60,1,1,1.7241944678181271
2019-03-08,143,48,95,1,47,1,1,2.3159776650370185
2019-03-10,15,0,15,0,0,0,0,0.0
2019-03-11,132,47,85,1,46,1,0,-2.9135902047463054
2019-03-12,158,48,110,1,47,1,0,-3.251255432404481
2019-03-13,149,36,113,1,35,1,0,-2.934701448753427
2019-03-14,162,45,117,1,44,1,0,-2.7575581968399785
2019-03-15,130,36,94,1,35,1,0,-2.685315241223575
2019-03-17,14,0,14,0,0,0,0,0.0
2019-03-18,184,70,114,1,69,1,1,1.0429292448906389
2019-03-19,149,34,115,1,33,1,0,-2.2446981371185815
2019-03-20,188,76,112,1,75,1,0,-4.218028900321176
2019-03-21,158,57,101,1,56,1,0,-4.410156997630908
2019-03-22,149,57,92,1,56,1,0,-4.468359424611913
2019-03-24,16,0,16,0,0,0,0,0.0
2019-03-25,149,53,96,1,52,1,0,-2.783297196728131
2019-03-26,159,51,108,1,50,1,0,-4.745779152018878
2019-03-27,106,51,55,1,50,1,0,-3.6176591339568427
2019-03-28,162,57,105,1,56,1,0,-5.379145499719272
2019-03-29,106,11,95,1,10,1,0,-4.7774873026794005
2019-03-31,7,0,7,0,0,0,0,0.0
2019-04-01,162,54,108,1,53,1,1,3.7279498718294315
2019-04-02,199,123,76,0,123,0,0,0.0
2019-04-03,200,91,109,0,91,0,0,0.0
2019-04-04,243,133,110,0,133,0,0,0.0
2019-04-05,151,54,97,1,53,1,0,-4.792497761364087
2019-04-07,14,0,14,0,0,0,0,0.0
2019-04-08,252,137,115,0,137,0,0,0.0
2019-04-09,254,142,112,0,142,0,0,0.0
2019-04-10,149,53,96,1,52,1,1,5.271050107664875
2019-04-11,240,130,110,0,130,0,0,0.0
2019-04-12,221,125,96,0,125,0,0,0.0
2019-04-14,32,12,20,0,12,0,0,0.0
2019-04-15,173,75,98,0,75,0,0,0.0
2019-04-16,152,67,85,0,67,0,0,0.0
2019-04-17,230,123,107,0,123,0,0,0.0
2019-04-18,202,105,97,0,105,0,0,0.0
2019-04-19,173,86,87,0,86,0,0,0.0
2019-04-21,28,12,16,0,12,0,0,0.0
2019-04-22,135,50,85,0,50,0,0,0.0
2019-04-23,249,134,115,0,134,0,0,0.0
2019-04-24,221,115,106,1,114,1,1,3.2169979680406544
2019-04-25,166,57,109,1,56,1,1,1.9074237471395867
2019-04-26,147,51,96,1,50,1,0,-4.0308693550315935
2019-04-28,12,0,12,0,0,0,0,0.0
2019-04-29,221,119,102,0,119,0,0,0.0
2019-04-30,182,77,105,1,76,1,0,-4.8670998905105325
2019-05-01,218,117,101,1,116,1,1,4.842883578302679
2019-05-02,241,131,110,0,131,0,0,0.0
2019-05-03,138,44,94,1,43,1,0,-3.521738428869581
2019-05-05,15,0,15,0,0,0,0,0.0
2019-05-06,218,128,90,1,127,1,1,1.990282564159919
2019-05-07,141,63,78,1,62,1,1,1.4682114266604547
2019-05-08,151,52,99,1,51,1,0,-5.389734024932956
2019-05-09,166,58,108,1,57,1,0,-3.858520242669604
2019-05-10,161,66,95,1,65,1,1,1.7818680260316893
2019-05-12,17,0,17,0,0,0,0,0.0
2019-05-13,125,44,81,2,42,2,1,1.7453064432993575
2019-05-14,160,49,111,1,48,1,1,1.2951531961048284
2019-05-15,162,54,108,1,53,1,0,-3.7172329126959127
2019-05-16,163,57,106,1,56,1,0,-3.3786990165153448
2019-05-17,144,48,96,1,47,1,1,2.7802229447083135
2019-05-19,10,0,10,0,0,0,0,0.0
2019-05-20,169,58,111,1,57,1,0,-3.386101054819761
2019-05-21,175,59,116,1,58,1,0,-3.8078275122570733
2019-05-22,263,157,106,0,157,0,0,0.0
2019-05-23,160,56,104,1,55,1,0,-3.155130453125015
2019-05-24,166,71,95,1,70,1,1,3.108423173175328
2019-05-26,21,0,21,0,0,0,0,0.0
2019-05-27,258,143,115,0,143,0,0,0.0
2019-05-28,122,31,91,1,30,1,0,-3.759708207618803
2019-05-29,151,54,97,1,53,1,1,2.5026802520945224
2019-05-30,171,62,109,1,61,1,1,1.9038145184734645
2019-05-31,136,40,96,1,39,1,0,-3.916816684894165
2019-06-02,12,0,12,0,0,0,0,0.0
2019-06-03,144,54,90,1,53,1,1,1.8276272413991455
2019-06-04,156,47,109,1,46,1,0,-4.865260037099125
2019-06-05,146,53,93,2,51,2,2,17.10763147508808
2019-06-06,146,57,89,1,56,1,0,-3.9682353903942027
2019-06-07,138,42,96,2,40,2,1,-0.9330997675318313
2019-06-09,6,0,6,0,0,0,0,0.0
2019-06-10,181,99,82,1,98,1,1,1.6373933556081601
2019-06-11,257,158,99,0,158,0,0,0.0
2019-06-12,142,39,103,1,38,1,0,-3.884317041176082
2019-06-13,262,154,108,0,154,0,0,0.0
2019-06-14,135,39,96,1,38,1,0,-3.751128260009755
2019-06-16,8,0,8,0,0,0,0,0.0
2019-06-17,236,126,110,0,126,0,0,0.0
2019-06-18,159,47,112,1,46,1,0,-5.055438617796664
2019-06-19,189,88,101,1,87,1,1,3.4070632660101783
2019-06-20,163,51,112,1,50,1,0,-4.073579693860685
2019-06-21,83,3,80,2,1,2,0,-8.383032201419088
2019-06-23,19,0,19,0,0,0,0,0.0
2019-06-24,253,157,96,0,157,0,0,0.0
2019-06-25,167,62,105,1,61,1,1,2.990123278718719
2019-06-26,201,94,107,1,93,1,1,3.5474321141365346
2019-06-27,188,79,109,1,78,1,1,2.291932822591342
2019-06-28,141,45,96,1,44,1,0,-4.877190266169767
2019-06-30,20,0,20,0,0,0,0,0.0
2019-07-01,113,53,60,1,52,1,0,-3.8532742593075326
2019-07-02,143,64,79,1,63,1,1,2.407018609423182
2019-07-03,267,152,115,0,152,0,0,0.0
2019-07-04,183,78,105,0,78,0,0,0.0
2019-07-05,128,32,96,2,30,2,1,0.3890182991200799
2019-07-07,5,0,5,0,0,0,0,0.0
2019-07-08,250,161,89,0,161,0,0,0.0
2019-07-09,217,109,108,0,109,0,0,0.0
2019-07-10,162,49,113,2,47,2,1,-0.1641485511390588
2019-07-11,151,44,107,2,42,2,1,-0.7361603537391335
2019-07-12,216,120,96,0,120,0,0,0.0
2019-07-14,20,12,8,0,12,0,0,0.0
2019-07-15,216,124,92,0,124,0,0,0.0
2019-07-16,167,55,112,2,53,2,1,-2.6363788531967263
2019-07-17,232,122,110,0,122,0,0,0.0
2019-07-18,203,86,117,2,84,2,2,3.920260537151038
2019-07-19,172,76,96,2,74,2,2,2.0156910146662352
2019-07-21,20,0,20,0,0,0,0,0.0
2019-07-22,165,58,107,1,57,1,0,-5.931977376943952
2019-07-23,243,134,109,0,134,0,0,0.0
2019-07-24,246,141,105,0,141,0,0,0.0
2019-07-25,114,29,85,2,27,2,1,-3.3024104982475073
2019-07-26,121,47,74,2,45,2,1,-3.4775172358314674
2019-07-28,6,0,6,0,0,0,0,0.0
2019-07-29,252,160,92,0,160,0,0,0.0
2019-07-30,236,134,102,1,133,1,1,-0.7345770014435375
2019-07-31,168,61,107,1,60,1,0,-4.945497983078024
2019-08-01,158,42,116,2,40,2,1,-2.7965085171735597
2019-08-02,97,2,95,2,0,2,1,8.803264351585103
2019-08-04,14,0,14,0,0,0,0,0.0
2019-08-05,102,2,100,2,0,2,0,-8.29836783547005
2019-08-06,113,2,111,2,0,2,0,-8.715192000000581
2019-08-07,107,3,104,2,1,2,0,-8.15194051578594
2019-08-08,88,38,50,2,36,2,1,-2.0189335065428096
2019-08-09,111,18,93,2,16,2,0,-9.344851501213999
2019-08-11,15,0,15,0,0,0,0,0.0
2019-08-12,212,102,110,1,101,1,1,3.74677265547568
2019-08-13,120,5,115,2,3,2,1,6.415222132137161
2019-08-14,123,7,116,2,5,2,0,-7.870548631926511
2019-08-15,117,3,114,2,1,2,0,-10.338101370541027
2019-08-16,159,65,94,1,64,1,1,0.17160210487371996
2019-08-18,22,7,15,0,7,0,0,0.0
2019-08-19,110,81,29,1,80,1,0,-4.495253249293581
2019-08-20,134,56,78,1,55,1,1,6.346528216600785
2019-08-21,263,152,111,0,152,0,0,0.0
2019-08-22,164,55,109,2,53,2,2,6.346364160023658
2019-08-23,133,37,96,2,35,2,0,-11.558594079336501
2019-08-25,17,0,17,0,0,0,0,0.0
2019-08-26,112,7,105,2,5,2,1,3.8294271702096685
2019-08-27,207,100,107,1,99,1,0,-4.422954826784213
2019-08-28,219,114,105,1,113,1,0,-3.847830237353886
2019-08-29,212,104,108,1,103,1,0,-3.867451935223717
2019-08-30,238,143,95,0,143,0,0,0.0
2019-09-01,14,12,2,0,12,0,0,0.0
2019-09-02,249,153,96,0,153,0,0,0.0
2019-09-03,149,39,110,1,38,1,0,-5.55555794895108
2019-09-04,209,109,100,0,109,0,0,0.0
2019-09-05,175,58,117,2,56,2,2,8.900281977958983
2019-09-06,129,33,96,2,31,2,1,1.4980922051534202
2019-09-08,8,0,8,0,0,0,0,0.0
2019-09-09,181,134,47,0,134,0,0,0.0
2019-09-10,247,141,106,0,141,0,0,0.0
2019-09-11,232,124,108,0,124,0,0,0.0
2019-09-12,140,24,116,2,22,2,2,8.212189628735624
2019-09-13,131,57,74,1,56,1,0,-4.578265430007447
2019-09-15,1,1,0,1,0,1,1,4.5488662174394845
2019-09-16,65,38,27,2,36,2,2,4.144657828255288
2019-09-17,117,18,99,1,17,1,0,-5.467938796574515
2019-09-18,177,77,100,1,76,1,1,2.755147592669893
2019-09-19,206,99,107,1,98,1,0,-4.05548516136344
2019-09-20,199,103,96,1,102,1,1,2.374231078790693
2019-09-22,7,0,7,0,0,0,0,0.0
2019-09-23,86,47,39,1,46,1,0,-5.457668660571892
2019-09-24,174,64,110,1,63,1,1,1.3805156919991273
2019-09-25,136,31,105,1,30,1,0,-5.458193770046428
2019-09-26,170,55,115,1,54,1,0,-5.346109095685691
2019-09-27,161,67,94,1,66,1,0,-5.119305473074045
2019-09-29,19,0,19,0,0,0,0,0.0
2019-09-30,159,63,96,1,62,1,0,-3.889683006673996
2019-10-01,149,52,97,1,51,1,0,-5.591329476113842
2019-10-02,161,57,104,1,56,1,0,-4.158874322101619
2019-10-03,163,57,106,2,55,2,1,-3.540332500479946
2019-10-04,139,43,96,2,41,2,0,-10.433920976383085
2019-10-06,14,0,14,0,0,0,0,0.0
2019-10-07,178,92,86,1,91,1,1,4.373480857825931
2019-10-08,206,91,115,2,89,2,1,-3.261204497258798
2019-10-09,226,111,115,1,110,1,1,3.157328224677625
2019-10-10,106,3,103,2,1,2,0,-9.80734262258138
2019-10-11,154,64,90,2,62,2,2,5.976725484167595
2019-10-13,16,0,16,0,0,0,0,0.0
2019-10-14,218,113,105,1,112,1,1,0.47270635581203946
2019-10-15,171,72,99,1,71,1,1,4.302936337105274
2019-10-16,218,104,114,1,103,1,0,-4.527944531738601
2019-10-17,148,40,108,2,38,2,1,-3.062055468927168
2019-10-18,163,70,93,0,70,0,0,0.0
2019-10-20,4,4,0,0,4,0,0,0.0
2019-10-21,237,126,111,0,126,0,0,0.0
2019-10-22,259,146,113,0,146,0,0,0.0
2019-10-23,258,152,106,0,152,0,0,0.0
2019-10-24,195,97,98,0,97,0,0,0.0
2019-10-25,240,144,96,0,144,0,0,0.0
2019-10-27,14,12,2,0,12,0,0,0.0
2019-10-28,262,157,105,0,157,0,0,0.0
2019-10-29,176,121,55,0,121,0,0,0.0
2019-10-30,185,105,80,1,104,1,1,4.08231795198529
2019-10-31,131,28,103,2,26,2,2,4.250668488919274
2019-11-01,116,43,73,2,41,2,1,-2.017703470718936
2019-11-03,3,0,3,0,0,0,0,0.0
2019-11-04,158,125,33,0,125,0,0,0.0
2019-11-05,131,34,97,1,33,1,1,3.3395888934570435
2019-11-06,150,48,102,1,47,1,1,1.9059411300862283
2019-11-07,134,34,100,2,32,2,1,-4.124009023032853
2019-11-08,145,57,88,1,56,1,0,-3.98664423380086
2019-11-10,19,0,19,0,0,0,0,0.0
2019-11-11,236,139,97,0,139,0,0,0.0
2019-11-12,241,140,101,0,140,0,0,0.0
2019-11-13,124,30,94,2,28,2,2,0.8749488281013234
2019-11-14,121,34,87,2,32,2,1,-3.0450653085947765
2019-11-15,245,149,96,0,149,0,0,0.0
2019-11-17,15,0,15,0,0,0,0,0.0
2019-11-18,109,5,104,2,3,2,1,-3.558779202198817
2019-11-19,183,74,109,1,73,1,1,0.18461005777355144
2019-11-20,133,23,110,2,21,2,1,-2.4298527344182856
2019-11-21,138,43,95,1,42,1,0,-3.6610845197952004
2019-11-22,112,20,92,2,18,2,1,-4.55313182288885
2019-11-24,13,0,13,0,0,0,0,0.0
2019-11-25,227,112,115,0,112,0,0,0.0
2019-11-26,169,55,114,1,54,1,1,0.12952052932850222
2019-11-27,177,68,109,1,67,1,1,-0.3301912685607
2019-11-28,249,153,96,0,153,0,0,0.0
2019-11-29,177,81,96,1,80,1,1,-0.6647370197533036
2019-12-01,17,0,17,0,0,0,0,0.0
2019-12-02,172,56,116,1,55,1,0,-4.001134187518478
2019-12-03,143,26,117,2,24,2,2,3.413141784407977
2019-12-04,114,3,111,2,1,2,0,-7.916096380069766
2019-12-05,151,50,101,1,49,1,0,-4.273442226939543
2019-12-06,152,57,95,1,56,1,0,-4.839547880451775
2019-12-08,15,0,15,0,0,0,0,0.0
2019-12-09,252,154,98,0,154,0,0,0.0
2019-12-10,165,54,111,1,53,1,0,-4.694769860338133
2019-12-11,142,127,15,1,126,1,1,2.9057329882581397
2019-12-12,130,52,78,1,51,1,0,-3.6126362205270426
2019-12-13,101,42,59,1,41,1,0,-3.053237996759286
2019-12-15,18,0,18,0,0,0,0,0.0
2019-12-16,227,114,113,0,114,0,0,0.0
2019-12-17,171,136,35,0,136,0,0,0.0
2019-12-18,177,91,86,0,91,0,0,0.0
2019-12-19,198,143,55,0,143,0,0,0.0
2019-12-20,161,141,20,0,141,0,0,0.0
2019-12-22,20,0,20,0,0,0,0,0.0
2019-12-23,184,139,45,0,139,0,0,0.0
2019-12-24,219,138,81,0,138,0,0,0.0
2019-12-25,98,0,98,0,0,0,0,0.0
2019-12-26,252,156,96,0,156,0,0,0.0
2019-12-27,199,107,92,0,107,0,0,0.0
2019-12-29,6,0,6,0,0,0,0,0.0
2019-12-30,175,67,108,1,66,1,1,1.4113256519913608
2019-12-31,158,62,96,1,61,1,0,-3.757129772541279
2020-01-01,1,0,1,0,0,0,0,0.0
2020-01-02,71,49,22,1,48,1,1,1.1956218909463197
2020-01-03,93,7,86,2,5,2,0,-7.520473637236481
2020-01-05,14,0,14,0,0,0,0,0.0
2020-01-06,174,65,109,1,64,1,0,-4.6406749941742955
2020-01-07,176,69,107,1,68,1,0,-4.634893624789821
2020-01-08,125,22,103,2,20,2,1,-1.1173281567318685
2020-01-09,246,150,96,0,150,0,0,0.0
2020-01-10,106,67,39,1,66,1,0,-4.727938371031934
2020-01-12,15,0,15,0,0,0,0,0.0
2020-01-13,251,146,105,0,146,0,0,0.0
2020-01-14,198,92,106,1,91,1,1,2.4094555714954398
2020-01-15,250,150,100,0,150,0,0,0.0
2020-01-16,178,70,108,1,69,1,0,-4.875625088439018
2020-01-17,177,88,89,1,87,1,0,-4.887321686559188
2020-01-19,21,0,21,0,0,0,0,0.0
2020-01-20,250,134,116,0,134,0,0,0.0
2020-01-21,240,133,107,0,133,0,0,0.0
2020-01-22,257,146,111,0,146,0,0,0.0
2020-01-23,162,46,116,1,45,1,1,3.186385073220895
2020-01-24,162,67,95,1,66,1,1,1.6958992666864974
2020-01-26,13,0,13,0,0,0,0,0.0
2020-01-27,90,26,64,2,24,2,1,-2.426662300187606
2020-01-28,113,9,104,2,7,2,1,-2.3712941655843895
2020-01-29,113,45,68,1,44,1,1,2.055100631608264
2020-01-30,113,5,108,2,3,2,0,-9.987461663103204
2020-01-31,168,74,94,1,73,1,1,1.9098251445723675
2020-02-02,6,0,6,0,0,0,0,0.0
2020-02-03,128,21,107,2,19,2,1,-2.8750722505736914
2020-02-04,118,22,96,2,20,2,1,-4.062759254837848
2020-02-05,90,5,85,2,3,2,1,-0.8114822632716634
2020-02-06,175,69,106,1,68,1,1,1.0295737682253296
2020-02-07,151,55,96,1,54,1,1,2.050562818278586
2020-02-09,18,0,18,0,0,0,0,0.0
2020-02-10,238,136,102,0,136,0,0,0.0
2020-02-11,192,93,99,1,92,1,0,-3.400913634710757
2020-02-12,209,110,99,1,109,1,1,1.396021158926935
2020-02-13,119,12,107,2,10,2,1,-4.505280449267248
2020-02-14,138,80,58,1,79,1,1,0.08028501643819475
2020-02-16,0,0,0,0,0,0,0,0.0
2020-02-17,176,151,25,0,151,0,0,0.0
2020-02-18,140,32,108,1,31,1,1,-0.029011636403463825
2020-02-19,172,59,113,1,58,1,1,2.0143096562415357
2020-02-20,116,2,114,2,0,2,0,-7.5310986110468185
2020-02-21,97,2,95,2,0,2,0,-9.02462620263074
2020-02-23,14,0,14,0,0,0,0,0.0
2020-02-24,108,2,106,2,0,2,0,-8.270839886534118
2020-02-25,119,4,115,2,2,2,0,-8.401819852924628
2020-02-26,127,18,109,2,16,2,1,3.036996092203692
2020-02-27,110,2,108,2,0,2,0,-9.42395175714649
2020-02-28,71,3,68,2,1,2,1,3.32196589986183
2020-03-01,4,0,4,0,0,0,0,0.0
2020-03-02,99,2,97,2,0,2,0,-8.01508034376636
2020-03-03,112,2,110,2,0,2,0,-8.846349444616543
2020-03-04,132,20,112,1,19,1,0,-4.9733481877093215
2020-03-05,129,19,110,2,17,2,1,3.9391506755107857
2020-03-06,114,23,91,2,21,2,1,3.9428850726941436
2020-03-08,15,0,15,0,0,0,0,0.0
2020-03-09,115,3,112,2,1,2,0,-16.100222246534447
2020-03-10,104,2,102,2,0,2,0,-18.16954931422796
2020-03-11,205,91,114,1,90,1,0,-7.6215364201941025
2020-03-12,112,3,109,2,1,2,0,-15.913468194040014
2020-03-13,178,82,96,1,81,1,0,-8.587608628412642
2020-03-15,23,8,15,1,7,1,1,32.8783414938227
2020-03-16,98,56,42,2,54,2,1,4.996276256812225
2020-03-17,223,106,117,1,105,1,0,-8.908338645542475
2020-03-18,229,123,106,1,122,1,1,8.012826616684826
2020-03-19,113,3,110,2,1,2,0,-17.205462125676227
2020-03-20,188,94,94,1,93,1,0,-8.380827243074487
2020-03-22,22,12,10,0,12,0,0,0.0
2020-03-23,258,148,110,1,147,1,0,-10.489121011501332
2020-03-24,269,154,115,0,154,0,0,0.0
2020-03-25,173,60,113,2,58,2,1,1.8553845543585297
2020-03-26,198,87,111,1,86,1,1,8.348983312879875
2020-03-27,131,35,96,1,34,1,1,6.638498280125658
2020-03-29,14,0,14,0,0,0,0,0.0
2020-03-30,212,114,98,1,113,1,1,2.564394336713849
2020-03-31,163,48,115,1,47,1,1,4.903963052166275
2020-04-01,169,55,114,1,54,1,1,0.823221368072053
2020-04-02,132,17,115,2,15,2,1,-5.335520421887525
2020-04-03,74,22,52,2,20,2,1,-12.632432094084395
2020-04-05,12,0,12,0,0,0,0,0.0
2020-04-06,131,14,117,2,12,2,1,-9.124288660429432
2020-04-07,120,9,111,2,7,2,1,-9.578330321354436
2020-04-08,107,11,96,2,9,2,1,-4.749517763571227
2020-04-09,143,29,114,2,27,2,1,-11.382394542580883
2020-04-10,223,134,89,0,134,0,0,0.0
2020-04-12,15,12,3,0,12,0,0,0.0
2020-04-13,128,25,103,2,23,2,1,-7.141699213426465
2020-04-14,100,10,90,2,8,2,1,-9.64407941855788
2020-04-15,107,2,105,2,0,2,0,-11.004130351337913
2020-04-16,106,3,103,2,1,2,1,-1.6335840105010706
2020-04-17,116,20,96,2,18,2,1,2.277655845474289
2020-04-19,18,0,18,0,0,0,0,0.0
2020-04-20,136,24,112,2,22,2,2,0.978531029801581
2020-04-21,113,2,111,2,0,2,0,-11.136379330954265
2020-04-22,106,10,96,2,8,2,1,-4.587373242246262
2020-04-23,57,4,53,2,2,2,0,-10.830740240220994
2020-04-24,239,145,94,1,144,1,1,-0.6369646032957386
2020-04-26,26,10,16,0,10,0,0,0.0
2020-04-27,118,14,104,2,12,2,1,-0.6924948924869421
2020-04-28,131,17,114,2,15,2,1,-1.6197372624728592
2020-04-29,98,2,96,2,0,2,0,-8.819229883390815
2020-04-30,119,14,105,2,12,2,1,-0.7683002363431877
2020-05-01,68,20,48,2,18,2,1,2.2570420016083594
2020-05-03,7,0,7,0,0,0,0,0.0
2020-05-04,160,46,114,1,45,1,1,2.049460445670432
2020-05-05,126,15,111,2,13,2,2,4.3142005182156575
2020-05-06,123,8,115,2,6,2,2,1.2563481288299054
2020-05-07,112,2,110,2,0,2,0,-7.677746151562992
2020-05-08,116,21,95,2,19,2,0,-9.4400708629303
2020-05-10,21,0,21,0,0,0,0,0.0
2020-05-11,170,65,105,2,63,2,2,4.129709893709001
2020-05-12,135,25,110,2,23,2,1,-2.6523517141178554
2020-05-13,109,2,107,2,0,2,0,-8.184971812480216
2020-05-14,157,51,106,2,49,2,1,-1.7083028679537327
2020-05-15,118,39,79,2,37,2,1,-2.1672672571021345
2020-05-17,21,0,21,0,0,0,0,0.0
2020-05-18,122,63,59,1,62,1,0,-3.878467190074328
2020-05-19,121,5,116,2,3,2,1,-0.8027477781661014
2020-05-20,193,89,104,1,88,1,0,-2.9983457523606756
2020-05-21,224,127,97,0,127,0,0,0.0
2020-05-22,178,98,80,0,98,0,0,0.0
2020-05-24,18,7,11,0,7,0,0,0.0
2020-05-25,169,106,63,0,106,0,0,0.0
2020-05-26,226,111,115,1,110,1,1,1.2952514246582778
2020-05-27,102,14,88,2,12,2,2,4.36522766431415
2020-05-28,165,65,100,1,64,1,1,2.8260472388343296
2020-05-29,92,2,90,2,0,2,0,-8.816174006004868
2020-05-31,16,0,16,0,0,0,0,0.0
2020-06-01,213,104,109,1,103,1,0,-4.878673341284591
2020-06-02,112,14,98,2,12,2,1,-3.6114495839713774
2020-06-03,122,10,112,2,8,2,1,0.13328152872187715
2020-06-04,113,3,110,2,1,2,0,-8.738724450910382
2020-06-05,87,2,85,2,0,2,0,-8.280175637644557
2020-06-07,3,0,3,0,0,0,0,0.0
2020-06-08,129,19,110,2,17,2,1,-2.6351767758240654
2020-06-09,125,14,111,2,12,2,1,0.9743465244918705
2020-06-10,121,13,108,2,11,2,1,-0.15737550784868404
2020-06-11,111,2,109,2,0,2,0,-9.757430902983515
2020-06-12,105,10,95,2,8,2,0,-8.629989611748986
2020-06-14,5,0,5,0,0,0,0,0.0
2020-06-15,221,120,101,1,119,1,0,-4.477103358633933
2020-06-16,100,12,88,2,10,2,0,-8.69203433484465
2020-06-17,224,118,106,0,118,0,0,0.0
2020-06-18,227,121,106,0,121,0,0,0.0
2020-06-19,172,87,85,0,87,0,0,0.0
2020-06-21,15,12,3,0,12,0,0,0.0
2020-06-22,222,124,98,0,124,0,0,0.0
2020-06-23,150,38,112,2,36,2,1,-0.908750443080041
2020-06-24,206,115,91,1,114,1,1,2.539762631436037
2020-06-25,215,155,60,1,154,1,1,1.9543409901291997
2020-06-26,225,144,81,0,144,0,0,0.0
2020-06-28,14,12,2,0,12,0,0,0.0
2020-06-29,130,60,70,1,59,1,1,6.340635114167302
2020-06-30,161,60,101,1,59,1,0,-5.553457132500274
2020-07-01,182,75,107,1,74,1,1,1.1264714275626395
2020-07-02,128,46,82,2,44,2,2,8.487055330356903
2020-07-03,171,113,58,0,113,0,0,0.0
2020-07-05,19,12,7,0,12,0,0,0.0
2020-07-06,254,144,110,0,144,0,0,0.0
2020-07-07,260,153,107,0,153,0,0,0.0
2020-07-08,261,155,106,0,155,0,0,0.0
2020-07-09,170,67,103,1,66,1,0,-5.25069352861642
2020-07-10,237,141,96,0,141,0,0,0.0
2020-07-12,26,12,14,0,12,0,0,0.0
2020-07-13,213,128,85,0,128,0,0,0.0
2020-07-14,243,154,89,0,154,0,0,0.0
2020-07-15,166,103,63,1,102,1,0,-5.880346606992033
2020-07-16,258,158,100,0,158,0,0,0.0
2020-07-17,240,146,94,0,146,0,0,0.0
2020-07-19,15,10,5,0,10,0,0,0.0
2020-07-20,249,143,106,0,143,0,0,0.0
2020-07-21,185,69,116,1,68,1,1,3.9469044656210155
2020-07-22,188,103,85,1,102,1,0,-4.1102095081794765
2020-07-23,230,150,80,0,150,0,0,0.0
2020-07-24,100,4,96,2,2,2,1,2.4089284474081554
2020-07-26,9,0,9,0,0,0,0,0.0
2020-07-27,110,6,104,2,4,2,1,0.8967200828134816
2020-07-28,101,2,99,2,0,2,0,-8.878039650981542
2020-07-29,108,9,99,2,7,2,0,-8.865165361467477
2020-07-30,167,54,113,2,52,2,0,-9.302413563975833
2020-07-31,141,45,96,2,43,2,1,-0.05696841401121855
2020-08-02,5,0,5,0,0,0,0,0.0
2020-08-03,119,32,87,2,30,2,1,-1.8530866882583332
2020-08-04,217,103,114,1,102,1,1,2.5581787497567356
2020-08-05,181,80,101,1,79,1,0,-3.812271326605823
2020-08-06,140,41,99,1,40,1,1,3.7337261914338846
2020-08-07,115,21,94,2,19,2,0,-9.329416844517823
2020-08-09,7,0,7,0,0,0,0,0.0
2020-08-10,221,115,106,0,115,0,0,0.0
2020-08-11,146,38,108,1,37,1,0,-5.4161653146440765
2020-08-12,245,144,101,1,143,1,0,-5.251651799236479
2020-08-13,234,121,113,0,121,0,0,0.0
2020-08-14,198,119,79,0,119,0,0,0.0
2020-08-16,20,11,9,0,11,0,0,0.0
2020-08-17,244,152,92,0,152,0,0,0.0
2020-08-18,246,129,117,0,129,0,0,0.0
2020-08-19,263,152,111,0,152,0,0,0.0
2020-08-20,232,130,102,1,129,1,1,3.085180606230013
2020-08-21,160,64,96,1,63,1,1,5.642660323091946
2020-08-23,19,0,19,0,0,0,0,0.0
2020-08-24,201,142,59,0,142,0,0,0.0
2020-08-25,198,95,103,1,94,1,1,2.214645684614017
2020-08-26,243,133,110,0,133,0,0,0.0
2020-08-27,92,3,89,2,1,2,1,-2.405549214864316
2020-08-28,110,14,96,2,12,2,1,0.041545141245451056
2020-08-30,4,0,4,0,0,0,0,0.0
2020-08-31,137,100,37,1,99,1,0,-3.7985408053843672
2020-09-01,218,105,113,1,104,1,0,-3.5923959301564583
2020-09-02,149,36,113,1,35,1,1,2.47961432970223
2020-09-03,190,78,112,2,76,2,2,9.070076435907104
2020-09-04,208,136,72,1,135,1,1,0.8118513344655067
2020-09-06,26,12,14,0,12,0,0,0.0
2020-09-07,253,149,104,0,149,0,0,0.0
2020-09-08,160,48,112,2,46,2,1,-4.703708515267801
2020-09-09,118,85,33,0,85,0,0,0.0
2020-09-10,245,137,108,1,136,1,0,-5.9749690153319355
2020-09-11,216,129,87,0,129,0,0,0.0
2020-09-13,24,12,12,0,12,0,0,0.0
2020-09-14,259,156,103,0,156,0,0,0.0
2020-09-15,235,133,102,0,133,0,0,0.0
2020-09-16,141,25,116,2,23,2,1,-4.2440505486579045
2020-09-17,219,105,114,1,104,1,0,-4.885652511363747
2020-09-18,184,91,93,1,90,1,0,-3.8075739911850746
2020-09-20,12,12,0,0,12,0,0,0.0
2020-09-21,92,5,87,2,3,2,1,4.632703119954819
2020-09-22,261,160,101,0,160,0,0,0.0
2020-09-23,240,141,99,1,140,1,1,0.8367075429095459
2020-09-24,165,59,106,1,58,1,0,-4.16390886290915
2020-09-25,233,148,85,0,148,0,0,0.0
2020-09-27,32,12,20,0,12,0,0,0.0
2020-09-28,220,106,114,0,106,0,0,0.0
2020-09-29,163,66,97,1,65,1,1,0.9223522112502671
2020-09-30,258,155,103,0,155,0,0,0.0
2020-10-01,239,145,94,0,145,0,0,0.0
2020-10-02,175,91,84,1,90,1,0,-3.905325062290726
2020-10-04,24,8,16,0,8,0,0,0.0
2020-10-05,215,113,102,0,113,0,0,0.0
2020-10-06,226,122,104,0,122,0,0,0.0
2020-10-07,202,104,98,1,103,1,1,2.8898656578764896
2020-10-08,181,100,81,0,100,0,0,0.0
2020-10-09,214,118,96,0,118,0,0,0.0
2020-10-11,32,12,20,0,12,0,0,0.0
2020-10-12,201,94,107,0,94,0,0,0.0
2020-10-13,200,105,95,0,105,0,0,0.0
2020-10-14,241,135,106,0,135,0,0,0.0
2020-10-15,268,154,114,0,154,0,0,0.0
2020-10-16,218,122,96,1,121,1,0,-4.739213631056525
2020-10-18,11,0,11,0,0,0,0,0.0
2020-10-19,222,156,66,0,156,0,0,0.0
2020-10-20,254,154,100,0,154,0,0,0.0
2020-10-21,214,105,109,1,104,1,0,-4.247358172989316
2020-10-22,258,151,107,0,151,0,0,0.0
2020-10-23,162,67,95,0,67,0,0,0.0
2020-10-25,30,12,18,0,12,0,0,0.0
2020-10-26,251,144,107,0,144,0,0,0.0
2020-10-27,264,148,116,0,148,0,0,0.0
2020-10-28,244,140,104,0,140,0,0,0.0
2020-10-29,252,148,104,1,147,1,0,-5.110566684346817
2020-10-30,148,52,96,1,51,1,0,-4.728258235576426
2020-11-01,8,0,8,0,0,0,0,0.0
2020-11-02,253,157,96,0,157,0,0,0.0
2020-11-03,190,148,42,0,148,0,0,0.0
2020-11-04,116,3,113,2,1,2,0,-9.35964152618083
2020-11-05,144,27,117,2,25,2,1,-1.2572668958625495
2020-11-06,108,20,88,2,18,2,1,-2.1173202840848635
2020-11-08,21,0,21,0,0,0,0,0.0
2020-11-09,148,43,105,2,41,2,1,-3.945053268205631
2020-11-10,138,42,96,1,41,1,1,1.6830784351487482
2020-11-11,165,70,95,1,69,1,1,2.7261113577751495
2020-11-12,227,123,104,1,122,1,0,-5.528033912314649
2020-11-13,250,154,96,0,154,0,0,0.0
2020-11-15,0,0,0,0,0,0,0,0.0
2020-11-16,211,129,82,1,128,1,1,0.7601586041085824
2020-11-17,159,42,117,1,41,1,1,0.4803231210181256
2020-11-18,203,93,110,1,92,1,1,2.122157136108839
2020-11-19,184,91,93,1,90,1,0,-3.9724708515615648
2020-11-20,198,109,89,0,109,0,0,0.0
2020-11-22,16,0,16,0,0,0,0,0.0
2020-11-23,105,60,45,1,59,1,1,7.037812052825907
2020-11-24,179,85,94,1,84,1,0,-4.683630463402537
2020-11-25,179,69,110,1,68,1,0,-3.8215018323905863
2020-11-26,216,104,112,0,104,0,0,0.0
2020-11-27,225,129,96,0,129,0,0,0.0
2020-11-29,16,0,16,0,0,0,0,0.0
2020-11-30,208,97,111,1,96,1,0,-5.203849434201388
2020-12-01,243,132,111,0,132,0,0,0.0
2020-12-02,208,91,117,1,90,1,1,1.5194505655340231
2020-12-03,217,112,105,1,111,1,0,-5.19653145909632
2020-12-04,173,98,75,1,97,1,0,-5.121678837916928
2020-12-06,17,0,17,0,0,0,0,0.0
2020-12-07,182,112,70,1,111,1,1,1.6463457436435553
2020-12-08,204,109,95,0,109,0,0,0.0
2020-12-09,269,156,113,0,156,0,0,0.0
2020-12-10,230,130,100,0,130,0,0,0.0
2020-12-11,241,145,96,0,145,0,0,0.0
2020-12-13,6,0,6,0,0,0,0,0.0
2020-12-14,186,150,36,0,150,0,0,0.0
2020-12-15,235,146,89,0,146,0,0,0.0
2020-12-16,180,67,113,1,66,1,1,4.284447671365817
2020-12-17,115,14,101,2,12,2,0,-8.84198882542265
2020-12-18,138,42,96,1,41,1,0,-5.235594939235169
2020-12-20,1,0,1,0,0,0,0,0.0
2020-12-21,118,99,19,1,98,1,0,-3.8245238294236885
2020-12-22,258,150,108,0,150,0,0,0.0
2020-12-23,209,95,114,0,95,0,0,0.0
2020-12-24,230,117,113,0,117,0,0,0.0
2020-12-25,60,0,60,0,0,0,0,0.0
2020-12-27,17,0,17,0,0,0,0,0.0
2020-12-28,230,151,79,0,151,0,0,0.0
2020-12-29,223,120,103,0,120,0,0,0.0
2020-12-30,254,151,103,0,151,0,0,0.0
2020-12-31,149,146,3,0,146,0,0,0.0
2021-01-03,13,0,13,0,0,0,0,0.0
2021-01-04,257,155,102,0,155,0,0,0.0
2021-01-05,256,151,105,0,151,0,0,0.0
2021-01-06,226,138,88,0,138,0,0,0.0
2021-01-07,213,103,110,1,102,1,0,-3.8616653668047523
2021-01-08,107,11,96,2,9,2,2,8.642886708487103
2021-01-10,20,0,20,0,0,0,0,0.0
2021-01-11,247,134,113,0,134,0,0,0.0
2021-01-12,217,131,86,0,131,0,0,0.0
2021-01-13,207,97,110,0,97,0,0,0.0
2021-01-14,214,110,104,0,110,0,0,0.0
2021-01-15,160,125,35,0,125,0,0,0.0
2021-01-17,5,0,5,0,0,0,0,0.0
2021-01-18,246,142,104,0,142,0,0,0.0
2021-01-19,208,112,96,0,112,0,0,0.0
2021-01-20,249,149,100,0,149,0,0,0.0
2021-01-21,171,63,108,1,62,1,1,3.517311946744148
2021-01-22,212,116,96,0,116,0,0,0.0
2021-01-24,1,0,1,0,0,0,0,0.0
2021-01-25,195,117,78,0,117,0,0,0.0
2021-01-26,194,123,71,0,123,0,0,0.0
2021-01-27,174,81,93,1,80,1,1,2.6968550883534084
2021-01-28,221,116,105,0,116,0,0,0.0
2021-01-29,131,35,96,2,33,2,2,3.773204938958973
2021-01-31,18,0,18,0,0,0,0,0.0
2021-02-01,218,115,103,0,115,0,0,0.0
2021-02-02,227,135,92,0,135,0,0,0.0
2021-02-03,199,88,111,0,88,0,0,0.0
2021-02-04,259,155,104,0,155,0,0,0.0
2021-02-05,119,63,56,1,62,1,0,-5.5021740546683215
2021-02-07,21,0,21,0,0,0,0,0.0
2021-02-08,261,156,105,0,156,0,0,0.0
2021-02-09,176,66,110,1,65,1,0,-5.616119121517464
2021-02-10,134,32,102,2,30,2,1,-3.6585576438732383
2021-02-11,172,138,34,0,138,0,0,0.0
2021-02-12,243,155,88,0,155,0,0,0.0
2021-02-14,18,0,18,0,0,0,0,0.0
2021-02-15,232,128,104,0,128,0,0,0.0
2021-02-16,166,52,114,1,51,1,0,-5.408830131891889
2021-02-17,214,114,100,1,113,1,1,1.6104469136424475
2021-02-18,159,62,97,1,61,1,0,-5.384592351514316
2021-02-19,111,22,89,2,20,2,2,3.35708689578062
2021-02-21,16,0,16,0,0,0,0,0.0
2021-02-22,250,150,100,0,150,0,0,0.0
2021-02-23,190,94,96,1,93,1,1,1.0610685566769842
2021-02-24,177,64,113,1,63,1,1,0.11295580836880426
2021-02-25,125,13,112,2,11,2,1,-0.8949800323331338
2021-02-26,192,106,86,1,105,1,1,0.7453432366032016
2021-02-28,7,0,7,0,0,0,0,0.0
2021-03-01,188,96,92,1,95,1,0,-4.09443006812785
2021-03-02,128,21,107,2,19,2,1,-1.9562448630000246
2021-03-03,182,67,115,1,66,1,1,2.692163799653231
2021-03-04,183,74,109,2,72,2,2,1.68518502422884
2021-03-05,93,4,89,2,2,2,1,2.532985362381604
2021-03-07,13,0,13,0,0,0,0,0.0
2021-03-08,195,105,90,1,104,1,0,-5.4258749877245895
2021-03-09,116,2,114,2,0,2,0,-7.840667427443082
2021-03-10,123,12,111,2,10,2,1,-2.413355605308676
2021-03-11,178,73,105,1,72,1,0,-4.528384159978712
2021-03-12,130,34,96,1,33,1,0,-4.3613870647127575
2021-03-14,22,4,18,0,4,0,0,0.0
2021-03-15,187,94,93,1,93,1,0,-5.0398555867011305
2021-03-16,146,46,100,2,44,2,1,-2.1328129072229434
2021-03-17,230,115,115,1,114,1,1,6.951377368597074
2021-03-18,205,96,109,1,95,1,0,-4.291110144407698
2021-03-19,166,70,96,0,70,0,0,0.0
2021-03-21,22,12,10,0,12,0,0,0.0
2021-03-22,111,78,33,0,78,0,0,0.0
2021-03-23,131,22,109,2,20,2,2,3.1692598707981223
2021-03-24,179,72,107,1,71,1,1,1.8858715334268195
2021-03-25,158,43,115,1,42,1,0,-3.8610152488419494
2021-03-26,99,3,96,2,1,2,1,-0.7420967281550332
2021-03-28,16,0,16,0,0,0,0,0.0
2021-03-29,252,154,98,0,154,0,0,0.0
2021-03-30,226,113,113,0,113,0,0,0.0
2021-03-31,118,2,116,2,0,2,0,-6.685207176381304
2021-04-01,195,99,96,1,98,1,0,-4.069021499536707
2021-04-02,145,54,91,1,53,1,1,2.6345586735891624
2021-04-04,20,0,20,0,0,0,0,0.0
2021-04-05,118,42,76,1,41,1,1,5.741635541739251
2021-04-06,118,11,107,2,9,2,1,-2.678074370664849
2021-04-07,114,8,106,2,6,2,1,0.34231245847927383
2021-04-08,114,2,112,2,0,2,0,-7.890798805834901
2021-04-09,168,97,71,1,96,1,1,2.087345451981486
2021-04-11,30,11,19,0,11,0,0,0.0
2021-04-12,212,106,106,1,105,1,0,-4.989867809287509
2021-04-13,117,2,115,2,0,2,0,-8.507045650287491
2021-04-14,149,46,103,1,45,1,0,-4.794144908103727
2021-04-15,170,54,116,2,52,2,0,-9.008767220610462
2021-04-16,234,138,96,0,138,0,0,0.0
2021-04-18,29,12,17,0,12,0,0,0.0
2021-04-19,148,41,107,1,40,1,0,-3.76167653539071
2021-04-20,261,148,113,0,148,0,0,0.0
2021-04-21,266,150,116,0,150,0,0,0.0
2021-04-22,178,65,113,1,64,1,1,3.779479228969666
2021-04-23,116,39,77,2,37,2,2,8.515896059658816
2021-04-25,17,0,17,0,0,0,0,0.0
2021-04-26,138,23,115,2,21,2,1,-0.15760869762897434
2021-04-27,264,150,114,0,150,0,0,0.0
2021-04-28,168,51,117,2,49,2,1,-3.00458903352398
2021-04-29,165,52,113,1,51,1,0,-3.6594270937044846
2021-04-30,236,140,96,0,140,0,0,0.0
2021-05-02,13,12,1,0,12,0,0,0.0
2021-05-03,165,56,109,1,55,1,0,-5.225830189166684
2021-05-04,158,50,108,2,48,2,2,6.5038162066939575
2021-05-05,162,53,109,1,52,1,1,4.744701014343477
2021-05-06,175,65,110,2,63,2,2,6.126394089499964
2021-05-07,125,34,91,2,32,2,0,-13.627689771310536
2021-05-09,1,0,1,0,0,0,0,0.0
2021-05-10,232,117,115,1,116,1,1,1.8323080164548575
2021-05-11,145,37,108,2,35,2,1,-2.6753672514357634
2021-05-12,161,51,110,2,49,2,0,-10.235790400957647
2021-05-13,95,4,91,2,2,2,0,-8.27490787047162
2021-05-14,123,27,96,1,26,1,0,-3.7211755044296897
2021-05-16,20,0,20,0,0,0,0,0.0
2021-05-17,176,103,73,0,103,0,0,0.0
2021-05-18,209,109,100,0,109,0,0,0.0
2021-05-19,167,53,114,1,52,1,0,-6.236691490755163
2021-05-20,152,36,116,1,35,1,0,-3.770848879061572
2021-05-21,132,37,95,1,36,1,1,2.6087458227855724
2021-05-23,5,0,5,0,0,0,0,0.0
2021-05-24,242,158,84,0,158,0,0,0.0
2021-05-25,142,37,105,1,36,1,0,-5.141008526583025
2021-05-26,245,150,95,0,150,0,0,0.0
2021-05-27,168,56,112,1,55,1,0,-3.5569575979342334
2021-05-28,134,39,95,2,37,2,2,7.44377325522446
2021-05-30,12,0,12,0,0,0,0,0.0
2021-05-31,255,140,115,0,140,0,0,0.0
2021-06-01,140,38,102,1,37,1,1,4.035754541459009
2021-06-02,272,156,116,0,156,0,0,0.0
2021-06-03,165,54,111,2,52,2,1,-3.3448476149235558
2021-06-04,138,42,96,2,40,2,1,-1.0836591301980465
2021-06-06,18,0,18,0,0,0,0,0.0
2021-06-07,92,18,74,1,17,1,0,-3.5485711033174248
2021-06-08,153,48,105,1,47,1,0,-3.3787955596802797
2021-06-09,154,54,100,1,53,1,1,2.5718449761156528
2021-06-10,164,53,111,2,51,2,1,0.5599605830840355
2021-06-11,110,18,92,2,16,2,1,-0.8679386885837665
2021-06-13,3,0,3,0,0,0,0,0.0
2021-06-14,230,142,88,0,142,0,0,0.0
2021-06-15,137,39,98,1,38,1,0,-4.4916113151320705
2021-06-16,191,92,99,1,91,1,1,2.4737067721480566
2021-06-17,209,102,107,1,101,1,0,-5.052508682996506
2021-06-18,150,56,94,2,54,2,2,5.31848619093064
2021-06-20,2,0,2,0,0,0,0,0.0
2021-06-21,121,14,107,2,12,2,0,-9.410235128031923
2021-06-22,150,49,101,1,48,1,0,-4.376793936583802
2021-06-23,134,31,103,2,29,2,2,4.557264303261649
2021-06-24,253,152,101,1,151,1,1,1.3617315356643163
2021-06-25,131,42,89,2,40,2,2,5.00521661969205
2021-06-27,0,0,0,0,0,0,0,0.0
2021-06-28,153,59,94,2,57,2,2,1.9938431883109327
2021-06-29,103,2,101,2,0,2,0,-7.149735844663559
2021-06-30,153,48,105,2,46,2,1,-1.641346903235412
2021-07-01,96,2,94,2,0,2,0,-7.754493235300968
2021-07-02,134,38,96,2,36,2,0,-11.243943600427919
2021-07-04,21,0,21,0,0,0,0,0.0
2021-07-05,212,121,91,0,121,0,0,0.0
2021-07-06,255,145,110,0,145,0,0,0.0
2021-07-07,160,50,110,2,48,2,1,-3.0301224857142834
2021-07-08,121,7,114,2,5,2,0,-10.239314429888799
2021-07-09,230,134,96,1,133,1,0,-4.785024378518697
2021-07-11,28,12,16,0,12,0,0,0.0
2021-07-12,215,159,56,0,159,0,0,0.0
2021-07-13,157,42,115,2,40,2,0,-10.263827863321051
2021-07-14,151,35,116,2,33,2,1,-2.5430416994361247
2021-07-15,204,92,112,1,91,1,1,1.6338265627720436
2021-07-16,188,92,96,1,91,1,0,-3.606913403867595
2021-07-18,26,12,14,0,12,0,0,0.0
2021-07-19,162,49,113,1,48,1,1,2.6122743362437726
2021-07-20,210,103,107,1,102,1,0,-3.5199068804817175
2021-07-21,161,60,101,0,60,0,0,0.0
2021-07-22,130,26,104,2,24,2,1,-2.6383867693888536
2021-07-23,236,145,91,0,145,0,0,0.0
2021-07-25,13,9,4,0,9,0,0,0.0
2021-07-26,177,69,108,0,69,0,0,0.0
2021-07-27,212,98,114,1,97,1,0,-4.018947738311532
2021-07-28,244,130,114,0,130,0,0,0.0
2021-07-29,130,18,112,2,16,2,1,-0.8861264239644067
2021-07-30,201,105,96,0,105,0,0,0.0
2021-08-01,16,12,4,0,12,0,0,0.0
2021-08-02,189,155,34,0,155,0,0,0.0
2021-08-03,261,147,114,0,147,0,0,0.0
2021-08-04,126,44,82,2,42,2,2,9.032638438801724
2021-08-05,246,142,104,1,141,1,1,-0.09572267980906402
2021-08-06,152,58,94,2,56,2,1,-3.395887123673918
2021-08-08,13,0,13,0,0,0,0,0.0
2021-08-09,190,97,93,1,96,1,0,-4.340245106071668
2021-08-10,222,151,71,0,151,0,0,0.0
2021-08-11,155,46,109,2,44,2,1,-2.7546474732171946
2021-08-12,247,138,109,0,138,0,0,0.0
2021-08-13,205,122,83,0,122,0,0,0.0
2021-08-15,28,12,16,0,12,0,0,0.0
2021-08-16,181,69,112,0,69,0,0,0.0
2021-08-17,106,5,101,2,3,2,0,-8.674630689486658
2021-08-18,212,122,90,0,122,0,0,0.0
2021-08-19,149,46,103,1,45,1,0,-3.5881071460543903
2021-08-20,116,27,89,1,26,1,0,-5.077422898302857
2021-08-22,32,12,20,0,12,0,0,0.0
2021-08-23,254,142,112,0,142,0,0,0.0
2021-08-24,273,158,115,0,158,0,0,0.0
2021-08-25,254,140,114,0,140,0,0,0.0
2021-08-26,242,130,112,1,129,1,1,2.195283179805838
2021-08-27,133,37,96,1,36,1,0,-5.617788526621523
2021-08-29,6,0,6,0,0,0,0,0.0
2021-08-30,204,115,89,0,115,0,0,0.0
2021-08-31,253,150,103,1,149,1,1,0.6670726120914447
2021-09-01,170,55,115,1,54,1,0,-3.6605013820462307
2021-09-02,252,143,109,0,143,0,0,0.0
2021-09-03,145,49,96,2,47,2,1,-4.554839245703219
2021-09-05,4,0,4,0,0,0,0,0.0
2021-09-06,181,76,105,0,76,0,0,0.0
2021-09-07,220,109,111,0,109,0,0,0.0
2021-09-08,168,65,103,1,64,1,0,-5.500944915521051
2021-09-09,218,101,117,1,100,1,0,-5.947750033829042
2021-09-10,180,99,81,0,99,0,0,0.0
2021-09-12,15,11,4,0,11,0,0,0.0
2021-09-13,258,144,114,0,144,0,0,0.0
2021-09-14,255,141,114,1,140,1,0,-3.9697793760377804
2021-09-15,208,93,115,1,92,1,1,1.3007970899309118
2021-09-16,193,84,109,1,83,1,1,1.0462568585703087
2021-09-17,239,143,96,0,143,0,0,0.0
2021-09-19,16,12,4,0,12,0,0,0.0
2021-09-20,198,90,108,1,89,1,0,-3.8980686005850984
2021-09-21,239,123,116,1,122,1,1,2.303092254545443
2021-09-22,260,145,115,0,145,0,0,0.0
2021-09-23,248,151,97,1,150,1,1,1.8929713678159772
2021-09-24,190,94,96,1,93,1,0,-3.7623878416818393
2021-09-26,12,12,0,0,12,0,0,0.0
2021-09-27,190,98,92,1,97,1,1,1.5626602380196872
2021-09-28,171,59,112,1,58,1,0,-3.9621584009421813
2021-09-29,213,105,108,1,104,1,0,-3.5127803815070338
2021-09-30,221,106,115,1,105,1,0,-4.332368529594515
2021-10-01,121,30,91,1,29,1,0,-4.31080762102164
2021-10-03,14,12,2,0,12,0,0,0.0
2021-10-04,240,157,83,0,157,0,0,0.0
2021-10-05,271,159,112,0,159,0,0,0.0
2021-10-06,184,72,112,1,71,1,0,-3.259331163146085
2021-10-07,239,126,113,0,126,0,0,0.0
2021-10-08,150,54,96,2,52,2,2,14.177190897738527
2021-10-10,18,0,18,0,0,0,0,0.0
2021-10-11,235,122,113,1,121,1,0,-4.986684794100844
2021-10-12,113,11,102,1,10,1,0,-5.337624776918446
2021-10-13,136,24,112,2,22,2,2,10.907841334958347
2021-10-14,254,139,115,0,139,0,0,0.0
2021-10-15,194,98,96,1,97,1,1,2.212968146483551
2021-10-17,16,12,4,0,12,0,0,0.0
2021-10-18,136,63,73,1,62,1,0,-5.789876259465194
2021-10-19,183,66,117,1,65,1,0,-4.230941489104627
2021-10-20,247,131,116,1,130,1,1,2.6395906177156547
2021-10-21,165,53,112,2,51,2,0,-9.023996720244348
2021-10-22,184,88,96,1,87,1,0,-3.6453243318519024
2021-10-24,32,12,20,0,12,0,0,0.0
2021-10-25,258,147,111,0,147,0,0,0.0
2021-10-26,218,102,116,1,101,1,0,-5.320263092995879
2021-10-27,128,15,113,2,13,2,0,-9.714363144782752
2021-10-28,234,124,110,1,123,1,0,-5.426290930845633
2021-10-29,245,149,96,0,149,0,0,0.0
2021-10-31,27,12,15,0,12,0,0,0.0
2021-11-01,240,132,108,0,132,0,0,0.0
2021-11-02,249,137,112,0,137,0,0,0.0
2021-11-03,264,154,110,0,154,0,0,0.0
2021-11-04,229,112,117,1,111,1,1,3.5982898554498606
2021-11-05,137,41,96,2,39,2,1,-2.162984069289312
2021-11-07,20,0,20,0,0,0,0,0.0
2021-11-08,274,159,115,0,159,0,0,0.0
2021-11-09,256,143,113,0,143,0,0,0.0
2021-11-10,249,155,94,0,155,0,0,0.0
2021-11-11,238,132,106,0,132,0,0,0.0
2021-11-12,235,139,96,0,139,0,0,0.0
2021-11-14,21,0,21,0,0,0,0,0.0
2021-11-15,247,148,99,0,148,0,0,0.0
2021-11-16,258,144,114,0,144,0,0,0.0
2021-11-17,259,154,105,0,154,0,0,0.0
2021-11-18,147,83,64,0,83,0,0,0.0
2021-11-19,202,106,96,1,105,1,0,-5.594545136372297
2021-11-21,21,0,21,0,0,0,0,0.0
2021-11-22,224,123,101,0,123,0,0,0.0
2021-11-23,158,57,101,1,56,1,0,-5.821091000627957
2021-11-24,215,122,93,1,121,1,1,4.693540007306806
2021-11-25,167,117,50,0,117,0,0,0.0
2021-11-26,198,102,96,2,100,2,1,9.067446829845494
2021-11-28,15,0,15,0,0,0,0,0.0
2021-11-29,177,104,73,0,104,0,0,0.0
2021-11-30,148,33,115,2,31,2,1,10.396292201529707
2021-12-01,162,53,109,1,52,1,1,8.147386325884815
2021-12-02,155,43,112,2,41,2,1,-3.129079232709433
2021-12-03,139,65,74,1,64,1,1,9.46385503266656
2021-12-05,14,0,14,0,0,0,0,0.0
2021-12-06,222,109,113,1,108,1,0,-4.4207807111011235
2021-12-07,203,91,112,0,91,0,0,0.0
2021-12-08,228,138,90,1,137,1,0,-6.734555620702016
2021-12-09,247,139,108,0,139,0,0,0.0
2021-12-10,158,63,95,1,62,1,1,6.129966531656233
2021-12-12,17,0,17,0,0,0,0,0.0
2021-12-13,255,141,114,0,141,0,0,0.0
2021-12-14,258,152,106,0,152,0,0,0.0
2021-12-15,211,114,97,1,113,1,1,4.704936339505483
2021-12-16,166,52,114,1,51,1,1,3.5054852272550567
2021-12-17,150,57,93,1,56,1,0,-4.980595082879301
2021-12-19,12,0,12,0,0,0,0,0.0
2021-12-20,244,143,101,0,143,0,0,0.0
2021-12-21,263,156,107,0,156,0,0,0.0
2021-12-22,218,139,79,0,139,0,0,0.0
2021-12-23,240,123,117,0,123,0,0,0.0
2021-12-24,220,124,96,0,124,0,0,0.0
2021-12-26,4,0,4,0,0,0,0,0.0
2021-12-27,228,153,75,0,153,0,0,0.0
2021-12-28,245,144,101,0,144,0,0,0.0
2021-12-29,227,111,116,0,111,0,0,0.0
2021-12-30,218,103,115,0,103,0,0,0.0
2021-12-31,221,125,96,0,125,0,0,0.0
2022-01-02,19,0,19,0,0,0,0,0.0
2022-01-03,269,153,116,0,153,0,0,0.0
2022-01-04,192,76,116,2,74,2,2,6.106484579117155
2022-01-05,137,20,117,2,18,2,1,-6.461031779525538
2022-01-06,137,20,117,2,18,2,1,-3.659969545869403
2022-01-07,158,62,96,1,61,1,0,-5.9669569088338354
2022-01-09,6,0,6,0,0,0,0,0.0
2022-01-10,235,128,107,1,127,1,1,2.131676965661521
2022-01-11,265,153,112,0,153,0,0,0.0
2022-01-12,161,53,108,1,52,1,1,4.690960197892854
2022-01-13,149,52,97,2,50,2,1,-5.314547810175129
2022-01-14,101,5,96,2,3,2,1,-2.144801458630975
2022-01-16,20,0,20,0,0,0,0,0.0
2022-01-17,217,110,107,0,110,0,0,0.0
2022-01-18,118,19,99,2,17,2,1,-0.8751977976360905
2022-01-19,261,146,115,0,146,0,0,0.0
2022-01-20,181,72,109,1,71,1,1,2.7908674562365587
2022-01-21,110,14,96,2,12,2,0,-11.841957249217273
2022-01-23,18,0,18,0,0,0,0,0.0
2022-01-24,146,32,114,2,30,2,2,7.503532930192015
2022-01-25,117,10,107,2,8,2,1,-1.4463884517280694
2022-01-26,216,115,101,1,114,1,0,-5.907277844352203
2022-01-27,114,3,111,2,1,2,0,-9.764026767202965
2022-01-28,107,13,94,2,11,2,2,6.659052350014955
2022-01-30,18,0,18,0,0,0,0,0.0
2022-01-31,129,17,112,2,15,2,0,-9.76481624867842
2022-02-01,152,36,116,2,34,2,2,6.254096457930726
2022-02-02,138,27,111,2,25,2,2,4.002675475223162
2022-02-03,136,48,88,2,46,2,1,-3.4585299866992836
2022-02-04,95,5,90,2,3,2,0,-9.526558864243007
2022-02-06,12,0,12,0,0,0,0,0.0
2022-02-07,191,112,79,1,111,1,1,1.407313363369099
2022-02-08,215,101,114,1,100,1,0,-5.561891857529606
2022-02-09,223,112,111,0,112,0,0,0.0
2022-02-10,124,9,115,2,7,2,1,-2.6113939450842665
2022-02-11,97,9,88,2,7,2,1,0.4842184726803316
2022-02-13,19,0,19,0,0,0,0,0.0
2022-02-14,72,2,70,2,0,2,0,-9.43854251419681
2022-02-15,180,73,107,1,72,1,0,-5.539046847538525
2022-02-16,136,28,108,1,27,1,1,3.2916491954317575
2022-02-17,110,6,104,2,4,2,1,-1.97024387194582
2022-02-18,165,69,96,1,68,1,0,-5.381355711788948
2022-02-20,18,0,18,0,0,0,0,0.0
2022-02-21,209,98,111,1,97,1,0,-3.707617643874209
2022-02-22,207,96,111,1,95,1,0,-3.7928254858843786
2022-02-23,233,135,98,0,135,0,0,0.0
2022-02-24,115,2,113,2,0,2,0,-9.499702337293943
2022-02-25,234,138,96,0,138,0,0,0.0
2022-02-27,1,0,1,0,0,0,0,0.0
2022-02-28,87,69,18,1,68,1,1,4.274590010191819
2022-03-01,166,57,109,1,56,1,1,3.1535411195495167
2022-03-02,122,12,110,2,10,2,0,-8.205164364682176
2022-03-03,155,42,113,1,41,1,1,4.120536461221088
2022-03-04,150,55,95,1,54,1,1,5.242349185302441
2022-03-06,2,0,2,0,0,0,0,0.0
2022-03-07,121,65,56,1,64,1,0,-5.132231131451324
2022-03-08,181,75,106,1,74,1,1,2.519993944845499
2022-03-09,156,42,114,1,41,1,0,-5.371586580283461
2022-03-10,161,52,109,1,51,1,0,-5.312960267565829
2022-03-11,225,129,96,1,128,1,1,3.997787974528337
2022-03-13,33,12,21,0,12,0,0,0.0
2022-03-14,189,74,115,1,73,1,1,3.745637734655215
2022-03-15,113,2,111,2,0,2,0,-8.428106177996064
2022-03-16,152,36,116,1,35,1,1,4.654260526922611
2022-03-17,105,20,85,2,18,2,1,-1.1978764711208054
2022-03-18,146,51,95,1,50,1,0,-5.816140454986402
2022-03-20,12,0,12,0,0,0,0,0.0
2022-03-21,108,77,31,1,76,1,1,2.9057816785736224
2022-03-22,124,13,111,2,11,2,1,0.9102011343861047
2022-03-23,99,2,97,2,0,2,0,-10.20629057320205
2022-03-24,101,6,95,2,4,2,1,0.9234178982217793
2022-03-25,106,10,96,2,8,2,1,-1.4047015733253128
2022-03-27,18,0,18,0,0,0,0,0.0
2022-03-28,115,4,111,2,2,2,1,2.7025344629346097
2022-03-29,133,18,115,2,16,2,0,-13.999161376878495
2022-03-30,107,2,105,2,0,2,0,-11.18595888299728
2022-03-31,106,2,104,2,0,2,0,-11.025547221112657
2022-04-01,107,11,96,2,9,2,1,2.185095540749117
2022-04-03,2,0,2,0,0,0,0,0.0
2022-04-04,97,53,44,1,52,1,0,-4.785468574083203
2022-04-05,110,2,108,2,0,2,1,3.102350553716325
2022-04-06,116,15,101,2,13,2,1,0.20338905829682297
2022-04-07,146,38,108,0,38,0,0,0.0
2022-04-08,118,33,85,1,32,1,1,5.2292812287515655
2022-04-10,16,0,16,0,0,0,0,0.0
2022-04-11,120,7,113,2,5,2,0,-11.037664701793599
2022-04-12,105,2,103,2,0,2,0,-11.257644598434304
2022-04-13,111,3,108,2,1,2,0,-9.89833328062064
2022-04-14,159,43,116,1,42,1,0,-6.137723896239402
2022-04-15,186,90,96,0,90,0,0,0.0
2022-04-17,29,10,19,0,10,0,0,0.0
2022-04-18,242,152,90,0,152,0,0,0.0
2022-04-19,110,6,104,2,4,2,1,2.714170179634954
2022-04-20,95,6,89,2,4,2,1,1.5416080796609224
2022-04-21,105,15,90,2,13,2,0,-10.321140754035525
2022-04-22,101,7,94,2,5,2,0,-12.328800776629029
2022-04-24,2,0,2,0,0,0,0,0.0
2022-04-25,111,27,84,2,25,2,2,18.818263097471238
2022-04-26,111,8,103,2,6,2,1,1.1748231516299468
2022-04-27,220,113,107,1,112,1,0,-4.650687655613468
2022-04-28,111,8,103,2,6,2,1,2.495973487944097
2022-04-29,104,8,96,2,6,2,1,3.1573432129095176
2022-05-01,3,0,3,0,0,0,0,0.0
2022-05-02,211,141,70,1,140,1,1,4.581634734783048
2022-05-03,226,129,97,1,128,1,1,3.4008735695456602
2022-05-04,144,87,57,2,85,2,1,-4.686278403035203
2022-05-05,179,105,74,1,104,1,0,-5.141061504387847
2022-05-06,142,46,96,2,44,2,1,-0.12078076779214442
2022-05-08,1,0,1,0,0,0,0,0.0
2022-05-09,104,2,102,2,0,2,0,-9.566210996759168
2022-05-10,188,115,73,1,114,1,1,6.942779992239828
2022-05-11,64,11,53,2,9,2,1,-3.311199532612328
2022-05-12,100,3,97,2,1,2,1,13.433660324386288
2022-05-13,191,101,90,1,100,1,0,-8.419147247007693
2022-05-15,23,11,12,0,11,0,0,0.0
2022-05-16,131,34,97,1,33,1,0,-8.200206158999498
2022-05-17,213,104,109,1,103,1,0,-6.107823784946602
2022-05-18,213,104,109,1,103,1,0,-5.661502782650341
2022-05-19,113,11,102,2,9,2,1,4.22273943413743
2022-05-20,147,69,78,1,68,1,1,4.37957068702984
2022-05-22,2,2,0,0,2,0,0,0.0
2022-05-23,178,85,93,1,84,1,0,-5.55681693310235
2022-05-24,113,10,103,2,8,2,1,6.482173433441616
2022-05-25,123,10,113,2,8,2,1,-5.675874125392756
2022-05-26,173,59,114,1,58,1,0,-5.824569060698926
2022-05-27,178,84,94,1,83,1,0,-7.062306669279676
2022-05-29,27,8,19,0,8,0,0,0.0
2022-05-30,241,128,113,1,127,1,1,2.2608444270857158
2022-05-31,168,51,117,1,50,1,0,-5.609181229064461
2022-06-01,213,104,109,1,103,1,0,-4.839858093463047
2022-06-02,250,143,107,1,142,1,1,2.674442169994431
2022-06-03,188,113,75,1,112,1,1,-0.6772742061505719
2022-06-05,23,12,11,0,12,0,0,0.0
2022-06-06,220,108,112,1,107,1,0,-4.258845018681458
2022-06-07,133,16,117,2,14,2,1,5.228850473115495
2022-06-08,117,2,115,2,0,2,0,-11.51061187340778
2022-06-09,105,7,98,2,5,2,1,1.6627477492453222
2022-06-10,98,2,96,2,0,2,1,4.060443176464659
2022-06-12,9,0,9,0,0,0,0,0.0
2022-06-13,105,2,103,2,0,2,0,-11.168973114189246
2022-06-14,128,15,113,2,13,2,1,7.102280230730434
2022-06-15,221,108,113,2,106,2,0,-14.736439979633408
2022-06-16,196,87,109,1,86,1,0,-6.881718549319999
2022-06-17,216,120,96,1,119,1,1,10.261867892398385
2022-06-19,20,12,8,0,12,0,0,0.0
2022-06-20,116,25,91,1,24,1,1,3.6478456584880323
2022-06-21,92,2,90,2,0,2,0,-11.53898547150761
2022-06-22,204,90,114,1,89,1,0,-5.495190203160496
2022-06-23,124,9,115,2,7,2,1,10.867418657757192
2022-06-24,122,26,96,2,24,2,2,18.793893504229406
2022-06-26,12,0,12,0,0,0,0,0.0
2022-06-27,203,93,110,1,92,1,1,2.1553533427314187
2022-06-28,132,21,111,1,20,1,0,-5.98346521797134
2022-06-29,105,2,103,2,0,2,0,-11.509160950263492
2022-06-30,82,6,76,2,4,2,1,6.438335785995268
2022-07-01,114,18,96,2,16,2,1,-0.5321870320922857
2022-07-03,18,0,18,0,0,0,0,0.0
2022-07-04,236,134,102,0,134,0,0,0.0
2022-07-05,127,10,117,2,8,2,0,-12.371988009644681
2022-07-06,118,5,113,2,3,2,0,-14.120417748315113
2022-07-07,212,101,111,1,100,1,0,-5.373180889624444
2022-07-08,92,2,90,2,0,2,0,-13.456374086795337
2022-07-10,21,0,21,0,0,0,0,0.0
2022-07-11,220,110,110,1,109,1,1,-0.6939764232794525
2022-07-12,198,89,109,1,88,1,1,6.545858943556328
2022-07-13,155,42,113,2,40,2,0,-14.215300584524906
2022-07-14,240,129,111,1,128,1,0,-6.678106352787198
2022-07-15,129,46,83,2,44,2,1,0.14793945276744314
2022-07-17,15,0,15,0,0,0,0,0.0
2022-07-18,237,122,115,1,121,1,1,0.09391516188744475
2022-07-19,209,101,108,1,100,1,0,-5.357966995031227
2022-07-20,229,114,115,1,113,1,1,-2.1164867809864276
2022-07-21,112,2,110,2,0,2,0,-11.226156086077733
2022-07-22,96,11,85,2,9,2,1,12.85558254160928
2022-07-24,20,0,20,0,0,0,0,0.0
2022-07-25,231,132,99,0,132,0,0,0.0
2022-07-26,229,123,106,1,122,1,1,0.39741929097977646
2022-07-27,181,78,103,2,76,2,2,13.575386311773453
2022-07-28,113,10,103,2,8,2,1,-2.9827189175933544
2022-07-29,78,6,72,2,4,2,1,3.634297347951218
2022-07-31,15,0,15,0,0,0,0,0.0
2022-08-01,132,18,114,2,16,2,1,1.2081084233063724
2022-08-02,118,12,106,2,10,2,0,-13.833577798142523
2022-08-03,214,139,75,1,138,1,1,9.829579545566506
2022-08-04,123,12,111,2,10,2,1,-3.5264767237940493
2022-08-05,145,52,93,2,50,2,1,10.277043078552762
2022-08-07,10,0,10,0,0,0,0,0.0
2022-08-08,167,108,59,1,107,1,1,4.0311727713463
2022-08-09,165,60,105,1,59,1,0,-8.354003266829366
2022-08-10,115,16,99,2,14,2,1,-17.6592791462937
2022-08-11,128,34,94,2,32,2,1,-5.877193569788555
2022-08-12,128,32,96,2,30,2,1,-6.948435675896141
2022-08-14,16,0,16,0,0,0,0,0.0
2022-08-15,215,102,113,1,101,1,0,-9.04468486998601
2022-08-16,208,101,107,1,100,1,0,-8.204264114806016
2022-08-17,172,68,104,1,67,1,0,-5.676360491627572
2022-08-18,202,101,101,1,100,1,0,-6.089874475475428
2022-08-19,133,37,96,1,36,1,0,-5.759419670162243
2022-08-21,11,0,11,0,0,0,0,0.0
2022-08-22,218,106,112,1,105,1,0,-7.314322367800978
2022-08-23,125,10,115,2,8,2,1,14.002931203925646
2022-08-24,135,20,115,1,19,1,0,-7.400479501218447
2022-08-25,188,74,114,1,73,1,0,-5.539196481510342
2022-08-26,143,47,96,2,45,2,1,-2.324784540176849
2022-08-28,14,0,14,0,0,0,0,0.0
2022-08-29,216,115,101,1,114,1,1,4.405026326545506
2022-08-30,213,103,110,1,102,1,0,-5.856614495091194
2022-08-31,214,107,107,1,106,1,0,-6.965660384091683
2022-09-01,208,99,109,1,98,1,0,-5.102113867885159
2022-09-02,224,132,92,1,131,1,0,-8.686238689593115
2022-09-04,30,12,18,0,12,0,0,0.0
2022-09-05,198,114,84,0,114,0,0,0.0
2022-09-06,212,101,111,1,100,1,0,-7.191134302133581
2022-09-07,244,127,117,1,126,1,1,6.618787964465012
2022-09-08,167,56,111,1,55,1,0,-6.536535856154277
2022-09-09,198,102,96,1,101,1,0,-6.471269925697584
2022-09-11,18,4,14,0,4,0,0,0.0
2022-09-12,191,97,94,1,96,1,0,-5.9096568138716865
2022-09-13,135,41,94,2,39,2,1,-7.901455858958368
2022-09-14,163,63,100,1,62,1,0,-6.362472960465129
2022-09-15,152,53,99,1,52,1,1,5.823146653526693
2022-09-16,185,94,91,1,93,1,0,-8.097574406596976
2022-09-18,29,11,18,0,11,0,0,0.0
2022-09-19,234,126,108,0,126,0,0,0.0
2022-09-20,168,58,110,1,57,1,0,-10.500194205004153
2022-09-21,249,122,127,1,121,1,1,5.752239691677236
2022-09-22,99,2,97,2,0,2,0,-32.685184356016435
2022-09-23,202,110,92,1,109,1,1,20.605306203647608
2022-09-25,20,12,8,0,12,0,0,0.0
2022-09-26,215,105,110,1,104,1,0,-7.443319264063217
2022-09-27,238,126,112,1,125,1,1,5.042643616194759
2022-09-28,215,105,110,1,104,1,0,-5.460750358100816
2022-09-29,186,87,99,0,87,0,0,0.0
2022-09-30,211,125,86,1,124,1,1,4.997593067156692
2022-10-02,27,11,16,0,11,0,0,0.0
2022-10-03,260,146,114,1,145,1,1,3.9322320417503183
2022-10-04,213,104,109,1,103,1,0,-5.4787865056844325
2022-10-05,162,83,79,1,82,1,0,-4.770638305414756
2022-10-06,219,154,65,0,154,0,0,0.0
2022-10-07,175,112,63,1,111,1,0,-8.153411895225396
2022-10-09,15,6,9,0,6,0,0,0.0
2022-10-10,130,37,93,1,36,1,0,-3.5178507028164936
2022-10-11,220,122,98,0,122,0,0,0.0
2022-10-12,241,126,115,1,125,1,1,4.725822203718039
2022-10-13,191,137,54,1,136,1,1,-0.640696609881946
2022-10-14,233,142,91,1,141,1,1,3.575865654132389
2022-10-16,25,12,13,0,12,0,0,0.0
2022-10-17,229,131,98,1,130,1,1,2.8132242779082683
2022-10-18,206,99,107,1,98,1,1,1.5132098330280832
2022-10-19,164,98,66,1,97,1,0,-5.090107241110087
2022-10-20,201,92,109,1,91,1,0,-7.89299026759258
2022-10-21,102,6,96,2,4,2,1,27.4434047973431
2022-10-23,14,0,14,0,0,0,0,0.0
2022-10-24,185,143,42,1,142,1,1,14.8468847469561
2022-10-25,129,49,80,1,48,1,1,22.185242993059607
2022-10-26,148,105,43,1,104,1,0,-8.449125438454903
2022-10-27,109,18,91,2,16,2,1,-1.1964039965259268
2022-10-28,111,34,77,1,33,1,0,-7.137909461077211
2022-10-30,10,6,4,0,6,0,0,0.0
2022-10-31,177,63,114,1,62,1,1,7.7318329184723105
2022-11-01,124,15,109,2,13,2,1,6.764842300051109
2022-11-02,149,33,116,2,31,2,2,37.26970432160269
2022-11-03,104,2,102,2,0,2,0,-14.530826961247802
2022-11-04,72,16,56,2,14,2,1,5.357036636563439
2022-11-06,0,0,0,0,0,0,0,0.0
2022-11-07,84,16,68,2,14,2,1,3.197005514674313
2022-11-08,133,22,111,2,20,2,1,1.2822302583470577
2022-11-09,112,3,109,2,1,2,0,-13.743537409181949
2022-11-10,135,19,116,2,17,2,2,24.19140101032062
2022-11-11,200,104,96,1,103,1,0,-8.6990888354464
2022-11-13,0,0,0,0,0,0,0,0.0
2022-11-14,36,2,34,2,0,2,0,-17.68242101730087
2022-11-15,115,6,109,2,4,2,1,13.512295336314487
2022-11-16,153,39,114,1,38,1,1,20.245683274919198
2022-11-17,118,9,109,2,7,2,1,-1.56942874345701
2022-11-18,117,21,96,2,19,2,0,-17.130209374607958
2022-11-20,19,0,19,0,0,0,0,0.0
2022-11-21,127,27,100,2,25,2,1,2.7958815814047835
2022-11-22,126,10,116,2,8,2,1,-0.812747600084121
2022-11-23,115,7,108,2,5,2,1,-4.189121173458504
2022-11-24,224,113,111,1,112,1,1,5.620466009544712
2022-11-25,191,98,93,1,97,1,0,-8.76448654467654
2022-11-27,10,0,10,0,0,0,0,0.0
2022-11-28,108,4,104,2,2,2,1,10.149356154772088
2022-11-29,123,12,111,2,10,2,1,2.848131238772856
2022-11-30,122,12,110,2,10,2,0,-11.273888746472334
2022-12-01,124,8,116,2,6,2,0,-17.011123709977205
2022-12-02,116,20,96,2,18,2,2,61.09603547868005
2022-12-04,2,0,2,0,0,0,0,0.0
2022-12-05,170,105,65,1,104,1,0,-8.43020849329931
2022-12-06,109,3,106,2,1,2,0,-16.946399699105562
2022-12-07,113,8,105,2,6,2,0,-17.78686122870453
2022-12-08,142,34,108,2,32,2,0,-17.81058806740184
2022-12-09,110,14,96,2,12,2,1,9.657062235807517
2022-12-11,17,0,17,0,0,0,0,0.0
2022-12-12,210,98,112,1,97,1,0,-9.55562243964472
2022-12-13,149,35,114,2,33,2,2,25.805779109056513
2022-12-14,186,79,107,2,77,2,2,26.73202519982387
2022-12-15,143,28,115,2,26,2,1,-1.9537198021128805
2022-12-16,118,22,96,2,20,2,0,-12.792828946169685
2022-12-18,15,0,15,0,0,0,0,0.0
2022-12-19,142,106,36,1,105,1,0,-7.804498430030449
2022-12-20,113,2,111,2,0,2,0,-19.421276657821007
2022-12-21,230,130,100,1,129,1,0,-8.625886704714906
2022-12-22,156,42,114,1,41,1,1,14.536075057648263
2022-12-23,124,28,96,1,27,1,0,-7.674717110492114
2022-12-25,11,0,11,0,0,0,0,0.0
2022-12-26,215,103,112,1,102,1,1,9.755270435380591
2022-12-27,187,94,93,1,93,1,0,-9.155948383764347
2022-12-28,153,36,117,2,34,2,2,14.362415360128459
2022-12-29,124,15,109,2,13,2,1,-0.3537648070334285
2022-12-30,120,24,96,2,22,2,0,-11.938071585029084
2023-01-01,8,0,8,0,0,0,0,0.0
2023-01-02,167,127,40,0,127,0,0,0.0
2023-01-03,121,7,114,2,5,2,0,-16.451056392783205
2023-01-04,127,16,111,2,14,2,1,9.660904401010262
2023-01-05,119,14,105,2,12,2,0,-13.342096629744345
2023-01-06,112,16,96,2,14,2,0,-16.124391213975766
2023-01-08,19,0,19,0,0,0,0,0.0
2023-01-09,228,126,102,1,125,1,1,8.65693540531059
2023-01-10,121,47,74,2,45,2,1,7.071731669343956
2023-01-11,217,113,104,1,112,1,1,6.943669816061725
2023-01-12,120,5,115,2,3,2,0,-18.186772368945086
2023-01-13,121,36,85,2,34,2,2,19.964684679601056
2023-01-15,20,0,20,0,0,0,0,0.0
2023-01-16,194,78,116,0,78,0,0,0.0
2023-01-17,119,2,117,2,0,2,0,-14.142599876592229
2023-01-18,142,28,114,2,26,2,1,6.876753616049038
2023-01-19,156,46,110,2,44,2,1,-1.2716343034316306
2023-01-20,131,35,96,2,33,2,2,21.310524586530093
2023-01-22,19,0,19,0,0,0,0,0.0
2023-01-23,149,40,109,2,38,2,1,2.8051218686663084
2023-01-24,135,26,109,2,24,2,2,18.49222198624873
2023-01-25,137,26,111,2,24,2,1,-1.1931721232440289
2023-01-26,123,11,112,2,9,2,0,-15.644790130091687
2023-01-27,108,12,96,2,10,2,1,0.7284165161987168
2023-01-29,8,0,8,0,0,0,0,0.0
2023-01-30,142,28,114,2,26,2,2,13.97067843329532
2023-01-31,125,10,115,2,8,2,2,14.303464163289574
2023-02-01,121,10,111,2,8,2,1,-1.849669954859043
2023-02-02,123,13,110,2,11,2,1,6.239708341972161
2023-02-03,129,39,90,2,37,2,2,10.077737139815678
2023-02-05,7,0,7,0,0,0,0,0.0
2023-02-06,49,7,42,2,5,2,1,3.000816920632067
2023-02-07,100,2,98,2,0,2,0,-12.842118088155015
2023-02-08,96,3,93,2,1,2,0,-12.178711909864466
2023-02-09,127,27,100,2,25,2,1,-1.434683664846792
2023-02-10,96,2,94,2,0,2,0,-18.8676281551225
2023-02-12,20,0,20,0,0,0,0,0.0
2023-02-13,107,3,104,2,1,2,0,-13.496676857753165
2023-02-14,119,8,111,2,6,2,0,-19.093199889605167
2023-02-15,130,22,108,2,20,2,1,3.256723037567988
2023-02-16,115,10,105,2,8,2,1,0.9869975108998101
2023-02-17,112,16,96,2,14,2,1,-3.8007488052613354
2023-02-19,19,0,19,0,0,0,0,0.0
2023-02-20,208,106,102,1,105,1,0,-4.5336227696082325
2023-02-21,133,26,107,2,24,2,0,-11.992473345598386
2023-02-22,111,9,102,2,7,2,1,-2.5471757750047574
2023-02-23,109,7,102,2,5,2,1,2.351288711373691
2023-02-24,93,9,84,2,7,2,1,-3.0517675461248874
2023-02-26,19,0,19,0,0,0,0,0.0
2023-02-27,215,109,106,1,108,1,0,-6.716209525247351
2023-02-28,125,27,98,2,25,2,1,3.14539098824676
2023-03-01,146,30,116,2,28,2,2,11.090820504805313
2023-03-02,126,24,102,2,22,2,1,1.5180724218901966
2023-03-03,69,12,57,2,10,2,1,-1.3019903668579795
2023-03-05,18,0,18,0,0,0,0,0.0
2023-03-06,119,8,111,2,6,2,0,-13.556268924542856
2023-03-07,119,11,108,2,9,2,1,0.029463791442491782
2023-03-08,136,29,107,2,27,2,1,0.15983156719057412
2023-03-09,143,32,111,2,30,2,2,21.1630003849366
2023-03-10,111,15,96,2,13,2,1,3.773904387250699
2023-03-12,21,0,21,0,0,0,0,0.0
2023-03-13,83,6,77,2,4,2,1,5.356810598370046
2023-03-14,117,2,115,2,0,2,0,-22.89233046758636
2023-03-15,124,17,107,2,15,2,1,0.776689273528504
2023-03-16,117,5,112,2,3,2,1,21.97470009212237
2023-03-17,109,13,96,2,11,2,1,9.650267263590477
2023-03-19,18,0,18,0,0,0,0,0.0
2023-03-20,142,59,83,1,58,1,0,-8.339110949134867
2023-03-21,108,12,96,2,10,2,1,-1.0053496624966343
2023-03-22,103,12,91,2,10,2,2,9.447360523996974
2023-03-23,113,2,111,2,0,2,0,-12.629197536911253
2023-03-24,138,43,95,1,42,1,0,-6.178145109834835
2023-03-26,4,0,4,0,0,0,0,0.0
2023-03-27,108,47,61,2,45,2,2,10.85607473355866
2023-03-28,117,4,113,2,2,2,1,4.124031232223469
2023-03-29,117,3,114,2,1,2,0,-12.081685422139962
2023-03-30,123,7,116,2,5,2,0,-13.248504332245084
2023-03-31,111,15,96,2,13,2,0,-13.07674810417544
2023-04-02,3,0,3,0,0,0,0,0.0
2023-04-03,211,109,102,1,108,1,0,-6.408780700461717
2023-04-04,118,13,105,2,11,2,1,0.21146130615265601
2023-04-05,108,11,97,2,9,2,1,1.6276840589149808
2023-04-06,102,3,99,2,1,2,1,-1.6173906865027226
2023-04-07,109,34,75,2,32,2,1,-7.066181551331536
2023-04-09,8,0,8,0,0,0,0,0.0
2023-04-10,204,104,100,1,103,1,0,-3.8821083929044846
2023-04-11,220,105,115,1,104,1,0,-5.441303362225236
2023-04-12,108,2,106,2,0,2,0,-15.618606593906451
2023-04-13,78,24,54,2,22,2,2,15.885197363158566
2023-04-14,97,2,95,2,0,2,0,-12.227931926443103
2023-04-16,21,0,21,0,0,0,0,0.0
2023-04-17,192,106,86,1,105,1,0,-4.462554469477518
2023-04-18,190,101,89,1,100,1,0,-5.674044980473585
2023-04-19,198,102,96,1,101,1,0,-5.75533686329263
2023-04-20,84,2,82,2,0,2,0,-9.855400186019438
2023-04-21,188,92,96,1,91,1,0,-5.679611879772737
2023-04-23,29,12,17,0,12,0,0,0.0
2023-04-24,216,124,92,1,123,1,1,4.435699017287726
2023-04-25,167,79,88,1,78,1,0,-4.174279040009174
2023-04-26,196,81,115,1,80,1,0,-4.5017950549804535
2023-04-27,103,7,96,2,5,2,0,-10.912493863816088
2023-04-28,170,82,88,1,81,1,0,-5.119548335580492
2023-04-30,23,12,11,0,12,0,0,0.0
2023-05-01,247,139,108,0,139,0,0,0.0
2023-05-02,261,155,106,0,155,0,0,0.0
2023-05-03,180,82,98,2,80,2,0,-15.967038099600968
2023-05-04,146,102,44,1,101,1,0,-4.600390465235403
2023-05-05,164,68,96,0,68,0,0,0.0
2023-05-07,18,0,18,0,0,0,0,0.0
2023-05-08,223,133,90,0,133,0,0,0.0
2023-05-09,198,99,99,0,99,0,0,0.0
2023-05-10,171,69,102,1,68,1,0,-6.416188363470291
2023-05-11,251,144,107,1,143,1,0,-6.816439556406993
2023-05-12,198,112,86,1,111,1,1,1.3503568490380782
2023-05-14,18,12,6,0,12,0,0,0.0
2023-05-15,189,84,105,1,83,1,1,1.7549781110952063
2023-05-16,252,139,113,1,138,1,1,6.515896953858239
2023-05-17,226,129,97,0,129,0,0,0.0
2023-05-18,205,121,84,0,121,0,0,0.0
2023-05-19,223,127,96,1,126,1,0,-6.4754534431144375
2023-05-21,33,12,21,0,12,0,0,0.0
2023-05-22,236,145,91,0,145,0,0,0.0
2023-05-23,148,45,103,1,44,1,1,4.080997144238814
2023-05-24,215,105,110,1,104,1,0,-6.191813630241156
2023-05-25,242,134,108,1,133,1,0,-5.868018303129342
2023-05-26,237,143,94,1,142,1,1,10.23800458643169
2023-05-28,14,12,2,0,12,0,0,0.0
2023-05-29,265,158,107,0,158,0,0,0.0
2023-05-30,167,72,95,1,71,1,0,-4.87169600186367
2023-05-31,160,68,92,2,66,2,0,-17.398738963526213
2023-06-01,245,139,106,1,138,1,1,9.813960932406218
2023-06-02,235,142,93,1,141,1,0,-7.659749263947338
2023-06-04,24,12,12,0,12,0,0,0.0
2023-06-05,204,112,92,1,111,1,0,-10.138690614075326
2023-06-06,160,86,74,0,86,0,0,0.0
2023-06-07,261,147,114,1,146,1,0,-8.66983354281458
2023-06-08,257,148,109,0,148,0,0,0.0
2023-06-09,220,124,96,0,124,0,0,0.0
2023-06-11,15,6,9,0,6,0,0,0.0
2023-06-12,248,161,87,0,161,0,0,0.0
2023-06-13,231,123,108,1,122,1,0,-8.298972626697454
2023-06-14,242,130,112,0,130,0,0,0.0
2023-06-15,245,132,113,1,131,1,1,11.09177011995301
2023-06-16,189,94,95,1,93,1,1,12.166692736765764
2023-06-18,24,12,12,0,12,0,0,0.0
2023-06-19,225,154,71,0,154,0,0,0.0
2023-06-20,223,115,108,1,114,1,1,4.069973518322323
2023-06-21,244,128,116,1,127,1,1,5.717113759192181
2023-06-22,222,138,84,1,137,1,1,4.413074039076021
2023-06-23,182,92,90,1,91,1,0,-7.745736334053777
2023-06-25,24,11,13,0,11,0,0,0.0
2023-06-26,215,106,109,1,105,1,0,-7.3322170951707655
2023-06-27,237,138,99,1,137,1,0,-8.625532822047656
2023-06-28,177,80,97,1,79,1,0,-5.063742203921917
2023-06-29,127,45,82,1,44,1,0,-6.869205826026846
2023-06-30,223,140,83,1,139,1,1,6.962203255970028
2023-07-02,24,12,12,0,12,0,0,0.0
2023-07-03,223,123,100,1,122,1,0,-8.6341606404466
2023-07-04,243,154,89,0,154,0,0,0.0
2023-07-05,219,109,110,1,108,1,0,-7.723470812663482
2023-07-06,166,52,114,1,51,1,0,-5.264411410429192
2023-07-07,188,94,94,1,93,1,0,-6.3217426020217395
2023-07-09,10,10,0,0,10,0,0,0.0
2023-07-10,230,130,100,1,129,1,1,1.2160548269232896
2023-07-11,186,75,111,1,74,1,0,-5.10668651539492
2023-07-12,144,30,114,2,28,2,1,0.3245478358352667
2023-07-13,217,111,106,1,110,1,0,-7.485990312413035
2023-07-14,213,118,95,1,117,1,1,8.22069948908915
2023-07-16,14,11,3,0,11,0,0,0.0
2023-07-17,240,135,105,1,134,1,0,-7.256701656759599
2023-07-18,111,2,109,2,0,2,0,-14.893830670039264
2023-07-19,219,111,108,1,110,1,0,-7.204407257563186
2023-07-20,251,142,109,1,141,1,0,-7.975414949895574
2023-07-21,186,93,93,1,92,1,0,-8.5167049376096
2023-07-23,23,12,11,0,12,0,0,0.0
2023-07-24,270,155,115,0,155,0,0,0.0
2023-07-25,209,121,88,0,121,0,0,0.0
2023-07-26,254,147,107,0,147,0,0,0.0
2023-07-27,242,148,94,1,147,1,1,13.369569953910638
2023-07-28,122,73,49,1,72,1,0,-9.329491718565162
2023-07-30,33,12,21,0,12,0,0,0.0
2023-07-31,235,129,106,0,129,0,0,0.0
2023-08-01,241,139,102,0,139,0,0,0.0
2023-08-02,243,141,102,1,140,1,1,10.869477054401244
2023-08-03,200,94,106,1,93,1,0,-7.2812453703990005
2023-08-04,211,120,91,1,119,1,0,-6.468187234082054
2023-08-06,26,12,14,0,12,0,0,0.0
2023-08-07,236,130,106,0,130,0,0,0.0
2023-08-08,217,104,113,1,103,1,0,-7.72597481282731
2023-08-09,260,153,107,0,153,0,0,0.0
2023-08-10,248,134,114,1,133,1,0,-7.261185258380201
2023-08-11,162,103,59,0,103,0,0,0.0
2023-08-13,25,11,14,0,11,0,0,0.0
2023-08-14,210,138,72,1,137,1,1,1.9224020540767204
2023-08-15,184,72,112,1,71,1,1,0.48180862351835785
2023-08-16,229,126,103,1,125,1,1,-0.21080445389575786
2023-08-17,258,142,116,0,142,0,0,0.0
2023-08-18,242,146,96,0,146,0,0,0.0
2023-08-20,30,12,18,0,12,0,0,0.0
2023-08-21,185,121,64,0,121,0,0,0.0
2023-08-22,247,135,112,1,134,1,0,-7.873366441785429
2023-08-23,247,138,109,1,137,1,1,6.436343264226619
2023-08-24,200,91,109,0,91,0,0,0.0
2023-08-25,219,124,95,1,123,1,1,0.3442475327905239
2023-08-27,32,12,20,0,12,0,0,0.0
2023-08-28,212,103,109,0,103,0,0,0.0
2023-08-29,157,64,93,2,62,2,2,26.641431812490268
2023-08-30,240,123,117,1,122,1,1,9.550879757115538
2023-08-31,219,119,100,1,118,1,0,-9.715771552738143
2023-09-01,98,25,73,2,23,2,1,-2.1037773870082273
2023-09-03,15,0,15,0,0,0,0,0.0
2023-09-04,207,124,83,0,124,0,0,0.0
2023-09-05,220,103,117,1,102,1,0,-9.12056148429464
2023-09-06,235,119,116,1,118,1,0,-9.807035997657142
2023-09-07,182,68,114,0,68,0,0,0.0
2023-09-08,216,120,96,1,119,1,0,-9.853488283600658
2023-09-10,21,12,9,0,12,0,0,0.0
2023-09-11,142,62,80,1,61,1,0,-5.426183974087797
2023-09-12,214,103,111,0,103,0,0,0.0
2023-09-13,149,44,105,2,42,2,1,0.4867953416133801
2023-09-14,212,111,101,1,110,1,0,-7.790703805520666
2023-09-15,119,46,73,1,45,1,0,-7.714729601139609
2023-09-17,33,12,21,0,12,0,0,0.0
2023-09-18,248,143,105,0,143,0,0,0.0
2023-09-19,248,140,108,0,140,0,0,0.0
2023-09-20,212,103,109,1,102,1,0,-5.446363956672358
2023-09-21,262,154,108,0,154,0,0,0.0
2023-09-22,222,126,96,0,126,0,0,0.0
2023-09-24,28,12,16,0,12,0,0,0.0
2023-09-25,219,156,63,0,156,0,0,0.0
2023-09-26,209,96,113,0,96,0,0,0.0
2023-09-27,230,155,75,0,155,0,0,0.0
2023-09-28,200,97,103,0,97,0,0,0.0
2023-09-29,187,91,96,1,90,1,0,-4.879069887953136
2023-10-01,29,12,17,0,12,0,0,0.0
2023-10-02,243,135,108,0,135,0,0,0.0
2023-10-03,180,59,121,1,58,1,1,26.77583933658967
2023-10-04,255,140,115,0,140,0,0,0.0
2023-10-05,265,152,113,0,152,0,0,0.0
2023-10-06,184,88,96,1,87,1,1,3.418843597658055
2023-10-08,18,12,6,0,12,0,0,0.0
2023-10-09,165,151,14,0,151,0,0,0.0
2023-10-10,246,143,103,0,143,0,0,0.0
2023-10-11,224,124,100,0,124,0,0,0.0
2023-10-12,228,136,92,1,135,1,1,6.613905969156899
2023-10-13,190,100,90,1,99,1,1,-1.2995888918643779
2023-10-15,25,11,14,0,11,0,0,0.0
2023-10-16,197,144,53,0,144,0,0,0.0
2023-10-17,112,50,62,1,49,1,0,-7.372831337786902
2023-10-18,260,152,108,0,152,0,0,0.0
2023-10-19,216,141,75,0,141,0,0,0.0
2023-10-20,245,149,96,0,149,0,0,0.0
2023-10-22,14,12,2,0,12,0,0,0.0
2023-10-23,233,149,84,0,149,0,0,0.0
2023-10-24,240,146,94,0,146,0,0,0.0
2023-10-25,220,150,70,0,150,0,0,0.0
2023-10-26,206,105,101,1,104,1,0,-6.5899402271225185
2023-10-27,239,147,92,1,146,1,1,6.440197768718027
2023-10-29,30,12,18,0,12,0,0,0.0
2023-10-30,231,155,76,0,155,0,0,0.0
2023-10-31,216,101,115,1,100,1,0,-6.18214741323445
2023-11-01,267,150,117,0,150,0,0,0.0
2023-11-02,260,149,111,1,148,1,1,5.70129856572492
2023-11-03,147,57,90,2,55,2,1,-2.2451888348240976
2023-11-05,16,0,16,0,0,0,0,0.0
2023-11-06,181,75,106,1,74,1,1,2.9249641845906504
2023-11-07,189,89,100,1,88,1,1,-1.2198122337796757
2023-11-08,253,151,102,0,151,0,0,0.0
2023-11-09,168,108,60,1,107,1,0,-7.183299188076607
2023-11-10,248,158,90,0,158,0,0,0.0
2023-11-12,20,0,20,0,0,0,0,0.0
2023-11-13,143,46,97,1,45,1,1,12.459158462732756
2023-11-14,124,45,79,1,44,1,1,13.081020329199156
2023-11-15,221,106,115,1,105,1,0,-7.6123391568114975
2023-11-16,162,80,82,1,79,1,1,6.94388918451744
2023-11-17,40,11,29,2,9,2,1,3.2402811627531065
2023-11-19,17,0,17,0,0,0,0,0.0
2023-11-20,150,46,104,1,45,1,0,-8.154924218147137
2023-11-21,218,102,116,1,101,1,0,-6.432566116154342
2023-11-22,218,110,108,1,109,1,1,6.706466626526729
2023-11-23,171,61,110,1,60,1,0,-5.376225591159509
2023-11-24,169,95,74,1,94,1,0,-5.005342951250322
2023-11-26,12,0,12,0,0,0,0,0.0
2023-11-27,175,69,106,1,68,1,0,-7.2776529318021135
2023-11-28,232,124,108,1,123,1,1,4.344716622212032
2023-11-29,246,129,117,1,128,1,1,5.215924177720141
2023-11-30,130,22,108,2,20,2,1,10.791861792109872
2023-12-01,117,21,96,2,19,2,2,16.70339302640476
2023-12-03,13,0,13,0,0,0,0,0.0
2023-12-04,148,49,99,2,47,2,1,-4.387738927834237
2023-12-05,110,27,83,2,25,2,1,-2.2058269039174583
2023-12-06,157,64,93,1,63,1,1,0.7341075379278124
2023-12-07,119,2,117,2,0,2,0,-14.628033600019982
2023-12-08,151,55,96,2,53,2,2,40.019204819574576
2023-12-10,6,0,6,0,0,0,0,0.0
2023-12-11,115,4,111,2,2,2,0,-15.031404531553086
2023-12-12,135,19,116,2,17,2,1,-7.141906507571901
2023-12-13,137,28,109,2,26,2,1,2.183409469662976
2023-12-14,155,40,115,1,39,1,0,-8.756168599667848
2023-12-15,120,27,93,2,25,2,1,-2.0914794450545404
2023-12-17,18,0,18,0,0,0,0,0.0
2023-12-18,209,100,109,1,99,1,0,-5.280369718567686
2023-12-19,121,6,115,2,4,2,1,4.7583943310113295
2023-12-20,222,116,106,1,115,1,1,3.8527472984593407
2023-12-21,114,19,95,2,17,2,1,4.356163062243274
2023-12-22,98,8,90,2,6,2,0,-11.943723667701796
2023-12-24,0,0,0,0,0,0,0,0.0
2023-12-25,91,0,91,0,0,0,0,0.0
2023-12-26,172,100,72,1,99,1,0,-9.080123854162508
2023-12-27,211,95,116,0,95,0,0,0.0
2023-12-28,217,111,106,1,110,1,0,-5.305638790515376
2023-12-29,217,135,82,1,134,1,1,2.323901717384877
2024-01-01,15,0,15,0,0,0,0,0.0
2024-01-02,146,36,110,2,34,2,2,14.966504847797918
2024-01-03,115,26,89,2,24,2,2,11.51000180193087
2024-01-04,120,10,110,2,8,2,0,-13.588418499152352
2024-01-05,100,4,96,2,2,2,0,-15.63568941255181
2024-01-07,15,0,15,0,0,0,0,0.0
2024-01-08,192,126,66,1,125,1,0,-6.46947134637248
2024-01-09,132,17,115,2,15,2,2,15.586303644098523
2024-01-10,122,20,102,2,18,2,1,1.4892847471331443
2024-01-11,118,4,114,2,2,2,1,-5.578966976825715
2024-01-12,100,4,96,2,2,2,1,1.0023263495728623
2024-01-14,16,0,16,0,0,0,0,0.0
2024-01-15,229,112,117,1,111,1,1,1.698265471022209
2024-01-16,122,7,115,2,5,2,0,-14.392587027136615
2024-01-17,114,17,97,2,15,2,2,11.419708688589136
2024-01-18,111,15,96,2,13,2,0,-14.128892264992231
2024-01-19,103,8,95,2,6,2,1,1.6198719755733926
2024-01-21,1,0,1,0,0,0,0,0.0
2024-01-22,90,21,69,2,19,2,1,-2.596705184272601
2024-01-23,102,12,90,2,10,2,1,0.004005334409244554
2024-01-24,113,6,107,2,4,2,1,1.3633947355689369
2024-01-25,135,27,108,2,25,2,1,-5.113885019891574
2024-01-26,77,7,70,2,5,2,0,-13.585734194842352
2024-01-28,15,0,15,0,0,0,0,0.0
2024-01-29,209,99,110,1,98,1,0,-5.361035593850557
2024-01-30,123,14,109,2,12,2,0,-12.530831605475662
2024-01-31,122,14,108,2,12,2,2,13.625627836728437
2024-02-01,150,50,100,1,49,1,1,12.413134762663507
2024-02-02,77,44,33,2,42,2,1,7.7642456335687875
2024-02-04,18,0,18,0,0,0,0,0.0
2024-02-05,108,22,86,2,20,2,1,-2.575533713033227
2024-02-06,123,10,113,2,8,2,0,-11.874897044048602
2024-02-07,126,21,105,2,19,2,1,-3.374575150188962
2024-02-08,118,9,109,2,7,2,0,-11.352173507141972
2024-02-09,95,5,90,2,3,2,1,2.5598169916360565
2024-02-11,13,0,13,0,0,0,0,0.0
2024-02-12,191,106,85,1,105,1,0,-4.664633841374126
2024-02-13,147,41,106,1,40,1,0,-7.224536340232979
2024-02-14,190,77,113,1,76,1,0,-6.212377639913452
2024-02-15,163,52,111,1,51,1,0,-6.6328389158476675
2024-02-16,237,141,96,0,141,0,0,0.0
2024-02-18,3,0,3,0,0,0,0,0.0
2024-02-19,211,103,108,0,103,0,0,0.0
2024-02-20,268,156,112,0,156,0,0,0.0
2024-02-21,259,158,101,0,158,0,0,0.0
2024-02-22,124,28,96,2,26,2,2,11.954003856149262
2024-02-23,185,112,73,0,112,0,0,0.0
2024-02-25,11,0,11,0,0,0,0,0.0
2024-02-26,182,158,24,0,158,0,0,0.0
2024-02-27,260,157,103,0,157,0,0,0.0
2024-02-28,191,85,106,0,85,0,0,0.0
2024-02-29,113,5,108,2,3,2,1,0.5889341207057956
2024-03-01,127,31,96,2,29,2,0,-12.542746428343955
2024-03-03,15,0,15,0,0,0,0,0.0
2024-03-04,204,102,102,0,102,0,0,0.0
2024-03-05,113,31,82,1,30,1,1,6.083258664920125
2024-03-06,116,7,109,2,5,2,1,1.5113525739054792
2024-03-07,117,3,114,2,1,2,0,-12.092698471813218
2024-03-08,105,17,88,2,15,2,1,2.132744513904969
2024-03-10,16,0,16,0,0,0,0,0.0
2024-03-11,178,106,72,1,105,1,1,5.9396643960826445
2024-03-12,103,2,101,2,0,2,0,-17.26024005041926
2024-03-13,206,108,98,1,107,1,1,5.828346723024616
2024-03-14,115,3,112,2,1,2,0,-15.415304955428596
2024-03-15,187,94,93,1,93,1,0,-5.623756761300473
2024-03-17,13,12,1,0,12,0,0,0.0
2024-03-18,212,114,98,0,114,0,0,0.0
2024-03-19,217,104,113,1,103,1,0,-6.429695654200735
2024-03-20,227,111,116,1,110,1,1,8.350496163436196
2024-03-21,216,103,113,1,102,1,0,-4.91923561672467
2024-03-22,98,2,96,2,0,2,0,-11.07997098748146
2024-03-24,15,0,15,0,0,0,0,0.0
2024-03-25,241,137,104,0,137,0,0,0.0
2024-03-26,222,124,98,0,124,0,0,0.0
2024-03-27,186,84,102,1,83,1,0,-6.1293447232199405
2024-03-28,179,112,67,0,112,0,0,0.0
2024-03-29,202,109,93,0,109,0,0,0.0
2024-03-31,29,12,17,0,12,0,0,0.0
2024-04-01,250,154,96,0,154,0,0,0.0
2024-04-02,225,126,99,0,126,0,0,0.0
2024-04-03,235,153,82,0,153,0,0,0.0
2024-04-04,206,111,95,0,111,0,0,0.0
2024-04-05,95,18,77,2,16,2,1,0.9892004685725588
2024-04-07,0,0,0,0,0,0,0,0.0
2024-04-08,210,110,100,0,110,0,0,0.0
2024-04-09,246,149,97,0,149,0,0,0.0
2024-04-10,111,45,66,2,43,2,0,-14.095585833284872
2024-04-11,221,139,82,0,139,0,0,0.0
2024-04-12,118,48,70,2,46,2,1,-2.7914233274423914
2024-04-14,20,0,20,0,0,0,0,0.0
2024-04-15,134,36,98,0,36,0,0,0.0
2024-04-16,158,60,98,1,59,1,1,12.13431546705048
2024-04-17,225,129,96,0,129,0,0,0.0
2024-04-18,267,153,114,1,152,1,1,0.9824546954009947
2024-04-19,126,35,91,1,34,1,0,-6.985939838672478
2024-04-21,7,7,0,0,7,0,0,0.0
2024-04-22,213,153,60,0,153,0,0,0.0
2024-04-23,212,116,96,0,116,0,0,0.0
2024-04-24,234,137,97,1,136,1,0,-6.570442526209164
2024-04-25,148,47,101,1,46,1,0,-6.554236435358069
2024-04-26,119,35,84,2,33,2,1,3.9103164130828088
2024-04-28,1,0,1,0,0,0,0,0.0
2024-04-29,163,74,89,2,72,2,1,-7.332059415789404
2024-04-30,202,106,96,1,105,1,1,6.0599019964943475
2024-05-01,135,35,100,1,34,1,1,5.713418368536116
2024-05-02,209,101,108,1,100,1,0,-6.144849718178225
2024-05-03,241,145,96,0,145,0,0,0.0
2024-05-05,32,12,20,0,12,0,0,0.0
2024-05-06,269,155,114,0,155,0,0,0.0
2024-05-07,122,9,113,2,7,2,0,-11.053018087156921
2024-05-08,229,114,115,0,114,0,0,0.0
2024-05-09,154,57,97,1,56,1,1,6.180039718647892
2024-05-10,173,78,95,0,78,0,0,0.0
2024-05-12,21,1,20,0,1,0,0,0.0
2024-05-13,227,115,112,0,115,0,0,0.0
2024-05-14,136,30,106,1,29,1,0,-5.735621276032181
2024-05-15,112,13,99,2,11,2,1,-1.872057544439265
2024-05-16,161,50,111,2,48,2,1,-1.959477641744848
2024-05-17,136,40,96,1,39,1,1,6.756697861166462
2024-05-19,21,0,21,0,0,0,0,0.0
2024-05-20,227,115,112,0,115,0,0,0.0
2024-05-21,116,2,114,2,0,2,0,-12.435985027983556
2024-05-22,264,158,106,0,158,0,0,0.0
2024-05-23,136,58,78,1,57,1,1,6.351266259361553
2024-05-24,241,146,95,0,146,0,0,0.0
2024-05-26,14,12,2,0,12,0,0,0.0
2024-05-27,230,144,86,0,144,0,0,0.0
2024-05-28,268,158,110,0,158,0,0,0.0
2024-05-29,246,150,96,0,150,0,0,0.0
2024-05-30,108,2,106,2,0,2,0,-13.38408306662471
2024-05-31,87,10,77,2,8,2,2,11.710419934968414
2024-06-02,6,0,6,0,0,0,0,0.0
2024-06-03,131,59,72,1,58,1,1,5.955499567677904
2024-06-04,108,2,106,2,0,2,0,-12.084360448316328
2024-06-05,114,2,112,2,0,2,0,-9.368197155527191
2024-06-06,125,18,107,2,16,2,1,-4.006332878900336
2024-06-07,125,29,96,2,27,2,0,-17.429186698631668
2024-06-09,14,0,14,0,0,0,0,0.0
2024-06-10,202,96,106,0,96,0,0,0.0
2024-06-11,227,113,114,1,112,1,1,2.1546640774175594
2024-06-12,164,49,115,2,47,2,1,-0.92082893248989
2024-06-13,166,54,112,1,53,1,0,-6.71833279642723
2024-06-14,98,2,96,2,0,2,0,-14.399140947849943
2024-06-16,19,0,19,0,0,0,0,0.0
2024-06-17,180,129,51,0,129,0,0,0.0
2024-06-18,134,46,88,2,44,2,1,-2.710238003662678
2024-06-19,215,143,72,0,143,0,0,0.0
2024-06-20,211,105,106,1,104,1,0,-5.2185695023218495
2024-06-21,222,140,82,0,140,0,0,0.0
2024-06-23,29,12,17,0,12,0,0,0.0
2024-06-24,185,120,65,1,119,1,1,11.042301647441851
2024-06-25,240,131,109,0,131,0,0,0.0
2024-06-26,138,31,107,2,29,2,2,15.586312748108462
2024-06-27,250,145,105,1,144,1,1,-0.4921067315315302
2024-06-28,97,2,95,2,0,2,0,-12.634546187000925
2024-06-30,7,0,7,0,0,0,0,0.0
2024-07-01,145,64,81,1,63,1,1,8.845010633805892
2024-07-02,172,60,112,1,59,1,0,-6.50570401661404
2024-07-03,121,15,106,2,13,2,1,6.284864431152319
2024-07-04,220,117,103,1,116,1,1,0.3187910241173899
2024-07-05,98,2,96,2,0,2,0,-14.338549152173755
2024-07-07,7,0,7,0,0,0,0,0.0
2024-07-08,252,147,105,1,146,1,1,-0.49672489251329566
2024-07-09,184,69,115,2,67,2,2,8.322385942707317
2024-07-10,246,144,102,0,144,0,0,0.0
2024-07-11,144,46,98,2,44,2,1,-26.160545693807613
2024-07-12,52,12,40,2,10,2,0,-22.476914335020666
2024-07-14,16,0,16,0,0,0,0,0.0
2024-07-15,156,99,57,1,98,1,0,-5.181341756338164
2024-07-16,157,57,100,1,56,1,1,10.623797680307451
2024-07-17,107,2,105,2,0,2,0,-19.250360995482136
2024-07-18,146,56,90,2,54,2,0,-14.936765437065691
2024-07-19,192,97,95,1,96,1,0,-7.39833025750526
2024-07-21,30,12,18,0,12,0,0,0.0
2024-07-22,188,104,84,1,103,1,0,-5.854665606847765
2024-07-23,201,90,111,1,89,1,0,-6.619387604276943
2024-07-24,121,19,102,2,17,2,0,-15.809336808310425
2024-07-25,146,32,114,1,31,1,0,-6.850068967559482
2024-07-26,154,58,96,1,57,1,0,-11.18312301012705
2024-07-28,16,0,16,0,0,0,0,0.0
2024-07-29,214,105,109,0,105,0,0,0.0
2024-07-30,216,109,107,0,109,0,0,0.0
2024-07-31,115,8,107,1,7,1,0,-10.35637369121119
2024-08-01,143,41,102,1,40,1,0,-8.439736430560638
2024-08-02,113,37,76,1,36,1,0,-19.772044020626822
2024-08-04,9,0,9,0,0,0,0,0.0
2024-08-05,128,15,113,2,13,2,1,21.02695108545751
2024-08-06,204,105,99,0,105,0,0,0.0
2024-08-07,224,118,106,1,117,1,1,14.758499507586356
2024-08-08,146,58,88,1,57,1,1,9.75162814151772
2024-08-09,146,57,89,1,56,1,0,-10.099582881122313
2024-08-11,28,8,20,0,8,0,0,0.0
2024-08-12,211,129,82,1,128,1,1,-6.489075678172517
2024-08-13,215,99,116,1,98,1,1,5.919653612815754
2024-08-14,122,10,112,2,8,2,2,21.451949985718535
2024-08-15,94,3,91,2,1,2,1,-12.685719288567633
2024-08-16,148,59,89,1,58,1,0,-9.712254316641161
2024-08-18,33,12,21,0,12,0,0,0.0
2024-08-19,160,54,106,1,53,1,0,-9.864943679522266
2024-08-20,218,106,112,1,105,1,0,-10.932298933514396
2024-08-21,206,101,105,1,100,1,1,9.731417698521312
2024-08-22,204,98,106,1,97,1,0,-7.981580931792134
2024-08-23,122,27,95,2,25,2,2,27.932447039667586
2024-08-25,18,0,18,0,0,0,0,0.0
2024-08-26,242,134,108,1,133,1,1,0.7536858883132789
2024-08-27,202,98,104,1,97,1,0,-9.80868701681175
2024-08-28,196,89,107,1,88,1,0,-7.9137418770375385
2024-08-29,101,6,95,2,4,2,0,-18.34098598424635
2024-08-30,213,136,77,1,135,1,1,2.9385532116235886
2024-09-01,31,11,20,0,11,0,0,0.0
2024-09-02,211,141,70,0,141,0,0,0.0
2024-09-03,124,8,116,2,6,2,1,11.904886366969823
2024-09-04,205,111,94,1,110,1,0,-8.867449773486605
2024-09-05,103,2,101,2,0,2,0,-15.588265392788104
2024-09-06,139,43,96,2,41,2,1,-10.761708190736542
2024-09-08,10,0,10,0,0,0,0,0.0
2024-09-09,224,114,110,1,113,1,1,4.076916875764099
2024-09-10,209,106,103,1,105,1,0,-7.909546981034
2024-09-11,170,55,115,1,54,1,0,-8.048727901851839
2024-09-12,131,23,108,2,21,2,1,-4.290488382903183
2024-09-13,176,80,96,0,80,0,0,0.0
2024-09-15,25,10,15,0,10,0,0,0.0
2024-09-16,219,107,112,1,106,1,0,-7.184909147050007
2024-09-17,149,42,107,2,40,2,1,12.188428977544467
2024-09-18,182,67,115,2,65,2,2,46.79759327448347
2024-09-19,119,2,117,2,0,2,0,-15.494430943187425
2024-09-20,196,100,96,1,99,1,0,-8.02768315261772
2024-09-22,21,11,10,0,11,0,0,0.0
2024-09-23,226,122,104,1,121,1,1,6.994823529611082
2024-09-24,215,112,103,1,111,1,0,-5.796764098538224
2024-09-25,231,128,103,1,127,1,1,5.316933116123051
2024-09-26,120,4,116,2,2,2,0,-15.421017290230395
2024-09-27,186,90,96,1,89,1,0,-7.7620059865185524
2024-09-29,28,9,19,0,9,0,0,0.0
2024-09-30,224,146,78,1,145,1,1,8.45279705409334
2024-10-01,263,152,111,1,151,1,0,-7.14117790452198
2024-10-02,161,46,115,2,44,2,1,1.630770821312428
2024-10-03,202,89,113,1,88,1,1,7.922989855898816
2024-10-04,104,10,94,2,8,2,1,-12.40216379317278
2024-10-06,0,0,0,0,0,0,0,0.0
2024-10-07,138,23,115,1,22,1,0,-8.609388064630247
2024-10-08,221,115,106,1,114,1,1,2.820339694227062
2024-10-09,203,115,88,1,114,1,1,1.9980249624159692
2024-10-10,82,2,80,2,0,2,0,-20.326567495410792
2024-10-11,175,83,92,1,82,1,0,-8.112930280778267
2024-10-13,26,9,17,0,9,0,0,0.0
2024-10-14,150,86,64,1,85,1,1,-4.376877316934044
2024-10-15,186,76,110,1,75,1,0,-6.621600175781499
2024-10-16,244,136,108,1,135,1,1,2.81701331120446
2024-10-17,240,132,108,1,131,1,1,-5.467554646391962
2024-10-18,194,98,96,1,97,1,1,1.9065920402212648
2024-10-20,27,12,15,0,12,0,0,0.0
2024-10-21,209,101,108,1,100,1,0,-5.588458422250459
2024-10-22,114,11,103,2,9,2,0,-12.169270845099181
2024-10-23,189,86,103,1,85,1,0,-5.395405099293018
2024-10-24,212,103,109,1,102,1,0,-6.977849249920825
2024-10-25,157,67,90,1,66,1,0,-4.77975029696828
2024-10-27,27,12,15,0,12,0,0,0.0
2024-10-28,207,102,105,1,101,1,0,-6.605230965409726
2024-10-29,127,11,116,2,9,2,1,4.916799032154214
2024-10-30,200,90,110,1,89,1,1,6.353950460498119
2024-10-31,230,115,115,1,114,1,1,7.7463573135351025
2024-11-01,221,125,96,1,124,1,0,-6.604894772739071
2024-11-03,6,0,6,0,0,0,0,0.0
2024-11-04,237,127,110,1,126,1,1,3.9012058362492787
2024-11-05,221,109,112,1,108,1,1,5.245510527930228
2024-11-06,198,90,108,1,89,1,0,-7.341029569949465
2024-11-07,215,109,106,1,108,1,0,-6.974260798007928
2024-11-08,190,102,88,1,101,1,1,7.973954303979303
2024-11-10,20,0,20,0,0,0,0,0.0
2024-11-11,164,50,114,1,49,1,0,-6.670221214926245
2024-11-12,214,104,110,1,103,1,0,-5.275054910958174
2024-11-13,203,101,102,1,100,1,0,-6.2210107255995215
2024-11-14,188,73,115,1,72,1,0,-6.180622878139285
2024-11-15,197,101,96,1,100,1,1,7.842371852884715
2024-11-17,16,0,16,0,0,0,0,0.0
2024-11-18,248,146,102,0,146,0,0,0.0
2024-11-19,229,121,108,1,120,1,1,25.312156353789007
2024-11-20,249,141,108,1,140,1,1,2.9225377802346397
2024-11-21,127,19,108,2,17,2,1,4.367221931974409
2024-11-22,197,119,78,1,118,1,1,10.66686305433984
2024-11-24,4,0,4,0,0,0,0,0.0
2024-11-25,149,65,84,1,64,1,0,-6.954905763754583
2024-11-26,187,82,105,1,81,1,0,-7.14428571405678
2024-11-27,222,107,115,1,106,1,0,-7.819176378709878
2024-11-28,224,112,112,1,111,1,0,-6.479847427608121
2024-11-29,108,12,96,2,10,2,0,-11.859491922857577
2024-12-01,19,0,19,0,0,0,0,0.0
2024-12-02,234,123,111,1,122,1,0,-6.584835364724408
2024-12-03,171,57,114,1,56,1,1,20.00118586909466
2024-12-04,146,33,113,2,31,2,1,-0.4651599245087956
2024-12-05,238,123,115,1,122,1,1,4.8624950723093665
2024-12-06,123,35,88,2,33,2,2,26.24253205411258
2024-12-08,0,0,0,0,0,0,0,0.0
2024-12-09,170,111,59,1,110,1,0,-4.323713115833431
2024-12-10,218,105,113,1,104,1,0,-6.590950081869602
2024-12-11,114,10,104,2,8,2,2,25.11783017567049
2024-12-12,117,33,84,2,31,2,2,13.021133604139047
2024-12-13,228,132,96,1,131,1,1,0.26830799922993176
2024-12-15,15,0,15,0,0,0,0,0.0
2024-12-16,188,95,93,1,94,1,0,-8.649036115182565
2024-12-17,107,9,98,2,7,2,2,12.213794075717084
2024-12-18,154,69,85,2,67,2,1,-8.69833584811931
2024-12-19,121,8,113,2,6,2,1,9.515153680217528
2024-12-20,114,19,95,2,17,2,1,2.922511041443279
2024-12-22,14,0,14,0,0,0,0,0.0
2024-12-23,177,73,104,1,72,1,0,-9.315598204396494
2024-12-24,194,105,89,1,104,1,1,3.6214870416406586
2024-12-25,119,0,119,0,0,0,0,0.0
2024-12-26,217,108,109,1,107,1,0,-3.296888802285044
2024-12-27,121,25,96,2,23,2,2,4.8888718031177
2024-12-29,15,0,15,0,0,0,0,0.0
2024-12-30,142,29,113,2,27,2,1,1.9034758021746034
2024-12-31,104,8,96,2,6,2,1,-1.8443617818579137
