date,breakouts,gate_pass,gate_block,ev_pass,ev_reject,fills,wins,pnl_pips
2018-01-01,10,0,10,0,0,0,0,0.0
2018-01-02,132,30,102,7,18,12,11,21.011428571427132
2018-01-03,84,27,57,2,25,2,1,1.3028571428582723
2018-01-04,116,3,113,2,1,2,0,-6.79142857142898
2018-01-05,151,55,96,1,54,1,1,4.454285714285334
2018-01-07,12,0,12,0,0,0,0,0.0
2018-01-08,150,62,88,1,61,1,1,2.517142857142119
2018-01-09,163,55,108,1,54,1,1,2.3199999999998226
2018-01-10,107,2,105,2,0,2,0,-5.454285714287209
2018-01-11,106,2,104,2,0,2,0,-6.522857142858584
2018-01-12,83,26,57,2,24,2,2,10.528571428570444
2018-01-14,17,0,17,0,0,0,0,0.0
2018-01-15,112,5,107,2,3,2,0,-5.394285714286639
2018-01-16,143,26,117,2,24,2,0,-6.379999999999541
2018-01-17,135,30,105,2,28,2,2,4.0346921487971485
2018-01-18,87,2,85,2,0,2,0,-7.385714285714528
2018-01-19,111,22,89,1,21,1,0,-3.3771428571431557
2018-01-21,12,0,12,0,0,0,0,0.0
2018-01-22,217,104,113,1,103,1,0,-2.605714285714555
2018-01-23,204,101,103,1,100,1,0,-2.5885714285711288
2018-01-24,202,95,107,1,94,1,0,-3.922857142857083
2018-01-25,181,70,111,2,68,2,1,5.28571428571405
2018-01-26,112,32,80,2,30,2,1,3.55999999999932
2018-01-28,13,0,13,0,0,0,0,0.0
2018-01-29,200,103,97,1,102,1,0,-4.39714285714291
2018-01-30,180,82,98,1,81,1,1,7.265714285713443
2018-01-31,147,50,97,1,49,1,0,-3.7942857142856496
2018-02-01,186,73,113,1,72,1,1,7.034285714285716
2018-02-02,149,55,94,1,54,1,1,8.800000000000352
2018-02-04,20,0,20,0,0,0,0,0.0
2018-02-05,115,3,112,2,1,2,0,-7.082857142857279
2018-02-06,119,6,113,2,4,2,1,2.691428571428901
2018-02-07,178,74,104,1,73,1,1,6.648571428571415
2018-02-08,75,4,71,2,2,2,1,2.431428571427375
2018-02-09,96,2,94,2,0,2,0,-6.8942857142852745
2018-02-11,15,0,15,0,0,0,0,0.0
2018-02-12,204,91,113,1,90,1,1,5.0628571428570694
2018-02-13,189,81,108,1,80,1,0,-5.879999999999541
2018-02-14,112,6,106,2,4,2,0,-6.69201975664555
2018-02-15,208,97,111,1,96,1,0,-3.5885714285716404
2018-02-16,211,118,93,0,118,0,0,0.0
2018-02-18,20,0,20,0,0,0,0,0.0
2018-02-19,245,139,106,0,139,0,0,0.0
2018-02-20,249,138,111,0,138,0,0,0.0
2018-02-21,237,128,109,1,127,1,1,11.66285714285732
2018-02-22,263,147,116,0,147,0,0,0.0
2018-02-23,239,143,96,0,143,0,0,0.0
2018-02-25,6,0,6,0,0,0,0,0.0
2018-02-26,235,122,113,0,122,0,0,0.0
2018-02-27,151,41,110,1,40,1,1,6.837142857143419
2018-02-28,169,64,105,1,63,1,1,5.56857142857109
2018-03-01,183,72,111,1,71,1,1,6.931428571428
2018-03-02,106,13,93,2,11,2,0,-9.585714285713664
2018-03-04,6,0,6,0,0,0,0,0.0
2018-03-05,102,72,30,1,71,1,1,3.34857142857129
2018-03-06,168,55,113,1,54,1,0,-4.605714285714157
2018-03-07,148,37,111,1,36,1,1,0.359745388804356
2018-03-08,183,75,108,1,74,1,0,-4.197142857143376
2018-03-09,156,54,102,1,53,1,1,5.500000000000227
2018-03-11,18,0,18,0,0,0,0,0.0
2018-03-12,161,47,114,1,46,1,0,0.03561670775508219
2018-03-13,167,57,110,1,56,1,0,-5.448571428572279
2018-03-14,141,48,93,1,47,1,0,-3.099999999999625
2018-03-15,176,71,105,1,70,1,1,5.011428571428212
2018-03-16,163,67,96,1,66,1,1,4.300000000000182
2018-03-18,15,0,15,0,0,0,0,0.0
2018-03-19,169,57,112,1,56,1,0,-2.5057142857140775
2018-03-20,171,64,107,1,63,1,0,-4.065714285714705
2018-03-21,213,102,111,1,101,1,1,11.174285714285304
2018-03-22,164,47,117,1,46,1,0,-4.580000000000439
2018-03-23,152,56,96,1,55,1,0,-4.454285714286243
2018-03-25,15,0,15,0,0,0,0,0.0
2018-03-26,150,47,103,1,46,1,1,4.248571428571324
2018-03-27,192,83,109,1,82,1,0,-3.688571428572118
2018-03-28,187,83,104,1,82,1,1,5.637142857143374
2018-03-29,188,83,105,1,82,1,1,4.102857142856465
2018-03-30,165,70,95,0,70,0,0,0.0
2018-04-01,8,6,2,0,6,0,0,0.0
2018-04-02,90,61,29,1,60,1,0,-3.571428571428214
2018-04-03,181,67,114,1,66,1,1,3.4857142857144368
2018-04-04,151,56,95,1,55,1,1,2.9114285714281323
2018-04-05,201,87,114,1,86,1,1,2.071428571428669
2018-04-06,128,33,95,1,32,1,0,-4.119999999999379
2018-04-08,8,0,8,0,0,0,0,0.0
2018-04-09,115,53,62,1,52,1,1,3.5714285714287257
2018-04-10,181,71,110,1,70,1,1,4.042857142857315
2018-04-11,175,60,115,1,59,1,1,4.557142857143049
2018-04-12,202,87,115,1,86,1,0,-2.2114285714285415
2018-04-13,188,92,96,1,91,1,1,2.1142857142858134
2018-04-15,6,0,6,0,0,0,0,0.0
2018-04-16,143,33,110,1,32,1,0,-2.111428571428064
2018-04-17,195,82,113,1,81,1,1,1.5399999999995089
2018-04-18,261,145,116,0,145,0,0,0.0
2018-04-19,230,125,105,0,125,0,0,0.0
2018-04-20,190,95,95,1,94,1,1,3.2628571428570012
2018-04-22,10,0,10,0,0,0,0,0.0
2018-04-23,159,57,102,1,56,1,0,-2.0314285714282505
2018-04-24,140,40,100,1,39,1,1,5.208571428571929
2018-04-25,153,60,93,1,59,1,1,0.10438751324056739
2018-04-26,152,46,106,1,45,1,0,-4.0799999999994725
2018-04-27,107,12,95,1,11,1,0,-2.88857142857114
2018-04-29,20,0,20,0,0,0,0,0.0
2018-04-30,196,106,90,0,106,0,0,0.0
2018-05-01,185,71,114,1,70,1,1,4.582857142856767
2018-05-02,175,63,112,1,62,1,1,2.980000000000416
2018-05-03,170,55,115,1,54,1,0,-3.7114285714285984
2018-05-04,137,41,96,1,40,1,0,-4.29999999999967
2018-05-06,14,0,14,0,0,0,0,0.0
2018-05-07,166,59,107,1,58,1,0,-3.7314285714292623
2018-05-08,144,43,101,1,42,1,0,-3.9485714285722224
2018-05-09,189,83,106,1,82,1,0,-3.0771428571431443
2018-05-10,168,56,112,1,55,1,0,-4.045714285714041
2018-05-11,184,89,95,1,88,1,0,-2.1285714285714903
2018-05-13,1,0,1,0,0,0,0,0.0
2018-05-14,196,122,74,0,122,0,0,0.0
2018-05-15,255,140,115,0,140,0,0,0.0
2018-05-16,253,146,107,0,146,0,0,0.0
2018-05-17,201,99,102,0,99,0,0,0.0
2018-05-18,237,141,96,0,141,0,0,0.0
2018-05-20,16,12,4,0,12,0,0,0.0
2018-05-21,200,85,115,1,84,1,1,2.439999999999543
2018-05-22,205,105,100,0,105,0,0,0.0
2018-05-23,173,74,99,1,73,1,1,4.068571428571033
2018-05-24,177,60,117,1,59,1,1,8.191428571428617
2018-05-25,152,56,96,1,55,1,0,-4.71142857142911
2018-05-27,8,0,8,0,0,0,0,0.0
2018-05-28,163,57,106,1,56,1,0,-2.205714285714066
2018-05-29,167,50,117,1,49,1,0,-3.011428571428098
2018-05-30,164,53,111,1,52,1,0,-4.214285714285381
2018-05-31,190,78,112,1,77,1,0,-5.837142857142396
2018-06-01,173,78,95,1,77,1,1,4.47142857142876
2018-06-03,4,0,4,0,0,0,0,0.0
2018-06-04,167,51,116,1,50,1,1,3.5714285714287257
2018-06-05,190,76,114,1,75,1,1,4.3257142857139
2018-06-06,261,154,107,0,154,0,0,0.0
2018-06-07,197,86,111,1,85,1,1,3.7171428571421643
2018-06-08,154,61,93,1,60,1,1,3.34857142857129
2018-06-10,6,0,6,0,0,0,0,0.0
2018-06-11,147,46,101,1,45,1,0,-3.1885714285711515
2018-06-12,195,78,117,1,77,1,1,1.6085714285717927
2018-06-13,211,112,99,1,111,1,1,6.2285714285716836
2018-06-14,113,39,74,1,38,1,0,-2.908571428571804
2018-06-15,139,44,95,1,43,1,0,-4.005714285714134
2018-06-17,11,0,11,0,0,0,0,0.0
2018-06-18,172,62,110,1,61,1,0,-2.602857142855896
2018-06-19,182,74,108,1,73,1,0,-4.020000000000323
2018-06-20,263,147,116,0,147,0,0,0.0
2018-06-21,203,98,105,1,97,1,1,2.268571428570965
2018-06-22,205,110,95,0,110,0,0,0.0
2018-06-24,13,4,9,1,3,1,1,3.4771428571427236
2018-06-25,147,32,115,1,31,1,0,-1.9657142857146255
2018-06-26,184,77,107,1,76,1,1,2.8600000000006958
2018-06-27,154,52,102,1,51,1,0,-3.1885714285711515
2018-06-28,188,83,105,1,82,1,1,4.128571428571604
2018-06-29,163,68,95,1,67,1,1,3.862857142857024
2018-07-01,10,0,10,0,0,0,0,0.0
2018-07-02,134,36,98,1,35,1,0,-3.1400000000009527
2018-07-03,200,86,114,1,85,1,1,2.5514285714289713
2018-07-04,201,101,100,0,101,0,0,0.0
2018-07-05,153,57,96,1,56,1,1,1.822857142857515
2018-07-06,126,58,68,1,57,1,0,-3.0571428571424804
2018-07-08,6,0,6,0,0,0,0,0.0
2018-07-09,148,86,62,1,85,1,1,1.2142857142857792
2018-07-10,269,154,115,1,153,1,1,6.211428571428257
2018-07-11,146,56,90,1,55,1,0,-2.9885714285716176
2018-07-12,179,64,115,1,63,1,0,-3.4657142857146823
2018-07-13,233,137,96,0,137,0,0,0.0
2018-07-15,25,12,13,0,12,0,0,0.0
2018-07-16,146,49,97,1,48,1,0,-2.151428571427971
2018-07-17,198,83,115,1,82,1,1,2.345714285713541
2018-07-18,223,123,100,0,123,0,0,0.0
2018-07-19,146,38,108,1,37,1,1,4.719999999999914
2018-07-20,146,51,95,1,50,1,0,-5.394285714286184
2018-07-22,19,0,19,0,0,0,0,0.0
2018-07-23,171,57,114,1,56,1,0,-2.151428571427971
2018-07-24,149,59,90,1,58,1,1,3.965714285714739
2018-07-25,159,68,91,1,67,1,1,3.142857142857281
2018-07-26,156,53,103,1,52,1,1,3.8971428571424553
2018-07-27,153,57,96,1,56,1,0,-3.25142857142896
2018-07-29,8,0,8,0,0,0,0,0.0
2018-07-30,227,112,115,0,112,0,0,0.0
2018-07-31,167,55,112,1,54,1,0,-4.737142857142828
2018-08-01,171,68,103,1,67,1,1,2.6542857142852654
2018-08-02,259,155,104,0,155,0,0,0.0
2018-08-03,122,35,87,1,34,1,0,-4.00000000000108
2018-08-05,1,0,1,0,0,0,0,0.0
2018-08-06,232,131,101,0,131,0,0,0.0
2018-08-07,277,161,116,0,161,0,0,0.0
2018-08-08,164,56,108,1,55,1,1,4.377142857142758
2018-08-09,177,63,114,1,62,1,1,2.7314285714292623
2018-08-10,154,58,96,1,57,1,0,-3.5685714285709764
2018-08-12,1,0,1,0,0,0,0,0.0
2018-08-13,148,50,98,2,48,2,1,2.614285714286325
2018-08-14,108,9,99,2,7,2,1,1.1257142857137978
2018-08-15,167,51,116,1,50,1,1,6.794285714286275
2018-08-16,157,48,109,1,47,1,1,3.425714285713866
2018-08-17,146,50,96,1,49,1,1,3.3742857142850085
2018-08-19,7,0,7,0,0,0,0,0.0
2018-08-20,128,30,98,1,29,1,0,-1.7914285714288098
2018-08-21,168,60,108,1,59,1,0,-2.328571428571024
2018-08-22,153,54,99,1,53,1,0,-1.931428571429194
2018-08-23,149,48,101,1,47,1,1,3.434285714285579
2018-08-24,120,54,66,1,53,1,1,5.208571428571929
2018-08-26,8,0,8,0,0,0,0,0.0
2018-08-27,261,153,108,0,153,0,0,0.0
2018-08-28,169,63,106,1,62,1,0,-3.2171428571421075
2018-08-29,162,60,102,1,59,1,1,4.4371428571433285
2018-08-30,164,62,102,1,61,1,0,-3.8828571428571763
2018-08-31,93,27,66,1,26,1,0,-3.354285714286675
2018-09-02,20,0,20,0,0,0,0,0.0
2018-09-03,256,148,108,0,148,0,0,0.0
2018-09-04,173,63,110,1,62,1,0,-4.419999999999391
2018-09-05,132,45,87,1,44,1,0,-2.1542857142852085
2018-09-06,159,46,113,1,45,1,1,5.491428571428514
2018-09-07,143,47,96,2,45,2,1,0.4857142857138683
2018-09-09,17,0,17,0,0,0,0,0.0
2018-09-10,209,112,97,0,112,0,0,0.0
2018-09-11,186,74,112,1,73,1,1,2.6714285714286916
2018-09-12,138,31,107,1,30,1,0,-3.231428571428296
2018-09-13,160,45,115,1,44,1,0,-4.540000000000532
2018-09-14,134,42,92,1,41,1,0,-4.025714285714798
2018-09-16,10,0,10,0,0,0,0,0.0
2018-09-17,190,143,47,0,143,0,0,0.0
2018-09-18,149,45,104,1,44,1,0,-4.462857142856535
2018-09-19,215,120,95,0,120,0,0,0.0
2018-09-20,226,125,101,0,125,0,0,0.0
2018-09-21,221,128,93,0,128,0,0,0.0
2018-09-23,21,12,9,0,12,0,0,0.0
2018-09-24,226,130,96,0,130,0,0,0.0
2018-09-25,264,155,109,0,155,0,0,0.0
2018-09-26,220,108,112,1,107,1,1,7.051428571429142
2018-09-27,198,89,109,1,88,1,1,2.5599999999992633
2018-09-28,223,128,95,0,128,0,0,0.0
2018-09-30,29,12,17,0,12,0,0,0.0
2018-10-01,251,137,114,0,137,0,0,0.0
2018-10-02,167,65,102,1,64,1,1,3.8371428571433057
2018-10-03,181,73,108,1,72,1,1,4.162857142857035
2018-10-04,146,35,111,2,33,2,1,1.9342857142850676
2018-10-05,134,56,78,1,55,1,0,-3.7971428571428874
2018-10-07,19,0,19,0,0,0,0,0.0
2018-10-08,171,61,110,1,60,1,1,4.282857142856756
2018-10-09,142,37,105,2,35,2,0,-6.294285714286673
2018-10-10,164,62,102,1,61,1,1,4.034285714285602
2018-10-11,86,5,81,2,3,2,0,-9.454285714286414
2018-10-12,194,98,96,1,97,1,1,4.480000000000473
2018-10-14,8,0,8,0,0,0,0,0.0
2018-10-15,173,71,102,1,70,1,0,-3.6228571428570717
2018-10-16,153,41,112,1,40,1,0,-2.331428571428262
2018-10-17,160,45,115,1,44,1,1,3.5371428571432943
2018-10-18,186,73,113,1,72,1,1,6.245714285713689
2018-10-19,149,53,96,1,52,1,1,4.942857142857349
2018-10-21,21,0,21,0,0,0,0,0.0
2018-10-22,164,55,109,1,54,1,0,-3.591428571428878
2018-10-23,110,6,104,2,4,2,1,0.20285714285728318
2018-10-24,108,4,104,2,2,2,0,-6.045714285714098
2018-10-25,124,45,79,1,44,1,0,-3.9485714285708013
2018-10-26,148,55,93,1,54,1,1,5.225714285713934
2018-10-28,10,0,10,0,0,0,0,0.0
2018-10-29,105,16,89,2,14,2,1,1.7799999999999159
2018-10-30,161,45,116,1,44,1,0,-2.17714285714311
2018-10-31,145,37,108,1,36,1,1,3.6399999999995885
2018-11-01,161,53,108,1,52,1,1,4.334285714285613
2018-11-02,150,54,96,1,53,1,0,-4.674285714286441
2018-11-04,17,0,17,0,0,0,0,0.0
2018-11-05,221,155,66,0,155,0,0,0.0
2018-11-06,262,151,111,0,151,0,0,0.0
2018-11-07,211,118,93,1,117,1,1,3.4857142857144368
2018-11-08,216,112,104,1,111,1,1,2.5685714285709764
2018-11-09,136,40,96,1,39,1,1,3.7257142857138774
2018-11-11,8,0,8,0,0,0,0,0.0
2018-11-12,168,61,107,1,60,1,0,-3.5799999999999272
2018-11-13,158,55,103,1,54,1,1,3.4514285714290054
2018-11-14,151,46,105,1,45,1,1,2.885714285714414
2018-11-15,102,16,86,2,14,2,1,-0.33999999999940655
2018-11-16,89,5,84,2,3,2,1,0.517142857142062
2018-11-18,16,0,16,0,0,0,0,0.0
2018-11-19,127,36,91,1,35,1,0,-3.5657142857137387
2018-11-20,139,44,95,1,43,1,1,3.2971428571424326
2018-11-21,157,54,103,1,53,1,1,3.0142857142858475
2018-11-22,151,123,28,0,123,0,0,0.0
2018-11-23,140,62,78,1,61,1,1,2.259999999999252
2018-11-25,12,0,12,0,0,0,0,0.0
2018-11-26,164,51,113,1,50,1,1,1.7199999999998
2018-11-27,112,11,101,2,9,2,0,-5.911428571428189
2018-11-28,193,86,107,1,85,1,0,-2.6649011181082756
2018-11-29,152,56,96,1,55,1,0,-3.3857142857148688
2018-11-30,79,79,0,1,78,1,1,2.3714285714286802
2018-12-02,14,0,14,0,0,0,0,0.0
2018-12-03,164,75,89,1,74,1,0,-2.6199999999993224
2018-12-04,184,72,112,1,71,1,1,2.2085714285703943
2018-12-05,188,73,115,1,72,1,1,1.917142857142096
2018-12-06,171,57,114,1,56,1,0,-1.8028571428577607
2018-12-07,147,53,94,1,52,1,1,-0.1421591826347708
2018-12-09,14,0,14,0,0,0,0,0.0
2018-12-10,159,45,114,1,44,1,0,-1.7371428571427145
2018-12-11,154,44,110,1,43,1,1,2.0542857142852426
2018-12-12,129,33,96,1,32,1,0,-1.7828571428570967
2018-12-13,139,43,96,1,42,1,1,-0.5849048873277525
2018-12-14,126,54,72,1,53,1,1,1.7800000000003706
2018-12-16,18,0,18,0,0,0,0,0.0
2018-12-17,158,55,103,1,54,1,1,1.557142857142935
2018-12-18,167,56,111,1,55,1,0,-1.8114285714280527
2018-12-19,167,68,99,1,67,1,1,1.7714285714286575
2018-12-20,127,28,99,2,26,2,2,2.922391960114169
2018-12-21,79,2,77,2,0,2,0,-4.094285714286116
2018-12-23,5,0,5,0,0,0,0,0.0
2018-12-24,49,40,9,1,39,1,0,-3.722857142857549
2018-12-25,117,0,117,0,0,0,0,0.0
2018-12-26,90,12,78,2,10,2,1,-1.2485714285725749
2018-12-27,114,2,112,2,0,2,0,-5.762857142858934
2018-12-28,146,51,95,1,50,1,1,2.6885714285706968
2018-12-30,19,0,19,0,0,0,0,0.0
2018-12-31,142,47,95,1,46,1,0,-2.4885714285720724
2019-01-01,18,0,18,0,0,0,0,0.0
2019-01-02,115,2,113,2,0,2,0,-6.694285714285741
2019-01-03,113,2,111,2,0,2,0,-8.334285714286182
2019-01-04,148,52,96,1,51,1,0,-0.1423408031446911
2019-01-06,12,0,12,0,0,0,0,0.0
2019-01-07,140,51,89,1,50,1,0,-2.00857142857177
2019-01-08,159,50,109,1,49,1,0,-2.4314285714287394
2019-01-09,129,26,103,1,25,1,1,3.2971428571424326
2019-01-10,164,57,107,1,56,1,0,-3.4942857142856383
2019-01-11,112,27,85,1,26,1,1,-0.23383554692958342
2019-01-13,13,0,13,0,0,0,0,0.0
2019-01-14,150,38,112,1,37,1,1,-0.4711677722132208
2019-01-15,154,57,97,1,56,1,0,-2.1342857142859657
2019-01-16,162,60,102,1,59,1,1,2.3971428571423985
2019-01-17,131,26,105,1,25,1,1,3.434285714285579
2019-01-18,140,45,95,1,44,1,0,-3.51714285714354
2019-01-20,8,0,8,0,0,0,0,0.0
2019-01-21,216,113,103,0,113,0,0,0.0
2019-01-22,161,63,98,1,62,1,0,-3.354285714285254
2019-01-23,147,48,99,1,47,1,1,3.057142857142992
2019-01-24,152,57,95,1,56,1,1,-0.5471811164359792
2019-01-25,154,59,95,1,58,1,0,-2.9514285714275275
2019-01-27,18,0,18,0,0,0,0,0.0
2019-01-28,156,48,108,1,47,1,1,2.1228571428575265
2019-01-29,166,69,97,1,68,1,1,1.9428571428572354
2019-01-30,111,63,48,1,62,1,1,3.6228571428575833
2019-01-31,157,53,104,1,52,1,0,-1.7314285714282391
2019-02-01,140,52,88,1,51,1,1,-0.6263828996101779
2019-02-03,20,0,20,0,0,0,0,0.0
2019-02-04,170,57,113,1,56,1,1,1.728571428571513
2019-02-05,149,55,94,1,54,1,1,1.4457142857135068
2019-02-06,163,58,105,1,57,1,1,1.2571428571429237
2019-02-07,144,53,91,1,52,1,1,2.96285714285699
2019-02-08,120,57,63,1,56,1,1,1.0000000000000568
2019-02-10,10,0,10,0,0,0,0,0.0
2019-02-11,149,57,92,1,56,1,0,-1.5371428571431807
2019-02-12,150,48,102,1,47,1,0,-2.605714285713134
2019-02-13,147,36,111,1,35,1,1,-0.6476627192076307
2019-02-14,158,50,108,1,49,1,0,-3.0771428571431443
2019-02-15,142,58,84,1,57,1,1,1.1800000000003479
2019-02-17,13,0,13,0,0,0,0,0.0
2019-02-18,254,146,108,0,146,0,0,0.0
2019-02-19,156,61,95,1,60,1,1,1.094285714286059
2019-02-20,166,58,108,1,57,1,0,-2.1000000000005343
2019-02-21,124,28,96,1,27,1,0,-2.2800000000008254
2019-02-22,150,60,90,1,59,1,1,1.5142857142857906
2019-02-24,17,0,17,0,0,0,0,0.0
2019-02-25,132,62,70,1,61,1,1,1.0857142857143458
2019-02-26,156,57,99,1,56,1,1,1.3857142857143572
2019-02-27,141,57,84,1,56,1,0,-1.074180896033738
2019-02-28,143,30,113,1,29,1,0,-2.7914285714279004
2019-03-01,123,27,96,1,26,1,0,-1.74285714285719
2019-03-03,21,0,21,0,0,0,0,0.0
2019-03-04,147,49,98,1,48,1,0,-3.0857142857148574
2019-03-05,165,59,106,1,58,1,1,-0.2805127515533741
2019-03-06,149,50,99,1,49,1,0,-1.734285714286898
2019-03-07,148,59,89,1,58,1,0,-0.6952983949180975
2019-03-08,143,48,95,1,47,1,1,3.4514285714290054
2019-03-10,15,0,15,0,0,0,0,0.0
2019-03-11,133,48,85,1,47,1,0,-3.5857142857144026
2019-03-12,158,48,110,1,47,1,0,-2.1171428571425395
2019-03-13,149,36,113,1,35,1,0,-1.7742857142853836
2019-03-14,167,50,117,1,49,1,1,1.8914285714283778
2019-03-15,130,36,94,1,35,1,0,-1.9171428571430056
2019-03-17,14,0,14,0,0,0,0,0.0
2019-03-18,184,70,114,1,69,1,1,1.908571428571804
2019-03-19,149,34,115,1,33,1,0,-2.2228571428574924
2019-03-20,188,76,112,1,75,1,0,-0.8147329917538855
2019-03-21,158,57,101,1,56,1,0,-3.628571428571547
2019-03-22,149,57,92,1,56,1,0,-3.665714285714216
2019-03-24,16,0,16,0,0,0,0,0.0
2019-03-25,149,53,96,1,52,1,0,-2.045714285714439
2019-03-26,159,51,108,1,50,1,0,-4.142857142857281
2019-03-27,106,51,55,1,50,1,0,-3.608571428570883
2019-03-28,162,57,105,1,56,1,1,0.960510003505533
2019-03-29,106,11,95,1,10,1,0,-4.01142857142861
2019-03-31,7,0,7,0,0,0,0,0.0
2019-04-01,161,53,108,1,52,1,1,4.342857142857326
2019-04-02,199,123,76,0,123,0,0,0.0
2019-04-03,158,49,109,1,48,1,0,-3.0257142857142867
2019-04-04,243,133,110,0,133,0,0,0.0
2019-04-05,151,54,97,1,53,1,0,-4.785714285714448
2019-04-07,14,0,14,0,0,0,0,0.0
2019-04-08,252,137,115,0,137,0,0,0.0
2019-04-09,254,142,112,0,142,0,0,0.0
2019-04-10,149,53,96,1,52,1,1,5.277142857142792
2019-04-11,240,130,110,0,130,0,0,0.0
2019-04-12,221,125,96,0,125,0,0,0.0
2019-04-14,32,12,20,0,12,0,0,0.0
2019-04-15,173,75,98,0,75,0,0,0.0
2019-04-16,152,67,85,0,67,0,0,0.0
2019-04-17,230,123,107,0,123,0,0,0.0
2019-04-18,202,105,97,0,105,0,0,0.0
2019-04-19,173,86,87,0,86,0,0,0.0
2019-04-21,28,12,16,0,12,0,0,0.0
2019-04-22,135,50,85,0,50,0,0,0.0
2019-04-23,249,134,115,0,134,0,0,0.0
2019-04-24,221,115,106,1,114,1,1,4.119999999999891
2019-04-25,166,57,109,1,56,1,1,3.1085714285718495
2019-04-26,147,51,96,1,50,1,0,-3.334285714286011
2019-04-28,12,0,12,0,0,0,0,0.0
2019-04-29,221,119,102,0,119,0,0,0.0
2019-04-30,176,71,105,1,70,1,0,-3.5657142857137387
2019-05-01,168,67,101,1,66,1,1,3.2199999999998568
2019-05-02,241,131,110,0,131,0,0,0.0
2019-05-03,138,44,94,1,43,1,0,-2.6171428571420847
2019-05-05,15,0,15,0,0,0,0,0.0
2019-05-06,218,128,90,1,127,1,1,3.1771428571427123
2019-05-07,141,63,78,1,62,1,1,2.8428571428572695
2019-05-08,151,52,99,1,51,1,0,-4.322857142857572
2019-05-09,166,58,108,1,57,1,0,-2.5057142857154986
2019-05-10,161,66,95,1,65,1,1,3.0314285714278526
2019-05-12,17,0,17,0,0,0,0,0.0
2019-05-13,126,45,81,2,43,2,1,3.3285714285715926
2019-05-14,160,49,111,1,48,1,1,2.8257142857138433
2019-05-15,162,54,108,1,53,1,0,-2.585714285713891
2019-05-16,163,57,106,1,56,1,0,-2.1914285714278776
2019-05-17,141,45,96,1,44,1,0,-2.777142857143133
2019-05-19,10,0,10,0,0,0,0,0.0
2019-05-20,171,60,111,1,59,1,0,-3.7314285714292623
2019-05-21,258,142,116,0,142,0,0,0.0
2019-05-22,263,157,106,0,157,0,0,0.0
2019-05-23,162,58,104,1,57,1,0,-3.8457142857145072
2019-05-24,166,71,95,1,70,1,1,3.931428571429308
2019-05-26,21,0,21,0,0,0,0,0.0
2019-05-27,258,143,115,0,143,0,0,0.0
2019-05-28,124,33,91,1,32,1,0,-2.8771428571436104
2019-05-29,153,56,97,1,55,1,0,-2.748571428572177
2019-05-30,253,144,109,0,144,0,0,0.0
2019-05-31,138,42,96,1,41,1,0,-4.057142857142992
2019-06-02,12,0,12,0,0,0,0,0.0
2019-06-03,146,56,90,1,55,1,0,-2.6287488775868724
2019-06-04,164,55,109,1,54,1,1,5.44857142857137
2019-06-05,149,56,93,1,55,1,1,9.691428571428673
2019-06-06,146,57,89,1,56,1,0,-2.654285714286175
2019-06-07,141,45,96,1,44,1,0,-5.757142857144004
2019-06-09,6,0,6,0,0,0,0,0.0
2019-06-10,217,135,82,0,135,0,0,0.0
2019-06-11,257,158,99,0,158,0,0,0.0
2019-06-12,189,86,103,0,86,0,0,0.0
2019-06-13,262,154,108,0,154,0,0,0.0
2019-06-14,135,39,96,1,38,1,0,-2.8399999999995202
2019-06-16,8,0,8,0,0,0,0,0.0
2019-06-17,236,126,110,0,126,0,0,0.0
2019-06-18,161,49,112,1,48,1,1,6.142857142857395
2019-06-19,190,89,101,1,88,1,1,4.925714285713923
2019-06-20,163,51,112,1,50,1,0,-3.005714285715044
2019-06-21,137,57,80,1,56,1,1,4.780000000000484
2019-06-23,19,0,19,0,0,0,0,0.0
2019-06-24,253,157,96,0,157,0,0,0.0
2019-06-25,167,62,105,1,61,1,1,3.9742857142864523
2019-06-26,243,136,107,0,136,0,0,0.0
2019-06-27,187,78,109,1,77,1,1,3.339999999999577
2019-06-28,143,47,96,1,46,1,0,-3.774285714286407
2019-06-30,20,0,20,0,0,0,0,0.0
2019-07-01,195,135,60,0,135,0,0,0.0
2019-07-02,143,64,79,1,63,1,1,3.6228571428575833
2019-07-03,267,152,115,0,152,0,0,0.0
2019-07-04,183,78,105,0,78,0,0,0.0
2019-07-05,131,35,96,1,34,1,0,-3.5228571428565942
2019-07-07,5,0,5,0,0,0,0,0.0
2019-07-08,250,161,89,0,161,0,0,0.0
2019-07-09,217,109,108,0,109,0,0,0.0
2019-07-10,163,50,113,1,49,1,0,-3.2057142857145777
2019-07-11,155,48,107,1,47,1,0,-3.2914285714288667
2019-07-12,127,31,96,1,30,1,1,3.2714285714287143
2019-07-14,8,0,8,0,0,0,0,0.0
2019-07-15,216,124,92,0,124,0,0,0.0
2019-07-16,170,58,112,1,57,1,0,-4.240000000000521
2019-07-17,232,122,110,0,122,0,0,0.0
2019-07-18,221,104,117,1,103,1,1,4.582857142856767
2019-07-19,174,78,96,1,77,1,1,4.068571428571033
2019-07-21,20,0,20,0,0,0,0,0.0
2019-07-22,206,99,107,0,99,0,0,0.0
2019-07-23,155,46,109,1,45,1,0,-3.7399999999995543
2019-07-24,246,141,105,0,141,0,0,0.0
2019-07-25,119,34,85,1,33,1,0,-2.539999999999509
2019-07-26,124,50,74,1,49,1,0,-2.339999999999975
2019-07-28,6,0,6,0,0,0,0,0.0
2019-07-29,252,160,92,0,160,0,0,0.0
2019-07-30,173,71,102,1,70,1,1,3.5542857142852995
2019-07-31,168,61,107,1,60,1,0,0.12776871181853267
2019-08-01,174,58,116,1,57,1,0,-2.614285714286268
2019-08-02,97,2,95,2,0,2,1,9.517142857143824
2019-08-04,14,0,14,0,0,0,0,0.0
2019-08-05,155,55,100,1,54,1,0,-2.8771428571436104
2019-08-06,162,51,111,1,50,1,0,-3.9742857142859407
2019-08-07,158,54,104,1,53,1,0,-4.32571428571481
2019-08-08,95,45,50,1,44,1,0,-3.2657142857151484
2019-08-09,162,69,93,1,68,1,0,-2.7760058827856255
2019-08-11,15,0,15,0,0,0,0,0.0
2019-08-12,267,157,110,0,157,0,0,0.0
2019-08-13,169,54,115,1,53,1,1,6.648571428571415
2019-08-14,172,56,116,1,55,1,0,-3.762857142857456
2019-08-15,151,37,114,2,35,2,0,-9.679999999999666
2019-08-16,210,116,94,0,116,0,0,0.0
2019-08-18,22,7,15,0,7,0,0,0.0
2019-08-19,156,127,29,0,127,0,0,0.0
2019-08-20,131,53,78,1,52,1,1,5.431428571429365
2019-08-21,263,152,111,0,152,0,0,0.0
2019-08-22,167,58,109,1,57,1,1,4.685714285714482
2019-08-23,137,41,96,1,40,1,0,-3.8028571428573628
2019-08-25,17,0,17,0,0,0,0,0.0
2019-08-26,155,50,105,1,49,1,0,-5.245714285714087
2019-08-27,139,32,107,1,31,1,0,-3.0000000000005684
2019-08-28,162,57,105,1,56,1,1,5.439999999999657
2019-08-29,268,160,108,0,160,0,0,0.0
2019-08-30,238,143,95,0,143,0,0,0.0
2019-09-01,14,12,2,0,12,0,0,0.0
2019-09-02,249,153,96,0,153,0,0,0.0
2019-09-03,151,41,110,1,40,1,1,8.045714285713757
2019-09-04,209,109,100,0,109,0,0,0.0
2019-09-05,181,64,117,1,63,1,1,6.931428571428
2019-09-06,134,38,96,1,37,1,1,7.111428571428291
2019-09-08,8,0,8,0,0,0,0,0.0
2019-09-09,181,134,47,0,134,0,0,0.0
2019-09-10,247,141,106,0,141,0,0,0.0
2019-09-11,232,124,108,0,124,0,0,0.0
2019-09-12,152,36,116,1,35,1,1,6.48571428571455
2019-09-13,145,71,74,0,71,0,0,0.0
2019-09-15,1,1,0,1,0,1,1,5.560000000000798
2019-09-16,102,75,27,1,74,1,1,4.051428571427607
2019-09-17,117,18,99,1,17,1,1,-0.15285914184107696
2019-09-18,175,75,100,1,74,1,1,2.9542857142852768
2019-09-19,210,103,107,1,102,1,1,2.722857142857549
2019-09-20,168,72,96,1,71,1,0,-2.234285714285022
2019-09-22,7,0,7,0,0,0,0,0.0
2019-09-23,81,42,39,1,41,1,0,-3.5657142857137387
2019-09-24,173,63,110,1,62,1,1,2.885714285714414
2019-09-25,135,30,105,1,29,1,0,-3.5371428571427828
2019-09-26,170,55,115,1,54,1,0,-3.7028571428568853
2019-09-27,145,51,94,1,50,1,0,-2.3542857142861635
2019-09-29,19,0,19,0,0,0,0,0.0
2019-09-30,148,52,96,1,51,1,0,-3.6999999999996476
2019-10-01,149,52,97,1,51,1,0,-4.645714285714064
2019-10-02,153,49,104,1,48,1,1,3.2885714285707195
2019-10-03,161,55,106,1,54,1,0,-3.9571428571425145
2019-10-04,144,47,97,1,46,1,0,-4.577142857143201
2019-10-06,14,0,14,0,0,0,0,0.0
2019-10-07,174,88,86,1,87,1,1,4.728571428571627
2019-10-08,167,52,115,1,51,1,1,3.862857142857024
2019-10-09,244,129,115,1,128,1,1,3.2114285714281436
2019-10-10,144,41,103,1,40,1,0,-2.7428571428577015
2019-10-11,153,63,90,1,62,1,0,-0.6113840206457439
2019-10-13,16,0,16,0,0,0,0,0.0
2019-10-14,259,154,105,0,154,0,0,0.0
2019-10-15,168,69,99,1,68,1,1,4.20571428571418
2019-10-16,157,43,114,1,42,1,0,-4.365714285714716
2019-10-17,158,50,108,1,49,1,0,-2.1657142857141594
2019-10-18,163,70,93,0,70,0,0,0.0
2019-10-20,4,4,0,0,4,0,0,0.0
2019-10-21,237,126,111,0,126,0,0,0.0
2019-10-22,259,146,113,0,146,0,0,0.0
2019-10-23,258,152,106,0,152,0,0,0.0
2019-10-24,195,97,98,0,97,0,0,0.0
2019-10-25,240,144,96,0,144,0,0,0.0
2019-10-27,14,12,2,0,12,0,0,0.0
2019-10-28,262,157,105,0,157,0,0,0.0
2019-10-29,176,121,55,0,121,0,0,0.0
2019-10-30,185,105,80,1,104,1,1,5.114285714285927
2019-10-31,171,68,103,1,67,1,1,3.519999999999868
2019-11-01,120,47,73,1,46,1,0,-3.0457142857149506
2019-11-03,3,0,3,0,0,0,0,0.0
2019-11-04,158,125,33,0,125,0,0,0.0
2019-11-05,128,31,97,1,30,1,1,3.34857142857129
2019-11-06,150,48,102,1,47,1,1,3.588571428570731
2019-11-07,185,85,100,1,84,1,1,3.159999999999286
2019-11-08,146,58,88,1,57,1,0,-3.534285714285545
2019-11-10,19,0,19,0,0,0,0,0.0
2019-11-11,236,139,97,0,139,0,0,0.0
2019-11-12,241,140,101,0,140,0,0,0.0
2019-11-13,164,70,94,1,69,1,1,2.800000000000125
2019-11-14,177,90,87,1,89,1,1,2.705714285714123
2019-11-15,160,64,96,1,63,1,1,-0.6216700398686044
2019-11-17,15,0,15,0,0,0,0,0.0
2019-11-18,155,51,104,1,50,1,1,2.2257142857138206
2019-11-19,183,74,109,1,73,1,1,2.0285714285715244
2019-11-20,144,34,110,1,33,1,1,1.5742857142849402
2019-11-21,138,43,95,1,42,1,0,-2.4371428571417937
2019-11-22,168,76,92,1,75,1,1,1.8314285714278071
2019-11-24,13,0,13,0,0,0,0,0.0
2019-11-25,227,112,115,0,112,0,0,0.0
2019-11-26,165,51,114,1,50,1,0,-3.1771428571422007
2019-11-27,185,76,109,1,75,1,1,1.642857142857224
2019-11-28,249,153,96,0,153,0,0,0.0
2019-11-29,165,69,96,1,68,1,1,1.3428571428572127
2019-12-01,17,0,17,0,0,0,0,0.0
2019-12-02,180,64,116,1,63,1,1,-0.18027180057390524
2019-12-03,170,53,117,1,52,1,0,-2.0114285714290077
2019-12-04,162,51,111,1,50,1,0,-1.9657142857146255
2019-12-05,153,52,101,1,51,1,0,-3.2742857142854405
2019-12-06,152,57,95,1,56,1,1,-0.1632328402867529
2019-12-08,15,0,15,0,0,0,0,0.0
2019-12-09,182,84,98,1,83,1,1,1.6599999999992292
2019-12-10,165,54,111,1,53,1,0,-0.8197757247022537
2019-12-11,137,122,15,1,121,1,1,1.6942857142846606
2019-12-12,128,50,78,1,49,1,0,-2.1542857142852085
2019-12-13,101,42,59,1,41,1,0,-2.0114285714290077
2019-12-15,18,0,18,0,0,0,0,0.0
2019-12-16,227,114,113,0,114,0,0,0.0
2019-12-17,171,136,35,0,136,0,0,0.0
2019-12-18,149,63,86,1,62,1,0,-3.2257142857138206
2019-12-19,198,143,55,0,143,0,0,0.0
2019-12-20,161,141,20,0,141,0,0,0.0
2019-12-22,20,0,20,0,0,0,0,0.0
2019-12-23,184,139,45,0,139,0,0,0.0
2019-12-24,219,138,81,0,138,0,0,0.0
2019-12-25,98,0,98,0,0,0,0,0.0
2019-12-26,252,156,96,0,156,0,0,0.0
2019-12-27,199,107,92,0,107,0,0,0.0
2019-12-29,6,0,6,0,0,0,0,0.0
2019-12-30,173,65,108,1,64,1,1,1.9342857142855223
2019-12-31,152,56,96,1,55,1,1,2.0199999999998113
2020-01-01,1,0,1,0,0,0,0,0.0
2020-01-02,69,47,22,1,46,1,1,1.6685714285709423
2020-01-03,131,45,86,1,44,1,0,-3.4657142857146823
2020-01-05,14,0,14,0,0,0,0,0.0
2020-01-06,173,64,109,1,63,1,0,-2.3142857142862567
2020-01-07,175,68,107,1,67,1,1,2.079999999998961
2020-01-08,137,34,103,1,33,1,0,-3.2057142857145777
2020-01-09,146,50,96,1,49,1,0,-2.2771428571435877
2020-01-10,102,63,39,1,62,1,1,-0.6370487026946421
2020-01-12,15,0,15,0,0,0,0,0.0
2020-01-13,180,75,105,1,74,1,0,-1.7571428571433785
2020-01-14,146,40,106,1,39,1,0,-1.7885714285715721
2020-01-15,177,77,100,1,76,1,1,2.080000000000382
2020-01-16,170,62,108,1,61,1,1,2.1142857142858134
2020-01-17,167,78,89,1,77,1,0,-3.2714285714282028
2020-01-19,21,0,21,0,0,0,0,0.0
2020-01-20,250,134,116,0,134,0,0,0.0
2020-01-21,160,53,107,1,52,1,1,1.9171428571435172
2020-01-22,176,65,111,1,64,1,1,1.5914285714283665
2020-01-23,151,35,116,1,34,1,0,-2.748571428570756
2020-01-24,154,59,95,1,58,1,1,1.98571428571438
2020-01-26,13,0,13,0,0,0,0,0.0
2020-01-27,119,55,64,1,54,1,0,-2.9714285714281914
2020-01-28,157,53,104,1,52,1,0,-3.4142857142858247
2020-01-29,113,45,68,1,44,1,1,3.2714285714287143
2020-01-30,145,37,108,1,36,1,0,-3.3599999999997294
2020-01-31,160,66,94,1,65,1,1,2.1228571428575265
2020-02-02,6,0,6,0,0,0,0,0.0
2020-02-03,162,55,107,1,54,1,1,2.0371428571432375
2020-02-04,152,56,96,1,55,1,0,-3.308571428570872
2020-02-05,142,57,85,1,56,1,0,-1.9457142857139615
2020-02-06,168,62,106,1,61,1,1,2.182857142856676
2020-02-07,148,52,96,1,51,1,0,-2.0079368394921744
2020-02-09,18,0,18,0,0,0,0,0.0
2020-02-10,238,136,102,0,136,0,0,0.0
2020-02-11,165,66,99,1,65,1,1,1.8742857142863727
2020-02-12,260,161,99,0,161,0,0,0.0
2020-02-13,162,55,107,1,54,1,1,2.011428571428098
2020-02-14,124,66,58,1,65,1,1,1.5399999999995089
2020-02-16,0,0,0,0,0,0,0,0.0
2020-02-17,176,151,25,0,151,0,0,0.0
2020-02-18,139,31,108,1,30,1,1,1.6257142857137978
2020-02-19,168,55,113,1,54,1,1,1.45428571428522
2020-02-20,116,2,114,2,0,2,0,-5.831428571428376
2020-02-21,97,2,95,2,0,2,0,-6.962857142857558
2020-02-23,14,0,14,0,0,0,0,0.0
2020-02-24,160,54,106,1,53,1,0,-1.9257142857147187
2020-02-25,170,55,115,1,54,1,0,-2.7342857142859884
2020-02-26,157,48,109,1,47,1,0,-2.294285714285593
2020-02-27,141,33,108,1,32,1,0,-2.9714285714281914
2020-02-28,123,55,68,1,54,1,0,-3.4285714285720132
2020-03-01,4,0,4,0,0,0,0,0.0
2020-03-02,114,17,97,2,15,2,1,7.0657142857134545
2020-03-03,112,2,110,2,0,2,0,-8.302857142856567
2020-03-04,132,20,112,1,19,1,0,-4.151428571428994
2020-03-05,167,57,110,1,56,1,0,-2.5142857142857906
2020-03-06,119,28,91,2,26,2,1,9.188571428571436
2020-03-08,15,0,15,0,0,0,0,0.0
2020-03-09,114,2,112,2,0,2,0,-13.059999999999604
2020-03-10,104,2,102,2,0,2,0,-17.425714285715287
2020-03-11,120,6,114,2,4,2,1,7.534285714286227
2020-03-12,111,2,109,2,0,2,0,-14.782857142858518
2020-03-13,98,2,96,2,0,2,0,-15.882857142858086
2020-03-15,15,0,15,0,0,0,0,0.0
2020-03-16,100,58,42,1,57,1,0,-9.940000000000737
2020-03-17,254,137,117,0,137,0,0,0.0
2020-03-18,229,123,106,1,122,1,1,12.04857142857162
2020-03-19,250,140,110,0,140,0,0,0.0
2020-03-20,240,146,94,0,146,0,0,0.0
2020-03-22,22,12,10,0,12,0,0,0.0
2020-03-23,258,148,110,1,147,1,0,-9.737142857142544
2020-03-24,269,154,115,0,154,0,0,0.0
2020-03-25,211,98,113,1,97,1,1,6.922857142856287
2020-03-26,208,97,111,0,97,0,0,0.0
2020-03-27,131,35,96,1,34,1,1,11.285714285714732
2020-03-29,14,0,14,0,0,0,0,0.0
2020-03-30,219,121,98,0,121,0,0,0.0
2020-03-31,163,48,115,1,47,1,1,9.82857142857182
2020-04-01,169,55,114,1,54,1,1,7.1200000000000045
2020-04-02,138,23,115,1,22,1,0,-4.994285714285695
2020-04-03,105,53,52,1,52,1,0,-5.14571428571503
2020-04-05,12,0,12,0,0,0,0,0.0
2020-04-06,151,34,117,1,33,1,0,-2.8485714285712334
2020-04-07,157,46,111,1,45,1,0,-4.502857142857863
2020-04-08,156,60,96,1,59,1,1,7.334285714285727
2020-04-09,174,60,114,1,59,1,0,-3.771428571429169
2020-04-10,223,134,89,0,134,0,0,0.0
2020-04-12,15,12,3,0,12,0,0,0.0
2020-04-13,149,46,103,1,45,1,1,3.605714285714157
2020-04-14,147,57,90,1,56,1,0,-3.9485714285708013
2020-04-15,138,33,105,1,32,1,0,-3.3228571428570604
2020-04-16,159,56,103,1,55,1,0,-3.5599999999992633
2020-04-17,158,62,96,1,61,1,1,7.565714285714876
2020-04-19,18,0,18,0,0,0,0,0.0
2020-04-20,174,62,112,1,61,1,0,-2.7257142857142753
2020-04-21,157,46,111,1,45,1,0,-2.8742857142863727
2020-04-22,165,69,96,1,68,1,1,4.634285714285625
2020-04-23,90,37,53,1,36,1,0,-4.077142857142235
2020-04-24,239,145,94,0,145,0,0,0.0
2020-04-26,22,6,16,1,5,1,1,3.134285714285568
2020-04-27,167,63,104,1,62,1,1,4.368571428571045
2020-04-28,169,55,114,1,54,1,0,-2.674285714286839
2020-04-29,148,52,96,1,51,1,0,-5.031428571428364
2020-04-30,142,37,105,1,36,1,1,4.05999999999932
2020-05-01,115,67,48,1,66,1,1,6.965714285714853
2020-05-03,7,0,7,0,0,0,0,0.0
2020-05-04,160,46,114,1,45,1,1,3.5285714285715812
2020-05-05,152,41,111,1,40,1,1,2.7742857142849857
2020-05-06,173,58,115,1,57,1,1,2.7314285714278412
2020-05-07,167,57,110,1,56,1,0,-2.197142857142353
2020-05-08,121,26,95,1,25,1,0,-3.591428571427457
2020-05-10,21,0,21,0,0,0,0,0.0
2020-05-11,179,74,105,1,73,1,1,3.8028571428564533
2020-05-12,143,33,110,1,32,1,0,-2.1857142857148233
2020-05-13,151,44,107,1,43,1,0,-2.825714285714753
2020-05-14,162,56,106,1,55,1,0,-2.2285714285719678
2020-05-15,135,56,79,1,55,1,0,-2.5714285714291236
2020-05-17,21,0,21,0,0,0,0,0.0
2020-05-18,123,64,59,1,63,1,0,-3.9199999999998454
2020-05-19,173,57,116,1,56,1,0,-4.077142857142235
2020-05-20,240,136,104,0,136,0,0,0.0
2020-05-21,139,42,97,1,41,1,1,2.9285714285715585
2020-05-22,178,98,80,0,98,0,0,0.0
2020-05-24,18,7,11,0,7,0,0,0.0
2020-05-25,169,106,63,0,106,0,0,0.0
2020-05-26,176,61,115,1,60,1,1,3.400000000000148
2020-05-27,150,62,88,1,61,1,1,4.239999999999611
2020-05-28,156,56,100,1,55,1,0,-2.351428571428926
2020-05-29,144,54,90,1,53,1,0,-2.98571428571438
2020-05-31,16,0,16,0,0,0,0,0.0
2020-06-01,254,145,109,0,145,0,0,0.0
2020-06-02,154,55,99,1,54,1,0,-4.062857142858888
2020-06-03,160,48,112,1,47,1,0,-2.4228571428570262
2020-06-04,165,55,110,1,54,1,0,-3.4942857142856383
2020-06-05,142,57,85,1,56,1,0,-4.974285714285031
2020-06-07,3,0,3,0,0,0,0,0.0
2020-06-08,163,53,110,1,52,1,1,6.365714285713409
2020-06-09,165,54,111,1,53,1,0,-4.045714285715462
2020-06-10,175,67,108,1,66,1,1,5.6028571428565215
2020-06-11,150,41,109,1,40,1,0,-4.177142857142712
2020-06-12,157,62,95,1,61,1,0,-4.4685714285710105
2020-06-14,5,0,5,0,0,0,0,0.0
2020-06-15,222,121,101,0,121,0,0,0.0
2020-06-16,145,57,88,1,56,1,0,-4.78285714285721
2020-06-17,144,38,106,1,37,1,1,4.231428571427898
2020-06-18,147,41,106,1,40,1,0,-0.34969001302061997
2020-06-19,172,87,85,0,87,0,0,0.0
2020-06-21,15,12,3,0,12,0,0,0.0
2020-06-22,222,124,98,0,124,0,0,0.0
2020-06-23,152,40,112,1,39,1,0,-3.68571428571488
2020-06-24,207,116,91,0,116,0,0,0.0
2020-06-25,216,156,60,1,155,1,1,3.2199999999998568
2020-06-26,146,65,81,1,64,1,1,2.8514285714289827
2020-06-28,2,0,2,0,0,0,0,0.0
2020-06-29,130,60,70,1,59,1,1,6.922857142857708
2020-06-30,157,56,101,1,55,1,0,-2.7314285714287507
2020-07-01,187,80,107,0,80,0,0,0.0
2020-07-02,128,46,82,1,45,1,1,5.757142857143094
2020-07-03,171,113,58,0,113,0,0,0.0
2020-07-05,19,12,7,0,12,0,0,0.0
2020-07-06,172,62,110,1,61,1,0,-2.871428571429135
2020-07-07,184,77,107,1,76,1,1,2.7314285714278412
2020-07-08,172,66,106,1,65,1,1,2.0542857142852426
2020-07-09,156,53,103,1,52,1,0,-3.2657142857151484
2020-07-10,163,67,96,1,66,1,1,2.0628571428569558
2020-07-12,14,0,14,0,0,0,0,0.0
2020-07-13,145,60,85,1,59,1,0,-3.2914285714288667
2020-07-14,155,66,89,1,65,1,1,2.080000000000382
2020-07-15,135,72,63,1,71,1,1,3.245714285714996
2020-07-16,158,58,100,1,57,1,0,-3.6914285714293555
2020-07-17,168,74,94,1,73,1,1,2.182857142856676
2020-07-19,5,0,5,0,0,0,0,0.0
2020-07-20,249,143,106,0,143,0,0,0.0
2020-07-21,171,55,116,1,54,1,1,2.2857142857143913
2020-07-22,231,146,85,0,146,0,0,0.0
2020-07-23,127,47,80,1,46,1,0,-1.902857142856817
2020-07-24,145,49,96,1,48,1,0,-0.8591975033785388
2020-07-26,9,0,9,0,0,0,0,0.0
2020-07-27,167,63,104,1,62,1,1,5.380000000000507
2020-07-28,155,56,99,1,55,1,0,-4.337142857142339
2020-07-29,161,62,99,1,61,1,0,0.04957171842175967
2020-07-30,167,54,113,1,53,1,0,-3.5657142857137387
2020-07-31,154,58,96,1,57,1,0,-3.6542857142852654
2020-08-02,5,0,5,0,0,0,0,0.0
2020-08-03,161,74,87,1,73,1,0,-4.88000000000045
2020-08-04,164,50,114,1,49,1,1,3.6399999999995885
2020-08-05,215,114,101,0,114,0,0,0.0
2020-08-06,192,93,99,0,93,0,0,0.0
2020-08-07,120,26,94,1,25,1,0,-3.5657142857137387
2020-08-09,7,0,7,0,0,0,0,0.0
2020-08-10,171,65,106,1,64,1,1,3.785714285714448
2020-08-11,146,38,108,1,37,1,1,0.8007281326494535
2020-08-12,245,144,101,0,144,0,0,0.0
2020-08-13,234,121,113,0,121,0,0,0.0
2020-08-14,145,66,79,1,65,1,1,3.511428571429576
2020-08-16,9,0,9,0,0,0,0,0.0
2020-08-17,244,152,92,0,152,0,0,0.0
2020-08-18,163,46,117,1,45,1,0,-4.4685714285710105
2020-08-19,162,51,111,1,50,1,0,-3.1228571428561054
2020-08-20,235,133,102,0,133,0,0,0.0
2020-08-21,148,52,96,1,51,1,0,-3.0657142857141935
2020-08-23,19,0,19,0,0,0,0,0.0
2020-08-24,201,142,59,0,142,0,0,0.0
2020-08-25,161,58,103,1,57,1,0,-3.9971428571424212
2020-08-26,143,33,110,1,32,1,1,3.502857142856442
2020-08-27,142,53,89,1,52,1,0,-5.334285714285613
2020-08-28,153,57,96,1,56,1,0,-4.54285714285777
2020-08-30,4,0,4,0,0,0,0,0.0
2020-08-31,186,149,37,0,149,0,0,0.0
2020-09-01,172,59,113,1,58,1,1,4.180000000000462
2020-09-02,169,56,113,1,55,1,0,-2.585714285713891
2020-09-03,269,157,112,0,157,0,0,0.0
2020-09-04,213,141,72,0,141,0,0,0.0
2020-09-06,26,12,14,0,12,0,0,0.0
2020-09-07,253,149,104,0,149,0,0,0.0
2020-09-08,165,53,112,1,52,1,0,-4.151428571428994
2020-09-09,118,85,33,0,85,0,0,0.0
2020-09-10,249,141,108,0,141,0,0,0.0
2020-09-11,216,129,87,0,129,0,0,0.0
2020-09-13,24,12,12,0,12,0,0,0.0
2020-09-14,159,56,103,1,55,1,1,2.782857142856699
2020-09-15,153,51,102,1,50,1,0,-1.9914285714283437
2020-09-16,160,44,116,1,43,1,0,-4.442857142857292
2020-09-17,271,157,114,0,157,0,0,0.0
2020-09-18,239,146,93,0,146,0,0,0.0
2020-09-20,12,12,0,0,12,0,0,0.0
2020-09-21,224,137,87,0,137,0,0,0.0
2020-09-22,261,160,101,0,160,0,0,0.0
2020-09-23,243,144,99,0,144,0,0,0.0
2020-09-24,162,56,106,1,55,1,0,-3.8799999999999386
2020-09-25,233,148,85,0,148,0,0,0.0
2020-09-27,32,12,20,0,12,0,0,0.0
2020-09-28,220,106,114,0,106,0,0,0.0
2020-09-29,208,111,97,0,111,0,0,0.0
2020-09-30,172,69,103,1,68,1,1,3.322857142857572
2020-10-01,239,145,94,0,145,0,0,0.0
2020-10-02,143,59,84,1,58,1,1,3.854285714285311
2020-10-04,16,0,16,0,0,0,0,0.0
2020-10-05,215,113,102,0,113,0,0,0.0
2020-10-06,200,96,104,1,95,1,1,3.314285714285859
2020-10-07,253,155,98,0,155,0,0,0.0
2020-10-08,181,100,81,0,100,0,0,0.0
2020-10-09,135,39,96,1,38,1,1,2.25142857142896
2020-10-11,20,0,20,0,0,0,0,0.0
2020-10-12,201,94,107,0,94,0,0,0.0
2020-10-13,200,105,95,0,105,0,0,0.0
2020-10-14,155,49,106,1,48,1,1,1.9771428571426668
2020-10-15,264,150,114,1,149,1,1,1.822857142857515
2020-10-16,147,51,96,1,50,1,0,-3.374285714285918
2020-10-18,11,0,11,0,0,0,0,0.0
2020-10-19,222,156,66,0,156,0,0,0.0
2020-10-20,254,154,100,0,154,0,0,0.0
2020-10-21,176,67,109,1,66,1,1,4.0000000000001705
2020-10-22,157,50,107,1,49,1,0,-3.2714285714282028
2020-10-23,162,67,95,0,67,0,0,0.0
2020-10-25,30,12,18,0,12,0,0,0.0
2020-10-26,251,144,107,0,144,0,0,0.0
2020-10-27,171,55,116,1,54,1,0,-3.3028571428578175
2020-10-28,173,69,104,1,68,1,1,3.6399999999995885
2020-10-29,163,59,104,1,58,1,1,3.3742857142850085
2020-10-30,150,54,96,1,53,1,0,-2.860000000000184
2020-11-01,8,0,8,0,0,0,0,0.0
2020-11-02,253,157,96,0,157,0,0,0.0
2020-11-03,105,63,42,1,62,1,0,-3.4342857142864887
2020-11-04,156,43,113,1,42,1,0,-4.717142857142164
2020-11-05,202,85,117,0,85,0,0,0.0
2020-11-06,147,59,88,1,58,1,1,9.982857142856972
2020-11-08,21,0,21,0,0,0,0,0.0
2020-11-09,161,56,105,1,55,1,0,-6.17142857142926
2020-11-10,175,79,96,0,79,0,0,0.0
2020-11-11,141,46,95,1,45,1,0,-2.151428571427971
2020-11-12,252,148,104,0,148,0,0,0.0
2020-11-13,250,154,96,0,154,0,0,0.0
2020-11-15,0,0,0,0,0,0,0,0.0
2020-11-16,236,154,82,0,154,0,0,0.0
2020-11-17,173,56,117,1,55,1,0,-0.48826737520545294
2020-11-18,243,133,110,0,133,0,0,0.0
2020-11-19,226,133,93,0,133,0,0,0.0
2020-11-20,198,109,89,0,109,0,0,0.0
2020-11-22,16,0,16,0,0,0,0,0.0
2020-11-23,105,60,45,1,59,1,1,7.60857142857202
2020-11-24,135,41,94,1,40,1,1,4.334285714285613
2020-11-25,198,88,110,0,88,0,0,0.0
2020-11-26,216,104,112,0,104,0,0,0.0
2020-11-27,225,129,96,0,129,0,0,0.0
2020-11-29,16,0,16,0,0,0,0,0.0
2020-11-30,156,45,111,1,44,1,0,-3.4914285714298217
2020-12-01,243,132,111,0,132,0,0,0.0
2020-12-02,171,54,117,1,53,1,0,-3.488571428571163
2020-12-03,142,37,105,1,36,1,1,3.074285714284997
2020-12-04,109,34,75,1,33,1,1,4.462857142857047
2020-12-06,17,0,17,0,0,0,0,0.0
2020-12-07,219,149,70,0,149,0,0,0.0
2020-12-08,147,52,95,1,51,1,0,-3.6371428571432602
2020-12-09,269,156,113,0,156,0,0,0.0
2020-12-10,230,130,100,0,130,0,0,0.0
2020-12-11,241,145,96,0,145,0,0,0.0
2020-12-13,6,0,6,0,0,0,0,0.0
2020-12-14,90,54,36,1,53,1,0,-2.037142857142726
2020-12-15,150,61,89,1,60,1,1,3.331428571427864
2020-12-16,179,66,113,1,65,1,1,4.762857142857058
2020-12-17,156,55,101,1,54,1,0,-4.3171428571430965
2020-12-18,168,72,96,0,72,0,0,0.0
2020-12-20,1,0,1,0,0,0,0,0.0
2020-12-21,162,143,19,0,143,0,0,0.0
2020-12-22,171,63,108,1,62,1,1,2.3800000000003934
2020-12-23,141,27,114,1,26,1,1,2.81714285714213
2020-12-24,230,117,113,0,117,0,0,0.0
2020-12-25,60,0,60,0,0,0,0,0.0
2020-12-27,17,0,17,0,0,0,0,0.0
2020-12-28,230,151,79,0,151,0,0,0.0
2020-12-29,223,120,103,0,120,0,0,0.0
2020-12-30,170,67,103,1,66,1,0,-3.5485714285717336
2020-12-31,149,146,3,0,146,0,0,0.0
2021-01-03,13,0,13,0,0,0,0,0.0
2021-01-04,257,155,102,0,155,0,0,0.0
2021-01-05,256,151,105,0,151,0,0,0.0
2021-01-06,226,138,88,0,138,0,0,0.0
2021-01-07,257,147,110,0,147,0,0,0.0
2021-01-08,157,61,96,1,60,1,1,5.354285714285368
2021-01-10,20,0,20,0,0,0,0,0.0
2021-01-11,247,134,113,0,134,0,0,0.0
2021-01-12,182,96,86,1,95,1,1,1.994285714286093
2021-01-13,175,65,110,1,64,1,0,-3.1485714285712447
2021-01-14,117,13,104,1,12,1,0,-2.1828571428561645
2021-01-15,76,41,35,1,40,1,1,2.6714285714286916
2021-01-17,5,0,5,0,0,0,0,0.0
2021-01-18,246,142,104,0,142,0,0,0.0
2021-01-19,120,24,96,1,23,1,1,1.9514285714289485
2021-01-20,249,149,100,0,149,0,0,0.0
2021-01-21,163,55,108,1,54,1,1,2.8514285714289827
2021-01-22,156,60,96,1,59,1,1,1.6000000000000796
2021-01-24,1,0,1,0,0,0,0,0.0
2021-01-25,142,64,78,1,63,1,1,1.8828571428566647
2021-01-26,120,49,71,1,48,1,1,1.282857142856642
2021-01-27,174,81,93,1,80,1,1,3.9142857142858816
2021-01-28,221,116,105,0,116,0,0,0.0
2021-01-29,152,56,96,1,55,1,0,-1.8771428571430988
2021-01-31,18,0,18,0,0,0,0,0.0
2021-02-01,183,80,103,1,79,1,0,-2.937142857144181
2021-02-02,227,135,92,0,135,0,0,0.0
2021-02-03,138,27,111,1,26,1,1,1.8399999999995202
2021-02-04,160,56,104,1,55,1,1,1.2142857142857792
2021-02-05,112,56,56,1,55,1,0,-3.145714285714007
2021-02-07,21,0,21,0,0,0,0,0.0
2021-02-08,261,156,105,0,156,0,0,0.0
2021-02-09,167,57,110,1,56,1,0,-1.620000000000232
2021-02-10,157,55,102,1,54,1,1,2.534285714285545
2021-02-11,87,53,34,1,52,1,0,-3.137142857142294
2021-02-12,144,56,88,1,55,1,0,-3.268571428570965
2021-02-14,18,0,18,0,0,0,0,0.0
2021-02-15,232,128,104,0,128,0,0,0.0
2021-02-16,166,52,114,1,51,1,0,-3.5571428571434467
2021-02-17,241,141,100,0,141,0,0,0.0
2021-02-18,155,58,97,1,57,1,0,-3.608571428570883
2021-02-19,147,58,89,1,57,1,0,-2.0142857142862454
2021-02-21,16,0,16,0,0,0,0,0.0
2021-02-22,250,150,100,0,150,0,0,0.0
2021-02-23,152,56,96,1,55,1,0,-3.4428571428567807
2021-02-24,225,112,113,0,112,0,0,0.0
2021-02-25,168,56,112,1,55,1,0,-2.98571428571438
2021-02-26,234,148,86,0,148,0,0,0.0
2021-02-28,7,0,7,0,0,0,0,0.0
2021-03-01,243,151,92,0,151,0,0,0.0
2021-03-02,165,58,107,1,57,1,1,3.048571428571279
2021-03-03,182,67,115,1,66,1,1,2.705714285714123
2021-03-04,234,125,109,1,124,1,1,2.885714285714414
2021-03-05,146,57,89,1,56,1,1,7.797142857142603
2021-03-07,13,0,13,0,0,0,0,0.0
2021-03-08,241,151,90,0,151,0,0,0.0
2021-03-09,167,53,114,1,52,1,0,-2.3428571428572127
2021-03-10,142,31,111,1,30,1,0,-5.031428571428364
2021-03-11,233,128,105,0,128,0,0,0.0
2021-03-12,149,53,96,0,53,0,0,0.0
2021-03-14,22,4,18,0,4,0,0,0.0
2021-03-15,216,123,93,0,123,0,0,0.0
2021-03-16,151,51,100,1,50,1,0,-4.408571428571861
2021-03-17,231,116,115,1,115,1,1,8.337142857143476
2021-03-18,259,150,109,0,150,0,0,0.0
2021-03-19,166,70,96,0,70,0,0,0.0
2021-03-21,22,12,10,0,12,0,0,0.0
2021-03-22,111,78,33,0,78,0,0,0.0
2021-03-23,163,54,109,1,53,1,1,2.5685714285709764
2021-03-24,179,72,107,1,71,1,1,3.4685714285710105
2021-03-25,158,43,115,1,42,1,0,-1.9485714285711992
2021-03-26,150,54,96,1,53,1,0,-2.339999999999975
2021-03-28,16,0,16,0,0,0,0,0.0
2021-03-29,252,154,98,0,154,0,0,0.0
2021-03-30,226,113,113,0,113,0,0,0.0
2021-03-31,156,40,116,1,39,1,0,-2.377142857142644
2021-04-01,246,150,96,0,150,0,0,0.0
2021-04-02,149,58,91,0,58,0,0,0.0
2021-04-04,20,0,20,0,0,0,0,0.0
2021-04-05,203,127,76,0,127,0,0,0.0
2021-04-06,165,58,107,1,57,1,0,-3.705714285714123
2021-04-07,131,25,106,1,24,1,1,3.845714285715019
2021-04-08,164,52,112,1,51,1,0,-3.988571428572129
2021-04-09,219,148,71,0,148,0,0,0.0
2021-04-11,30,11,19,0,11,0,0,0.0
2021-04-12,263,157,106,0,157,0,0,0.0
2021-04-13,160,45,115,1,44,1,0,-4.414285714284915
2021-04-14,149,46,103,1,45,1,0,-3.8628571428565124
2021-04-15,175,59,116,1,58,1,0,-4.177142857142712
2021-04-16,234,138,96,0,138,0,0,0.0
2021-04-18,29,12,17,0,12,0,0,0.0
2021-04-19,156,49,107,0,49,0,0,0.0
2021-04-20,261,148,113,0,148,0,0,0.0
2021-04-21,266,150,116,0,150,0,0,0.0
2021-04-22,170,57,113,1,56,1,0,-3.3685714285714425
2021-04-23,121,44,77,1,43,1,1,5.979999999999109
2021-04-25,17,0,17,0,0,0,0,0.0
2021-04-26,171,56,115,1,55,1,1,4.317142857142187
2021-04-27,264,150,114,0,150,0,0,0.0
2021-04-28,172,55,117,1,54,1,1,3.425714285713866
2021-04-29,166,53,113,1,52,1,0,-3.477142857142212
2021-04-30,236,140,96,0,140,0,0,0.0
2021-05-02,13,12,1,0,12,0,0,0.0
2021-05-03,165,56,109,1,55,1,0,-4.088571428571186
2021-05-04,168,60,108,1,59,1,1,4.4457142857136205
2021-05-05,162,53,109,1,52,1,1,4.754285714285345
2021-05-06,175,65,110,1,64,1,1,5.002857142856499
2021-05-07,130,39,91,1,38,1,0,-7.822857142857231
2021-05-09,1,0,1,0,0,0,0,0.0
2021-05-10,236,121,115,0,121,0,0,0.0
2021-05-11,167,59,108,1,58,1,0,-3.8914285714288894
2021-05-12,166,56,110,1,55,1,0,-4.617142857143108
2021-05-13,116,25,91,1,24,1,0,-4.66285714285749
2021-05-14,123,27,96,1,26,1,0,-2.919999999999334
2021-05-16,20,0,20,0,0,0,0,0.0
2021-05-17,176,103,73,0,103,0,0,0.0
2021-05-18,209,109,100,0,109,0,0,0.0
2021-05-19,167,53,114,1,52,1,0,-5.637142857142862
2021-05-20,258,142,116,0,142,0,0,0.0
2021-05-21,217,122,95,0,122,0,0,0.0
2021-05-23,17,12,5,0,12,0,0,0.0
2021-05-24,242,158,84,0,158,0,0,0.0
2021-05-25,243,138,105,0,138,0,0,0.0
2021-05-26,245,150,95,0,150,0,0,0.0
2021-05-27,272,160,112,0,160,0,0,0.0
2021-05-28,225,130,95,0,130,0,0,0.0
2021-05-30,24,12,12,0,12,0,0,0.0
2021-05-31,255,140,115,0,140,0,0,0.0
2021-06-01,140,38,102,1,37,1,1,5.011428571428212
2021-06-02,272,156,116,0,156,0,0,0.0
2021-06-03,178,67,111,1,66,1,1,4.154285714285322
2021-06-04,144,48,96,1,47,1,1,9.605714285714384
2021-06-06,18,0,18,0,0,0,0,0.0
2021-06-07,116,42,74,0,42,0,0,0.0
2021-06-08,154,49,105,1,48,1,0,-3.9114285714281323
2021-06-09,156,56,100,1,55,1,1,3.8028571428564533
2021-06-10,166,55,111,1,54,1,0,-3.3028571428563964
2021-06-11,235,143,92,0,143,0,0,0.0
2021-06-13,3,0,3,0,0,0,0,0.0
2021-06-14,230,142,88,0,142,0,0,0.0
2021-06-15,181,83,98,0,83,0,0,0.0
2021-06-16,192,93,99,1,92,1,1,5.165714285714785
2021-06-17,263,156,107,0,156,0,0,0.0
2021-06-18,154,60,94,1,59,1,1,4.428571428571615
2021-06-20,2,0,2,0,0,0,0,0.0
2021-06-21,171,64,107,1,63,1,0,-3.0171428571439947
2021-06-22,152,51,101,1,50,1,0,-3.8542857142862204
2021-06-23,160,57,103,1,56,1,1,3.580000000000439
2021-06-24,253,152,101,0,152,0,0,0.0
2021-06-25,135,46,89,1,45,1,1,3.8399999999991223
2021-06-27,0,0,0,0,0,0,0,0.0
2021-06-28,154,60,94,1,59,1,1,2.9114285714281323
2021-06-29,151,50,101,1,49,1,0,-3.5371428571427828
2021-06-30,155,50,105,1,49,1,0,-2.282857142856642
2021-07-01,154,60,94,1,59,1,1,3.2114285714281436
2021-07-02,139,43,96,1,42,1,0,-6.011428571428212
2021-07-04,21,0,21,0,0,0,0,0.0
2021-07-05,212,121,91,0,121,0,0,0.0
2021-07-06,255,145,110,0,145,0,0,0.0
2021-07-07,161,51,110,1,50,1,0,-3.9857142857148915
2021-07-08,153,39,114,1,38,1,0,-4.44571428571453
2021-07-09,153,57,96,1,56,1,1,4.017142857143597
2021-07-11,16,0,16,0,0,0,0,0.0
2021-07-12,215,159,56,0,159,0,0,0.0
2021-07-13,162,47,115,1,46,1,0,-4.537142857141873
2021-07-14,154,38,116,1,37,1,0,-4.511428571428155
2021-07-15,226,114,112,0,114,0,0,0.0
2021-07-16,145,49,96,1,48,1,0,-4.1200000000008
2021-07-18,14,0,14,0,0,0,0,0.0
2021-07-19,214,101,113,0,101,0,0,0.0
2021-07-20,262,155,107,0,155,0,0,0.0
2021-07-21,161,60,101,0,60,0,0,0.0
2021-07-22,134,30,104,1,29,1,1,4.91714285714221
2021-07-23,236,145,91,0,145,0,0,0.0
2021-07-25,13,9,4,0,9,0,0,0.0
2021-07-26,177,69,108,0,69,0,0,0.0
2021-07-27,148,34,114,1,33,1,1,0.0969341745355905
2021-07-28,207,93,114,1,92,1,1,8.337142857143476
2021-07-29,132,20,112,1,19,1,0,-3.0285714285715244
2021-07-30,201,105,96,0,105,0,0,0.0
2021-08-01,16,12,4,0,12,0,0,0.0
2021-08-02,189,155,34,0,155,0,0,0.0
2021-08-03,180,66,114,1,65,1,0,-3.517142857142119
2021-08-04,133,51,82,1,50,1,1,5.38857142857222
2021-08-05,261,157,104,0,157,0,0,0.0
2021-08-06,156,62,94,1,61,1,0,-4.805714285713691
2021-08-08,13,0,13,0,0,0,0,0.0
2021-08-09,233,140,93,0,140,0,0,0.0
2021-08-10,222,151,71,0,151,0,0,0.0
2021-08-11,160,51,109,1,50,1,0,-3.5199999999993565
2021-08-12,247,138,109,0,138,0,0,0.0
2021-08-13,205,122,83,0,122,0,0,0.0
2021-08-15,28,12,16,0,12,0,0,0.0
2021-08-16,181,69,112,0,69,0,0,0.0
2021-08-17,157,56,101,1,55,1,0,-4.8485714285708355
2021-08-18,212,122,90,0,122,0,0,0.0
2021-08-19,184,81,103,0,81,0,0,0.0
2021-08-20,155,66,89,0,66,0,0,0.0
2021-08-22,32,12,20,0,12,0,0,0.0
2021-08-23,254,142,112,0,142,0,0,0.0
2021-08-24,183,68,115,1,67,1,1,5.937142857143385
2021-08-25,254,140,114,0,140,0,0,0.0
2021-08-26,245,133,112,0,133,0,0,0.0
2021-08-27,133,37,96,1,36,1,0,0.6854721041459015
2021-08-29,6,0,6,0,0,0,0,0.0
2021-08-30,204,115,89,0,115,0,0,0.0
2021-08-31,173,70,103,1,69,1,1,5.071428571428783
2021-09-01,161,46,115,1,45,1,0,-4.454285714286243
2021-09-02,252,143,109,0,143,0,0,0.0
2021-09-03,150,54,96,1,53,1,0,-5.537142857142385
2021-09-05,4,0,4,0,0,0,0,0.0
2021-09-06,181,76,105,0,76,0,0,0.0
2021-09-07,220,109,111,0,109,0,0,0.0
2021-09-08,192,89,103,0,89,0,0,0.0
2021-09-09,220,103,117,0,103,0,0,0.0
2021-09-10,180,99,81,0,99,0,0,0.0
2021-09-12,15,11,4,0,11,0,0,0.0
2021-09-13,258,144,114,0,144,0,0,0.0
2021-09-14,159,45,114,1,44,1,0,-2.9914285714288553
2021-09-15,213,98,115,0,98,0,0,0.0
2021-09-16,197,88,109,0,88,0,0,0.0
2021-09-17,239,143,96,0,143,0,0,0.0
2021-09-19,16,12,4,0,12,0,0,0.0
2021-09-20,252,144,108,0,144,0,0,0.0
2021-09-21,240,124,116,0,124,0,0,0.0
2021-09-22,224,109,115,1,108,1,1,9.039999999999793
2021-09-23,250,153,97,0,153,0,0,0.0
2021-09-24,212,116,96,0,116,0,0,0.0
2021-09-26,12,12,0,0,12,0,0,0.0
2021-09-27,243,151,92,0,151,0,0,0.0
2021-09-28,165,53,112,1,52,1,0,-4.419999999999391
2021-09-29,255,147,108,0,147,0,0,0.0
2021-09-30,195,80,115,1,79,1,1,6.837142857143419
2021-10-01,146,55,91,1,54,1,0,-5.0285714285711265
2021-10-03,2,0,2,0,0,0,0,0.0
2021-10-04,240,157,83,0,157,0,0,0.0
2021-10-05,271,159,112,0,159,0,0,0.0
2021-10-06,234,122,112,0,122,0,0,0.0
2021-10-07,239,126,113,0,126,0,0,0.0
2021-10-08,152,56,96,1,55,1,0,-4.314285714285859
2021-10-10,18,0,18,0,0,0,0,0.0
2021-10-11,248,135,113,0,135,0,0,0.0
2021-10-12,164,62,102,0,62,0,0,0.0
2021-10-13,137,25,112,1,24,1,1,9.35714285714323
2021-10-14,254,139,115,0,139,0,0,0.0
2021-10-15,174,78,96,1,77,1,1,7.600000000000307
2021-10-17,4,0,4,0,0,0,0,0.0
2021-10-18,190,117,73,0,117,0,0,0.0
2021-10-19,233,116,117,0,116,0,0,0.0
2021-10-20,252,136,116,0,136,0,0,0.0
2021-10-21,164,52,112,1,51,1,0,-3.3028571428578175
2021-10-22,163,67,96,1,66,1,0,1.2200854579073166
2021-10-24,20,0,20,0,0,0,0,0.0
2021-10-25,258,147,111,0,147,0,0,0.0
2021-10-26,225,109,116,0,109,0,0,0.0
2021-10-27,170,57,113,1,56,1,0,-4.937142857142362
2021-10-28,165,55,110,1,54,1,1,6.914285714285995
2021-10-29,165,69,96,1,68,1,1,5.594285714284808
2021-10-31,15,0,15,0,0,0,0,0.0
2021-11-01,240,132,108,0,132,0,0,0.0
2021-11-02,249,137,112,0,137,0,0,0.0
2021-11-03,224,114,110,1,113,1,1,7.1200000000000045
2021-11-04,193,76,117,1,75,1,1,7.07714285714286
2021-11-05,138,42,96,1,41,1,0,-4.328571428572047
2021-11-07,20,0,20,0,0,0,0,0.0
2021-11-08,188,73,115,1,72,1,1,5.825714285713957
2021-11-09,157,44,113,1,43,1,1,3.7514285714290168
2021-11-10,151,57,94,1,56,1,1,5.8685714285711015
2021-11-11,150,44,106,1,43,1,1,3.0314285714278526
2021-11-12,135,39,96,1,38,1,0,-3.5600000000006844
2021-11-14,21,0,21,0,0,0,0,0.0
2021-11-15,247,148,99,0,148,0,0,0.0
2021-11-16,161,47,114,1,46,1,1,4.274285714285043
2021-11-17,172,67,105,1,66,1,1,3.777142857142735
2021-11-18,140,76,64,1,75,1,1,4.651428571429051
2021-11-19,154,46,108,1,45,1,0,-3.9971428571424212
2021-11-21,21,0,21,0,0,0,0,0.0
2021-11-22,129,28,101,1,27,1,1,4.642857142857338
2021-11-23,104,3,101,2,1,2,1,10.599999999999966
2021-11-24,152,59,93,1,58,1,0,-4.142857142857281
2021-11-25,167,117,50,0,117,0,0,0.0
2021-11-26,98,2,96,2,0,2,0,-9.10857142857202
2021-11-28,15,0,15,0,0,0,0,0.0
2021-11-29,177,104,73,0,104,0,0,0.0
2021-11-30,171,56,115,1,55,1,0,-4.717142857143585
2021-12-01,152,43,109,1,42,1,1,5.619999999999948
2021-12-02,151,39,112,1,38,1,0,-4.271428571428714
2021-12-03,132,58,74,1,57,1,1,5.7828571428568125
2021-12-05,14,0,14,0,0,0,0,0.0
2021-12-06,255,142,113,0,142,0,0,0.0
2021-12-07,153,41,112,1,40,1,1,3.1942857142861385
2021-12-08,144,54,90,1,53,1,0,-4.419999999999391
2021-12-09,155,47,108,1,46,1,0,-4.44571428571453
2021-12-10,153,58,95,1,57,1,1,4.5314285714279094
2021-12-12,17,0,17,0,0,0,0,0.0
2021-12-13,255,141,114,0,141,0,0,0.0
2021-12-14,165,59,106,1,58,1,1,4.959999999999354
2021-12-15,161,64,97,1,63,1,1,2.3199999999998226
2021-12-16,163,49,114,1,48,1,1,4.780000000000484
2021-12-17,150,57,93,1,56,1,0,-2.822857142857515
2021-12-19,12,0,12,0,0,0,0,0.0
2021-12-20,178,77,101,1,76,1,0,-4.0142857142858475
2021-12-21,263,156,107,0,156,0,0,0.0
2021-12-22,218,139,79,0,139,0,0,0.0
2021-12-23,176,59,117,1,58,1,0,-2.785714285713425
2021-12-24,220,124,96,0,124,0,0,0.0
2021-12-26,4,0,4,0,0,0,0,0.0
2021-12-27,228,153,75,0,153,0,0,0.0
2021-12-28,164,63,101,1,62,1,1,3.4428571428572923
2021-12-29,166,50,116,1,49,1,1,2.2171428571421075
2021-12-30,145,30,115,1,29,1,1,2.088571428570674
2021-12-31,152,56,96,1,55,1,0,-3.305714285713634
2022-01-02,19,0,19,0,0,0,0,0.0
2022-01-03,269,153,116,0,153,0,0,0.0
2022-01-04,184,68,116,1,67,1,0,-3.07142857143009
2022-01-05,179,62,117,1,61,1,0,-4.480000000001382
2022-01-06,170,53,117,1,52,1,1,5.191428571428503
2022-01-07,157,61,96,1,60,1,0,-4.128571428571092
2022-01-09,6,0,6,0,0,0,0,0.0
2022-01-10,187,80,107,1,79,1,1,4.874285714286486
2022-01-11,172,60,112,1,59,1,1,2.5000000000001137
2022-01-12,154,46,108,1,45,1,0,-3.4257142857147755
2022-01-13,150,53,97,1,52,1,0,-2.614285714286268
2022-01-14,146,50,96,1,49,1,1,4.942857142857349
2022-01-16,20,0,20,0,0,0,0,0.0
2022-01-17,217,110,107,0,110,0,0,0.0
2022-01-18,157,58,99,1,57,1,0,-2.1942857142851153
2022-01-19,171,56,115,1,55,1,0,-3.1685714285719087
2022-01-20,173,64,109,1,63,1,1,4.077142857142746
2022-01-21,143,47,96,1,46,1,0,-2.6676814377471487
2022-01-23,18,0,18,0,0,0,0,0.0
2022-01-24,180,66,114,1,65,1,1,6.5800000000005525
2022-01-25,166,59,107,1,58,1,1,4.137142857143317
2022-01-26,216,115,101,1,114,1,0,-2.703449676648006
2022-01-27,169,58,111,1,57,1,0,-3.7085714285727818
2022-01-28,145,51,94,1,50,1,1,5.011428571428212
2022-01-30,18,0,18,0,0,0,0,0.0
2022-01-31,155,43,112,1,42,1,0,-4.331428571429285
2022-02-01,177,61,116,1,60,1,0,-3.534285714285545
2022-02-02,172,61,111,1,60,1,1,4.574285714285054
2022-02-03,139,51,88,1,50,1,0,-3.4914285714298217
2022-02-04,149,59,90,1,58,1,1,0.6107223102030161
2022-02-06,12,0,12,0,0,0,0,0.0
2022-02-07,241,162,79,0,162,0,0,0.0
2022-02-08,269,155,114,0,155,0,0,0.0
2022-02-09,223,112,111,0,112,0,0,0.0
2022-02-10,171,56,115,1,55,1,1,4.917142857143631
2022-02-11,128,40,88,1,39,1,0,-2.3942857142860703
2022-02-13,19,0,19,0,0,0,0,0.0
2022-02-14,128,58,70,1,57,1,0,-4.831428571430251
2022-02-15,158,51,107,1,50,1,0,-3.6742857142859293
2022-02-16,134,26,108,1,25,1,1,3.2114285714281436
2022-02-17,164,60,104,1,59,1,1,0.4390552800880414
2022-02-18,154,58,96,1,57,1,0,-2.2114285714285415
2022-02-20,18,0,18,0,0,0,0,0.0
2022-02-21,251,140,111,0,140,0,0,0.0
2022-02-22,252,141,111,0,141,0,0,0.0
2022-02-23,145,47,98,1,46,1,1,2.3971428571423985
2022-02-24,145,32,113,1,31,1,0,-4.522857142857106
2022-02-25,234,138,96,0,138,0,0,0.0
2022-02-27,1,0,1,0,0,0,0,0.0
2022-02-28,87,69,18,1,68,1,1,5.208571428571929
2022-03-01,166,57,109,1,56,1,1,4.342857142857326
2022-03-02,157,47,110,1,46,1,0,-2.45428571428522
2022-03-03,143,30,113,1,29,1,0,-3.4171428571430624
2022-03-04,140,45,95,1,44,1,0,-2.4857142857148347
2022-03-06,2,0,2,0,0,0,0,0.0
2022-03-07,121,65,56,1,64,1,0,-3.8600000000006958
2022-03-08,241,135,106,0,135,0,0,0.0
2022-03-09,157,43,114,1,42,1,1,5.045714285713643
2022-03-10,162,53,109,1,52,1,0,-4.1085714285718495
2022-03-11,150,54,96,1,53,1,0,-2.3628571428578766
2022-03-13,21,0,21,0,0,0,0,0.0
2022-03-14,220,105,115,0,105,0,0,0.0
2022-03-15,143,32,111,1,31,1,0,-3.0285714285715244
2022-03-16,144,28,116,1,27,1,0,-1.5182915154445027
2022-03-17,232,147,85,0,147,0,0,0.0
2022-03-18,146,51,95,1,50,1,0,-4.859999999999786
2022-03-20,12,0,12,0,0,0,0,0.0
2022-03-21,162,131,31,0,131,0,0,0.0
2022-03-22,161,50,111,1,49,1,0,-4.211428571428144
2022-03-23,130,33,97,1,32,1,0,-3.6057142857136455
2022-03-24,115,20,95,1,19,1,1,4.488571428572186
2022-03-25,121,25,96,1,24,1,1,7.1200000000000045
2022-03-27,18,0,18,0,0,0,0,0.0
2022-03-28,141,30,111,2,28,2,0,-18.62857142857115
2022-03-29,148,33,115,2,31,2,2,40.46857142857101
2022-03-30,134,29,105,1,28,1,0,-3.8714285714282255
2022-03-31,127,23,104,1,22,1,0,-5.408571428570951
2022-04-01,153,57,96,1,56,1,0,-4.334285714286523
2022-04-03,2,0,2,0,0,0,0,0.0
2022-04-04,180,136,44,0,136,0,0,0.0
2022-04-05,154,46,108,1,45,1,1,8.208571428572043
2022-04-06,194,93,101,1,92,1,1,7.145714285713723
2022-04-07,146,38,108,0,38,0,0,0.0
2022-04-08,118,33,85,1,32,1,1,6.091428571428537
2022-04-10,16,0,16,0,0,0,0,0.0
2022-04-11,172,59,113,1,58,1,0,-4.457142857143481
2022-04-12,129,26,103,1,25,1,0,-7.022857142857674
2022-04-13,136,28,108,1,27,1,0,-3.8428571428572695
2022-04-14,159,43,116,1,42,1,0,-5.571428571429237
2022-04-15,186,90,96,0,90,0,0,0.0
2022-04-17,29,10,19,0,10,0,0,0.0
2022-04-18,242,152,90,0,152,0,0,0.0
2022-04-19,160,56,104,1,55,1,0,-5.105714285713702
2022-04-20,143,54,89,1,53,1,0,-4.088571428571186
2022-04-21,218,128,90,0,128,0,0,0.0
2022-04-22,155,61,94,1,60,1,0,-5.848571428569926
2022-04-24,2,0,2,0,0,0,0,0.0
2022-04-25,239,155,84,0,155,0,0,0.0
2022-04-26,158,55,103,1,54,1,0,-4.922857142857595
2022-04-27,248,141,107,0,141,0,0,0.0
2022-04-28,149,46,103,1,45,1,0,-7.154285714284924
2022-04-29,161,65,96,1,64,1,1,15.220000000001733
2022-05-01,3,0,3,0,0,0,0,0.0
2022-05-02,220,150,70,0,150,0,0,0.0
2022-05-03,231,134,97,0,134,0,0,0.0
2022-05-04,94,37,57,1,36,1,1,6.9228571428591295
2022-05-05,214,140,74,0,140,0,0,0.0
2022-05-06,146,50,96,1,49,1,0,-5.085714285715881
2022-05-08,1,0,1,0,0,0,0,0.0
2022-05-09,161,59,102,1,58,1,1,11.345714285715303
2022-05-10,130,57,73,1,56,1,0,-5.745714285712211
2022-05-11,107,54,53,1,53,1,0,-9.785714285712743
2022-05-12,104,7,97,1,6,1,1,21.96571428571542
2022-05-13,142,52,90,1,51,1,1,9.939999999999827
2022-05-15,12,0,12,0,0,0,0,0.0
2022-05-16,146,49,97,0,49,0,0,0.0
2022-05-17,159,50,109,1,49,1,1,1.9350102406117458
2022-05-18,167,58,109,1,57,1,0,-3.659999999999741
2022-05-19,104,2,102,2,0,2,0,-11.651428571428312
2022-05-20,131,53,78,1,52,1,0,-3.982857142857654
2022-05-22,0,0,0,0,0,0,0,0.0
2022-05-23,208,115,93,0,115,0,0,0.0
2022-05-24,132,29,103,1,28,1,1,2.3868034544657917
2022-05-25,129,16,113,1,15,1,0,-6.045714285713643
2022-05-26,219,105,114,0,105,0,0,0.0
2022-05-27,213,119,94,0,119,0,0,0.0
2022-05-29,27,8,19,0,8,0,0,0.0
2022-05-30,244,131,113,0,131,0,0,0.0
2022-05-31,174,57,117,1,56,1,0,-5.7114285714282005
2022-06-01,150,41,109,1,40,1,0,-5.2085714285714175
2022-06-02,161,54,107,1,53,1,0,-5.419999999998481
2022-06-03,208,133,75,0,133,0,0,0.0
2022-06-05,23,12,11,0,12,0,0,0.0
2022-06-06,270,158,112,0,158,0,0,0.0
2022-06-07,159,42,117,1,41,1,1,10.822857142857856
2022-06-08,171,56,115,1,55,1,0,-5.802857142856965
2022-06-09,150,52,98,1,51,1,0,-5.617142857142198
2022-06-10,151,55,96,1,54,1,0,-9.837142857143022
2022-06-12,9,0,9,0,0,0,0,0.0
2022-06-13,140,37,103,1,36,1,0,-5.982857142857256
2022-06-14,167,54,113,1,53,1,1,13.23142857142966
2022-06-15,225,112,113,1,111,1,0,-7.2942857142838875
2022-06-16,131,22,109,2,20,2,1,21.09714285714597
2022-06-17,189,93,96,1,92,1,0,-7.814285714286939
2022-06-19,20,12,8,0,12,0,0,0.0
2022-06-20,148,57,91,0,57,0,0,0.0
2022-06-21,133,43,90,1,42,1,0,-5.457142857142571
2022-06-22,237,123,114,0,123,0,0,0.0
2022-06-23,194,79,115,0,79,0,0,0.0
2022-06-24,154,58,96,1,57,1,0,-4.837142857144727
2022-06-26,12,0,12,0,0,0,0,0.0
2022-06-27,217,107,110,0,107,0,0,0.0
2022-06-28,182,71,111,0,71,0,0,0.0
2022-06-29,177,74,103,0,74,0,0,0.0
2022-06-30,223,147,76,0,147,0,0,0.0
2022-07-01,178,82,96,0,82,0,0,0.0
2022-07-03,18,0,18,0,0,0,0,0.0
2022-07-04,236,134,102,0,134,0,0,0.0
2022-07-05,197,80,117,0,80,0,0,0.0
2022-07-06,143,30,113,1,29,1,1,2.471868699182778
2022-07-07,156,45,111,1,44,1,0,-5.817142857140311
2022-07-08,138,48,90,1,47,1,0,-8.068571428569726
2022-07-10,21,0,21,0,0,0,0,0.0
2022-07-11,166,56,110,1,55,1,0,-6.085714285712129
2022-07-12,231,122,109,0,122,0,0,0.0
2022-07-13,160,47,113,1,46,1,0,2.3995447374910555
2022-07-14,258,147,111,0,147,0,0,0.0
2022-07-15,130,47,83,1,46,1,0,-5.137142857143317
2022-07-17,15,0,15,0,0,0,0,0.0
2022-07-18,271,156,115,0,156,0,0,0.0
2022-07-19,244,136,108,0,136,0,0,0.0
2022-07-20,252,137,115,0,137,0,0,0.0
2022-07-21,263,153,110,0,153,0,0,0.0
2022-07-22,228,143,85,0,143,0,0,0.0
2022-07-24,32,12,20,0,12,0,0,0.0
2022-07-25,231,132,99,0,132,0,0,0.0
2022-07-26,244,138,106,0,138,0,0,0.0
2022-07-27,256,153,103,0,153,0,0,0.0
2022-07-28,194,91,103,0,91,0,0,0.0
2022-07-29,209,137,72,0,137,0,0,0.0
2022-07-31,27,12,15,0,12,0,0,0.0
2022-08-01,245,131,114,0,131,0,0,0.0
2022-08-02,133,27,106,1,26,1,0,-7.539999999997804
2022-08-03,220,145,75,0,145,0,0,0.0
2022-08-04,258,147,111,0,147,0,0,0.0
2022-08-05,233,140,93,0,140,0,0,0.0
2022-08-07,22,12,10,0,12,0,0,0.0
2022-08-08,194,135,59,0,135,0,0,0.0
2022-08-09,178,73,105,0,73,0,0,0.0
2022-08-10,127,26,101,1,25,1,0,-17.502857142855987
2022-08-11,246,152,94,0,152,0,0,0.0
2022-08-12,225,129,96,0,129,0,0,0.0
2022-08-14,27,11,16,0,11,0,0,0.0
2022-08-15,257,144,113,0,144,0,0,0.0
2022-08-16,256,149,107,0,149,0,0,0.0
2022-08-17,216,112,104,0,112,0,0,0.0
2022-08-18,233,132,101,0,132,0,0,0.0
2022-08-19,186,90,96,0,90,0,0,0.0
2022-08-21,11,0,11,0,0,0,0,0.0
2022-08-22,261,149,112,0,149,0,0,0.0
2022-08-23,168,53,115,1,52,1,1,19.865714285716763
2022-08-24,183,68,115,0,68,0,0,0.0
2022-08-25,213,99,114,0,99,0,0,0.0
2022-08-26,148,52,96,1,51,1,0,-7.554285714283992
2022-08-28,14,0,14,0,0,0,0,0.0
2022-08-29,259,158,101,0,158,0,0,0.0
2022-08-30,222,112,110,0,112,0,0,0.0
2022-08-31,262,155,107,0,155,0,0,0.0
2022-09-01,252,143,109,0,143,0,0,0.0
2022-09-02,229,137,92,0,137,0,0,0.0
2022-09-04,30,12,18,0,12,0,0,0.0
2022-09-05,198,114,84,0,114,0,0,0.0
2022-09-06,260,149,111,0,149,0,0,0.0
2022-09-07,271,154,117,0,154,0,0,0.0
2022-09-08,193,82,111,0,82,0,0,0.0
2022-09-09,140,44,96,1,43,1,0,-6.577142857142803
2022-09-11,14,0,14,0,0,0,0,0.0
2022-09-12,216,122,94,0,122,0,0,0.0
2022-09-13,141,47,94,1,46,1,0,-17.579999999998563
2022-09-14,174,74,100,0,74,0,0,0.0
2022-09-15,192,93,99,0,93,0,0,0.0
2022-09-16,240,149,91,0,149,0,0,0.0
2022-09-18,29,11,18,0,11,0,0,0.0
2022-09-19,234,126,108,0,126,0,0,0.0
2022-09-20,168,58,110,0,58,0,0,0.0
2022-09-21,253,126,127,0,126,0,0,0.0
2022-09-22,203,106,97,1,105,1,0,-21.73428571428576
2022-09-23,234,142,92,0,142,0,0,0.0
2022-09-25,20,12,8,0,12,0,0,0.0
2022-09-26,260,150,110,0,150,0,0,0.0
2022-09-27,243,131,112,0,131,0,0,0.0
2022-09-28,263,153,110,0,153,0,0,0.0
2022-09-29,186,87,99,0,87,0,0,0.0
2022-09-30,214,128,86,0,128,0,0,0.0
2022-10-02,27,11,16,0,11,0,0,0.0
2022-10-03,263,149,114,0,149,0,0,0.0
2022-10-04,266,157,109,0,157,0,0,0.0
2022-10-05,174,95,79,0,95,0,0,0.0
2022-10-06,219,154,65,0,154,0,0,0.0
2022-10-07,180,117,63,0,117,0,0,0.0
2022-10-09,15,6,9,0,6,0,0,0.0
2022-10-10,235,142,93,0,142,0,0,0.0
2022-10-11,220,122,98,0,122,0,0,0.0
2022-10-12,243,128,115,0,128,0,0,0.0
2022-10-13,204,146,58,0,146,0,0,0.0
2022-10-14,238,147,91,0,147,0,0,0.0
2022-10-16,25,12,13,0,12,0,0,0.0
2022-10-17,251,153,98,0,153,0,0,0.0
2022-10-18,256,149,107,0,149,0,0,0.0
2022-10-19,213,147,66,0,147,0,0,0.0
2022-10-20,236,127,109,0,127,0,0,0.0
2022-10-21,161,65,96,1,64,1,1,66.05714285714396
2022-10-23,14,0,14,0,0,0,0,0.0
2022-10-24,197,155,42,0,155,0,0,0.0
2022-10-25,216,136,80,0,136,0,0,0.0
2022-10-26,171,128,43,0,128,0,0,0.0
2022-10-27,177,86,91,0,86,0,0,0.0
2022-10-28,160,83,77,0,83,0,0,0.0
2022-10-30,10,6,4,0,6,0,0,0.0
2022-10-31,230,116,114,0,116,0,0,0.0
2022-11-01,260,151,109,0,151,0,0,0.0
2022-11-02,200,84,116,1,83,1,1,31.61714285714322
2022-11-03,226,124,102,0,124,0,0,0.0
2022-11-04,117,61,56,0,61,0,0,0.0
2022-11-06,0,0,0,0,0,0,0,0.0
2022-11-07,152,84,68,0,84,0,0,0.0
2022-11-08,261,150,111,0,150,0,0,0.0
2022-11-09,231,122,109,0,122,0,0,0.0
2022-11-10,168,52,116,1,51,1,1,22.660000000001446
2022-11-11,253,157,96,0,157,0,0,0.0
2022-11-13,0,0,0,0,0,0,0,0.0
2022-11-14,89,55,34,1,54,1,0,-7.699999999997431
2022-11-15,163,54,109,1,53,1,1,25.92571428571614
2022-11-16,153,39,114,1,38,1,1,21.5799999999997
2022-11-17,162,53,109,1,52,1,0,-7.597142857142558
2022-11-18,133,37,96,1,36,1,0,-6.6771428571404385
2022-11-20,19,0,19,0,0,0,0,0.0
2022-11-21,242,142,100,0,142,0,0,0.0
2022-11-22,263,147,116,0,147,0,0,0.0
2022-11-23,172,64,108,1,63,1,1,13.780000000002246
2022-11-24,263,152,111,0,152,0,0,0.0
2022-11-25,242,149,93,0,149,0,0,0.0
2022-11-27,10,0,10,0,0,0,0,0.0
2022-11-28,149,45,104,1,44,1,0,-5.117142857142653
2022-11-29,159,48,111,1,47,1,1,12.588571428573914
2022-11-30,161,51,110,1,50,1,0,-4.8285714285701715
2022-12-01,165,49,116,1,48,1,0,-8.734285714283374
2022-12-02,157,61,96,1,60,1,1,32.20000000000266
2022-12-04,2,0,2,0,0,0,0,0.0
2022-12-05,223,158,65,0,158,0,0,0.0
2022-12-06,252,146,106,0,146,0,0,0.0
2022-12-07,117,12,105,1,11,1,1,3.192730593550664
2022-12-08,146,38,108,1,37,1,1,9.811428571429815
2022-12-09,145,49,96,1,48,1,0,-5.371428571428282
2022-12-11,17,0,17,0,0,0,0,0.0
2022-12-12,146,34,112,1,33,1,1,9.340000000002647
2022-12-13,169,55,114,1,54,1,0,0.025079626666524746
2022-12-14,167,60,107,1,59,1,0,-5.454285714285334
2022-12-15,179,64,115,1,63,1,0,-7.677142857142371
2022-12-16,134,38,96,1,37,1,1,11.028571428573287
2022-12-18,15,0,15,0,0,0,0,0.0
2022-12-19,195,159,36,0,159,0,0,0.0
2022-12-20,113,2,111,2,0,2,0,-18.14571428571503
2022-12-21,171,71,100,1,70,1,1,17.740000000002965
2022-12-22,155,41,114,1,40,1,1,15.040000000001442
2022-12-23,124,28,96,1,27,1,0,-3.4337269939787802
2022-12-25,11,0,11,0,0,0,0,0.0
2022-12-26,271,159,112,0,159,0,0,0.0
2022-12-27,240,147,93,0,147,0,0,0.0
2022-12-28,178,61,117,1,60,1,1,10.000000000001819
2022-12-29,129,20,109,1,19,1,1,9.125714285715503
2022-12-30,143,47,96,1,46,1,1,7.22285714285772
2023-01-01,8,0,8,0,0,0,0,0.0
2023-01-02,167,127,40,0,127,0,0,0.0
2023-01-03,140,26,114,1,25,1,0,-4.622857142857583
2023-01-04,167,56,111,1,55,1,0,-4.339999999999577
2023-01-05,119,14,105,1,13,1,0,-5.439999999999145
2023-01-06,126,30,96,1,29,1,0,-5.414285714284006
2023-01-08,19,0,19,0,0,0,0,0.0
2023-01-09,151,49,102,1,48,1,0,-4.300000000001091
2023-01-10,119,45,74,1,44,1,1,11.191428571430151
2023-01-11,160,56,104,1,55,1,1,9.074285714288067
2023-01-12,164,49,115,1,48,1,0,1.1770651084755173
2023-01-13,111,26,85,1,25,1,1,2.0357540644705523
2023-01-15,20,0,20,0,0,0,0,0.0
2023-01-16,130,14,116,1,13,1,0,-3.571428571428214
2023-01-17,152,35,117,1,34,1,0,-4.700000000000159
2023-01-18,116,2,114,2,0,2,0,-6.356568173951359
2023-01-19,157,47,110,1,46,1,0,-4.462857142857956
2023-01-20,153,57,96,1,56,1,1,2.418020103962249
2023-01-22,19,0,19,0,0,0,0,0.0
2023-01-23,157,48,109,1,47,1,0,-4.1200000000008
2023-01-24,179,70,109,1,69,1,1,10.83142857142957
2023-01-25,170,59,111,1,58,1,0,-5.448571428570858
2023-01-26,155,43,112,1,42,1,0,2.11763621709008
2023-01-27,116,20,96,1,19,1,0,-5.888571428571254
2023-01-29,8,0,8,0,0,0,0,0.0
2023-01-30,271,157,114,0,157,0,0,0.0
2023-01-31,181,66,115,1,65,1,1,13.137142857143658
2023-02-01,169,58,111,1,57,1,0,-6.228571428571172
2023-02-02,171,61,110,1,60,1,0,-7.12285714285531
2023-02-03,142,52,90,1,51,1,1,13.651428571429392
2023-02-05,7,0,7,0,0,0,0,0.0
2023-02-06,195,153,42,0,153,0,0,0.0
2023-02-07,154,56,98,1,55,1,1,9.38285714285837
2023-02-08,144,51,93,1,50,1,1,8.028571428573173
2023-02-09,149,49,100,1,48,1,0,-3.9828571428562327
2023-02-10,143,49,94,1,48,1,0,-4.097142857142899
2023-02-12,20,0,20,0,0,0,0,0.0
2023-02-13,162,58,104,1,57,1,0,-3.9400000000005093
2023-02-14,147,36,111,1,35,1,0,0.27348611879983764
2023-02-15,144,36,108,1,35,1,1,10.780000000002133
2023-02-16,141,36,105,1,35,1,1,9.151428571430642
2023-02-17,130,34,96,1,33,1,0,-3.7171428571416527
2023-02-19,19,0,19,0,0,0,0,0.0
2023-02-20,217,115,102,0,115,0,0,0.0
2023-02-21,148,41,107,1,40,1,1,11.774285714286748
2023-02-22,157,55,102,1,54,1,0,-5.908571428569076
2023-02-23,144,42,102,1,41,1,1,9.837142857144954
2023-02-24,137,53,84,1,52,1,0,-3.5971428571433535
2023-02-26,19,0,19,0,0,0,0,0.0
2023-02-27,183,77,106,1,76,1,1,7.848571428572882
2023-02-28,143,45,98,1,44,1,0,-4.8285714285701715
2023-03-01,169,53,116,1,52,1,1,1.297130576545669
2023-03-02,150,48,102,1,47,1,0,-3.8057142857131794
2023-03-03,112,55,57,1,54,1,1,6.8371428571448405
2023-03-05,18,0,18,0,0,0,0,0.0
2023-03-06,167,56,111,1,55,1,0,-3.108571428572759
2023-03-07,162,54,108,1,53,1,0,-5.002857142855987
2023-03-08,159,52,107,1,51,1,0,-5.508571428570008
2023-03-09,181,70,111,1,69,1,0,-7.319999999999027
2023-03-10,155,59,96,1,58,1,1,14.311428571428564
2023-03-12,21,0,21,0,0,0,0,0.0
2023-03-13,135,58,77,1,57,1,0,-10.717142857143813
2023-03-14,167,52,115,1,51,1,0,-12.917142857140107
2023-03-15,163,56,107,1,55,1,1,9.466500631946928
2023-03-16,129,17,112,1,16,1,0,-9.734285714285306
2023-03-17,136,40,96,1,39,1,1,16.57428571428693
2023-03-19,18,0,18,0,0,0,0,0.0
2023-03-20,164,81,83,0,81,0,0,0.0
2023-03-21,151,55,96,1,54,1,0,-6.2599999999979445
2023-03-22,137,46,91,1,45,1,1,7.042857142857429
2023-03-23,169,58,111,1,57,1,0,-5.0771428571441675
2023-03-24,138,43,95,1,42,1,0,-5.131428571428842
2023-03-26,4,0,4,0,0,0,0,0.0
2023-03-27,136,75,61,1,74,1,1,7.788571428573732
2023-03-28,170,57,113,1,56,1,0,-5.839999999998213
2023-03-29,166,52,114,1,51,1,0,-4.534285714286057
2023-03-30,165,49,116,1,48,1,0,-6.311428571428223
2023-03-31,139,43,96,1,42,1,0,-6.191428571429924
2023-04-02,3,0,3,0,0,0,0,0.0
2023-04-03,254,152,102,0,152,0,0,0.0
2023-04-04,172,67,105,1,66,1,1,13.368571428571386
2023-04-05,152,55,97,1,54,1,0,-5.922857142858106
2023-04-06,141,42,99,1,41,1,0,-7.619999999997617
2023-04-07,125,50,75,1,49,1,0,-5.9571428571421166
2023-04-09,8,0,8,0,0,0,0,0.0
2023-04-10,243,143,100,0,143,0,0,0.0
2023-04-11,267,152,115,0,152,0,0,0.0
2023-04-12,157,51,106,1,50,1,0,-8.900000000000318
2023-04-13,101,47,54,1,46,1,1,14.302857142859693
2023-04-14,152,57,95,1,56,1,0,-7.071428571427873
2023-04-16,21,0,21,0,0,0,0,0.0
2023-04-17,216,130,86,0,130,0,0,0.0
2023-04-18,238,149,89,0,149,0,0,0.0
2023-04-19,236,140,96,0,140,0,0,0.0
2023-04-20,132,50,82,1,49,1,0,-5.960000000002196
2023-04-21,159,63,96,1,62,1,1,13.162857142858797
2023-04-23,17,0,17,0,0,0,0,0.0
2023-04-24,246,154,92,0,154,0,0,0.0
2023-04-25,199,111,88,0,111,0,0,0.0
2023-04-26,163,48,115,1,47,1,1,10.737142857143567
2023-04-27,140,44,96,1,43,1,0,-6.885714285713107
2023-04-28,142,54,88,1,53,1,0,-6.142857142856883
2023-04-30,11,0,11,0,0,0,0,0.0
2023-05-01,247,139,108,0,139,0,0,0.0
2023-05-02,169,63,106,1,62,1,1,11.285714285716153
2023-05-03,124,26,98,1,25,1,0,-6.282857142855846
2023-05-04,110,66,44,1,65,1,1,17.85142857142955
2023-05-05,150,54,96,1,53,1,0,-7.857142857142662
2023-05-07,18,0,18,0,0,0,0,0.0
2023-05-08,223,133,90,0,133,0,0,0.0
2023-05-09,198,99,99,0,99,0,0,0.0
2023-05-10,138,36,102,1,35,1,0,-7.054285714284447
2023-05-11,155,48,107,1,47,1,0,-7.211428571429678
2023-05-12,131,45,86,1,44,1,1,12.580000000002201
2023-05-14,6,0,6,0,0,0,0,0.0
2023-05-15,162,57,105,1,56,1,0,-4.6114285714286325
2023-05-16,157,44,113,1,43,1,0,-6.508571428569098
2023-05-17,226,129,97,0,129,0,0,0.0
2023-05-18,105,21,84,1,20,1,0,-7.239999999999213
2023-05-19,227,131,96,0,131,0,0,0.0
2023-05-21,33,12,21,0,12,0,0,0.0
2023-05-22,236,145,91,0,145,0,0,0.0
2023-05-23,147,44,103,1,43,1,0,-7.971428571426486
2023-05-24,266,156,110,0,156,0,0,0.0
2023-05-25,248,140,108,0,140,0,0,0.0
2023-05-26,239,145,94,0,145,0,0,0.0
2023-05-28,14,12,2,0,12,0,0,0.0
2023-05-29,265,158,107,0,158,0,0,0.0
2023-05-30,217,122,95,0,122,0,0,0.0
2023-05-31,156,64,92,1,63,1,1,19.608571428571054
2023-06-01,149,43,106,1,42,1,0,-8.248571428570017
2023-06-02,150,57,93,1,56,1,0,-9.422857142854923
2023-06-04,12,0,12,0,0,0,0,0.0
2023-06-05,212,120,92,0,120,0,0,0.0
2023-06-06,160,86,74,0,86,0,0,0.0
2023-06-07,271,157,114,0,157,0,0,0.0
2023-06-08,257,148,109,0,148,0,0,0.0
2023-06-09,220,124,96,0,124,0,0,0.0
2023-06-11,15,6,9,0,6,0,0,0.0
2023-06-12,248,161,87,0,161,0,0,0.0
2023-06-13,132,24,108,1,23,1,1,22.574285714287157
2023-06-14,203,91,112,1,90,1,1,15.314285714287735
2023-06-15,161,48,113,1,47,1,0,-7.094285714285775
2023-06-16,158,63,95,1,62,1,1,13.49714285714424
2023-06-18,12,0,12,0,0,0,0,0.0
2023-06-19,225,154,71,0,154,0,0,0.0
2023-06-20,266,158,108,0,158,0,0,0.0
2023-06-21,187,71,116,1,70,1,0,-6.268571428569658
2023-06-22,241,157,84,0,157,0,0,0.0
2023-06-23,150,60,90,1,59,1,1,12.288571428572482
2023-06-25,13,0,13,0,0,0,0,0.0
2023-06-26,240,131,109,0,131,0,0,0.0
2023-06-27,149,50,99,1,49,1,0,-5.991428571426127
2023-06-28,131,34,97,1,33,1,0,-6.357142857141184
2023-06-29,97,15,82,1,14,1,0,-5.511428571430088
2023-06-30,225,142,83,0,142,0,0,0.0
2023-07-02,24,12,12,0,12,0,0,0.0
2023-07-03,230,130,100,0,130,0,0,0.0
2023-07-04,243,154,89,0,154,0,0,0.0
2023-07-05,240,130,110,0,130,0,0,0.0
2023-07-06,203,89,114,0,89,0,0,0.0
2023-07-07,139,45,94,1,44,1,0,-9.188571428569958
2023-07-09,0,0,0,0,0,0,0,0.0
2023-07-10,245,145,100,0,145,0,0,0.0
2023-07-11,226,115,111,0,115,0,0,0.0
2023-07-12,147,33,114,1,32,1,0,-8.468571428571636
2023-07-13,265,159,106,0,159,0,0,0.0
2023-07-14,217,122,95,0,122,0,0,0.0
2023-07-16,14,11,3,0,11,0,0,0.0
2023-07-17,247,142,105,0,142,0,0,0.0
2023-07-18,146,37,109,1,36,1,0,-9.08000000000061
2023-07-19,223,115,108,0,115,0,0,0.0
2023-07-20,260,151,109,0,151,0,0,0.0
2023-07-21,201,108,93,0,108,0,0,0.0
2023-07-23,23,12,11,0,12,0,0,0.0
2023-07-24,270,155,115,0,155,0,0,0.0
2023-07-25,209,121,88,0,121,0,0,0.0
2023-07-26,254,147,107,0,147,0,0,0.0
2023-07-27,243,149,94,0,149,0,0,0.0
2023-07-28,172,123,49,0,123,0,0,0.0
2023-07-30,33,12,21,0,12,0,0,0.0
2023-07-31,235,129,106,0,129,0,0,0.0
2023-08-01,241,139,102,0,139,0,0,0.0
2023-08-02,247,145,102,0,145,0,0,0.0
2023-08-03,205,99,106,0,99,0,0,0.0
2023-08-04,215,124,91,0,124,0,0,0.0
2023-08-06,26,12,14,0,12,0,0,0.0
2023-08-07,236,130,106,0,130,0,0,0.0
2023-08-08,223,110,113,0,110,0,0,0.0
2023-08-09,260,153,107,0,153,0,0,0.0
2023-08-10,249,135,114,0,135,0,0,0.0
2023-08-11,162,103,59,0,103,0,0,0.0
2023-08-13,25,11,14,0,11,0,0,0.0
2023-08-14,215,143,72,0,143,0,0,0.0
2023-08-15,191,79,112,0,79,0,0,0.0
2023-08-16,234,131,103,0,131,0,0,0.0
2023-08-17,258,142,116,0,142,0,0,0.0
2023-08-18,242,146,96,0,146,0,0,0.0
2023-08-20,30,12,18,0,12,0,0,0.0
2023-08-21,185,121,64,0,121,0,0,0.0
2023-08-22,256,144,112,0,144,0,0,0.0
2023-08-23,258,149,109,0,149,0,0,0.0
2023-08-24,200,91,109,0,91,0,0,0.0
2023-08-25,225,130,95,0,130,0,0,0.0
2023-08-27,32,12,20,0,12,0,0,0.0
2023-08-28,212,103,109,0,103,0,0,0.0
2023-08-29,249,156,93,0,156,0,0,0.0
2023-08-30,245,128,117,0,128,0,0,0.0
2023-08-31,228,128,100,0,128,0,0,0.0
2023-09-01,193,120,73,0,120,0,0,0.0
2023-09-03,27,12,15,0,12,0,0,0.0
2023-09-04,207,124,83,0,124,0,0,0.0
2023-09-05,272,155,117,0,155,0,0,0.0
2023-09-06,254,138,116,0,138,0,0,0.0
2023-09-07,182,68,114,0,68,0,0,0.0
2023-09-08,229,133,96,0,133,0,0,0.0
2023-09-10,21,12,9,0,12,0,0,0.0
2023-09-11,198,118,80,0,118,0,0,0.0
2023-09-12,214,103,111,0,103,0,0,0.0
2023-09-13,184,79,105,0,79,0,0,0.0
2023-09-14,218,117,101,0,117,0,0,0.0
2023-09-15,128,55,73,0,55,0,0,0.0
2023-09-17,33,12,21,0,12,0,0,0.0
2023-09-18,248,143,105,0,143,0,0,0.0
2023-09-19,248,140,108,0,140,0,0,0.0
2023-09-20,265,156,109,0,156,0,0,0.0
2023-09-21,262,154,108,0,154,0,0,0.0
2023-09-22,222,126,96,0,126,0,0,0.0
2023-09-24,28,12,16,0,12,0,0,0.0
2023-09-25,219,156,63,0,156,0,0,0.0
2023-09-26,209,96,113,0,96,0,0,0.0
2023-09-27,230,155,75,0,155,0,0,0.0
2023-09-28,200,97,103,0,97,0,0,0.0
2023-09-29,237,141,96,0,141,0,0,0.0
2023-10-01,29,12,17,0,12,0,0,0.0
2023-10-02,243,135,108,0,135,0,0,0.0
2023-10-03,180,59,121,1,58,1,1,27.05714285714248
2023-10-04,255,140,115,0,140,0,0,0.0
2023-10-05,265,152,113,0,152,0,0,0.0
2023-10-06,189,93,96,0,93,0,0,0.0
2023-10-08,18,12,6,0,12,0,0,0.0
2023-10-09,165,151,14,0,151,0,0,0.0
2023-10-10,246,143,103,0,143,0,0,0.0
2023-10-11,224,124,100,0,124,0,0,0.0
2023-10-12,228,136,92,0,136,0,0,0.0
2023-10-13,190,100,90,0,100,0,0,0.0
2023-10-15,25,11,14,0,11,0,0,0.0
2023-10-16,197,144,53,0,144,0,0,0.0
2023-10-17,145,83,62,0,83,0,0,0.0
2023-10-18,260,152,108,0,152,0,0,0.0
2023-10-19,216,141,75,0,141,0,0,0.0
2023-10-20,245,149,96,0,149,0,0,0.0
2023-10-22,14,12,2,0,12,0,0,0.0
2023-10-23,233,149,84,0,149,0,0,0.0
2023-10-24,240,146,94,0,146,0,0,0.0
2023-10-25,220,150,70,0,150,0,0,0.0
2023-10-26,236,135,101,0,135,0,0,0.0
2023-10-27,239,147,92,0,147,0,0,0.0
2023-10-29,30,12,18,0,12,0,0,0.0
2023-10-30,231,155,76,0,155,0,0,0.0
2023-10-31,263,148,115,0,148,0,0,0.0
2023-11-01,267,150,117,0,150,0,0,0.0
2023-11-02,260,149,111,0,149,0,0,0.0
2023-11-03,172,82,90,0,82,0,0,0.0
2023-11-05,16,0,16,0,0,0,0,0.0
2023-11-06,189,83,106,0,83,0,0,0.0
2023-11-07,232,132,100,0,132,0,0,0.0
2023-11-08,253,151,102,0,151,0,0,0.0
2023-11-09,217,157,60,0,157,0,0,0.0
2023-11-10,248,158,90,0,158,0,0,0.0
2023-11-12,20,0,20,0,0,0,0,0.0
2023-11-13,220,123,97,0,123,0,0,0.0
2023-11-14,128,49,79,1,48,1,1,16.84000000000151
2023-11-15,275,160,115,0,160,0,0,0.0
2023-11-16,243,161,82,0,161,0,0,0.0
2023-11-17,187,158,29,0,158,0,0,0.0
2023-11-19,17,0,17,0,0,0,0,0.0
2023-11-20,198,94,104,0,94,0,0,0.0
2023-11-21,266,150,116,0,150,0,0,0.0
2023-11-22,267,159,108,0,159,0,0,0.0
2023-11-23,213,103,110,0,103,0,0,0.0
2023-11-24,181,107,74,0,107,0,0,0.0
2023-11-26,12,0,12,0,0,0,0,0.0
2023-11-27,209,103,106,0,103,0,0,0.0
2023-11-28,236,128,108,0,128,0,0,0.0
2023-11-29,264,147,117,0,147,0,0,0.0
2023-11-30,179,71,108,1,70,1,1,18.725714285715867
2023-12-01,161,65,96,1,64,1,1,13.625714285714253
2023-12-03,13,0,13,0,0,0,0,0.0
2023-12-04,186,87,99,1,86,1,1,11.345714285715303
2023-12-05,152,69,83,1,68,1,0,1.2461957686833784
2023-12-06,149,56,93,1,55,1,0,-5.885714285714016
2023-12-07,174,57,117,1,56,1,0,-6.319999999997094
2023-12-08,153,57,96,1,56,1,0,-12.97428571428486
2023-12-10,6,0,6,0,0,0,0,0.0
2023-12-11,240,129,111,0,129,0,0,0.0
2023-12-12,163,47,116,1,46,1,0,1.7960947880449112
2023-12-13,221,112,109,1,111,1,1,16.968571428574364
2023-12-14,206,91,115,0,91,0,0,0.0
2023-12-15,148,55,93,1,54,1,0,2.4826923451679477
2023-12-17,18,0,18,0,0,0,0,0.0
2023-12-18,253,144,109,0,144,0,0,0.0
2023-12-19,175,60,115,1,59,1,0,-7.068571428570635
2023-12-20,259,153,106,0,153,0,0,0.0
2023-12-21,250,155,95,0,155,0,0,0.0
2023-12-22,157,67,90,1,66,1,0,-7.748571428570472
2023-12-24,0,0,0,0,0,0,0,0.0
2023-12-25,91,0,91,0,0,0,0,0.0
2023-12-26,222,150,72,0,150,0,0,0.0
2023-12-27,211,95,116,0,95,0,0,0.0
2023-12-28,240,134,106,0,134,0,0,0.0
2023-12-29,240,158,82,0,158,0,0,0.0
2024-01-01,15,0,15,0,0,0,0,0.0
2024-01-02,247,137,110,0,137,0,0,0.0
2024-01-03,172,83,89,1,82,1,1,18.605714285714726
2024-01-04,270,160,110,0,160,0,0,0.0
2024-01-05,151,55,96,1,54,1,1,14.037142857145113
2024-01-07,15,0,15,0,0,0,0,0.0
2024-01-08,201,135,66,0,135,0,0,0.0
2024-01-09,158,43,115,1,42,1,1,10.68571428571613
2024-01-10,153,51,102,1,50,1,1,8.662857142857206
2024-01-11,139,25,114,1,24,1,0,2.621364544279004
2024-01-12,132,36,96,1,35,1,1,9.751428571430665
2024-01-14,16,0,16,0,0,0,0,0.0
2024-01-15,270,153,117,0,153,0,0,0.0
2024-01-16,175,60,115,1,59,1,1,1.368274907462819
2024-01-17,141,44,97,1,43,1,1,0.8257353350326184
2024-01-18,132,36,96,1,35,1,0,-2.9599999999992406
2024-01-19,147,52,95,1,51,1,0,-4.934285714285124
2024-01-21,1,0,1,0,0,0,0,0.0
2024-01-22,128,59,69,1,58,1,0,-5.345714285713143
2024-01-23,138,48,90,1,47,1,0,-3.8457142857145072
2024-01-24,166,59,107,1,58,1,0,-5.422857142855719
2024-01-25,161,53,108,1,52,1,0,-2.2586497531652867
2024-01-26,126,56,70,1,55,1,0,-6.774285714283678
2024-01-28,15,0,15,0,0,0,0,0.0
2024-01-29,238,128,110,0,128,0,0,0.0
2024-01-30,138,29,109,1,28,1,1,11.954285714287039
2024-01-31,170,62,108,1,61,1,1,9.64857142857295
2024-02-01,150,50,100,1,49,1,1,13.120000000000232
2024-02-02,85,52,33,1,51,1,1,12.425714285714207
2024-02-04,18,0,18,0,0,0,0,0.0
2024-02-05,120,34,86,1,33,1,0,-4.617142857140266
2024-02-06,175,62,113,1,61,1,1,1.0926118657830557
2024-02-07,173,68,105,1,67,1,1,1.5096110225267694
2024-02-08,152,43,109,1,42,1,0,-3.4799999999994498
2024-02-09,116,26,90,1,25,1,0,-4.908571428569985
2024-02-11,13,0,13,0,0,0,0,0.0
2024-02-12,216,131,85,0,131,0,0,0.0
2024-02-13,147,41,106,1,40,1,1,2.7419120650757804
2024-02-14,182,69,113,1,68,1,0,-4.2800000000004275
2024-02-15,162,51,111,1,50,1,0,-1.8944220677700514
2024-02-16,143,47,96,1,46,1,1,7.051428571431984
2024-02-18,3,0,3,0,0,0,0,0.0
2024-02-19,211,103,108,0,103,0,0,0.0
2024-02-20,176,64,112,1,63,1,1,5.980000000001951
2024-02-21,225,124,101,1,123,1,1,5.200000000001637
2024-02-22,157,61,96,1,60,1,1,5.011428571429633
2024-02-23,132,59,73,1,58,1,0,-4.01142857142861
2024-02-25,11,0,11,0,0,0,0,0.0
2024-02-26,182,158,24,0,158,0,0,0.0
2024-02-27,160,57,103,1,56,1,0,-4.545714285712165
2024-02-28,160,54,106,1,53,1,0,-4.985714285712561
2024-02-29,166,58,108,1,57,1,1,6.8371428571448405
2024-03-01,148,52,96,1,51,1,0,-4.17999999999995
2024-03-03,15,0,15,0,0,0,0,0.0
2024-03-04,204,102,102,0,102,0,0,0.0
2024-03-05,101,19,82,1,18,1,1,4.9771428571427805
2024-03-06,164,55,109,1,54,1,0,-2.7542857142866524
2024-03-07,160,46,114,1,45,1,0,-3.6228571428556506
2024-03-08,145,57,88,1,56,1,0,-2.286693346883794
2024-03-10,16,0,16,0,0,0,0,0.0
2024-03-11,134,62,72,1,61,1,1,6.022857142857674
2024-03-12,133,32,101,1,31,1,0,-9.968571428573114
2024-03-13,258,160,98,0,160,0,0,0.0
2024-03-14,155,43,112,1,42,1,0,3.496653110479542
2024-03-15,114,21,93,1,20,1,0,-3.194285714287048
2024-03-17,1,0,1,0,0,0,0,0.0
2024-03-18,212,114,98,0,114,0,0,0.0
2024-03-19,257,144,113,0,144,0,0,0.0
2024-03-20,225,109,116,1,108,1,1,7.231428571429433
2024-03-21,164,51,113,1,50,1,0,-3.6742857142859293
2024-03-22,153,57,96,1,56,1,0,-5.619999999999436
2024-03-24,15,0,15,0,0,0,0,0.0
2024-03-25,241,137,104,0,137,0,0,0.0
2024-03-26,222,124,98,0,124,0,0,0.0
2024-03-27,233,131,102,0,131,0,0,0.0
2024-03-28,179,112,67,0,112,0,0,0.0
2024-03-29,202,109,93,0,109,0,0,0.0
2024-03-31,29,12,17,0,12,0,0,0.0
2024-04-01,250,154,96,0,154,0,0,0.0
2024-04-02,225,126,99,0,126,0,0,0.0
2024-04-03,235,153,82,0,153,0,0,0.0
2024-04-04,178,83,95,1,82,1,1,10.120000000000118
2024-04-05,93,16,77,1,15,1,0,-5.0657142857123745
2024-04-07,0,0,0,0,0,0,0,0.0
2024-04-08,210,110,100,0,110,0,0,0.0
2024-04-09,246,149,97,0,149,0,0,0.0
2024-04-10,116,46,70,1,45,1,0,-7.065714285713398
2024-04-11,221,139,82,0,139,0,0,0.0
2024-04-12,122,52,70,1,51,1,0,-4.954285714285788
2024-04-14,20,0,20,0,0,0,0,0.0
2024-04-15,114,16,98,1,15,1,0,-6.711428571427291
2024-04-16,157,59,98,1,58,1,0,1.851697085217097
2024-04-17,225,129,96,0,129,0,0,0.0
2024-04-18,273,159,114,0,159,0,0,0.0
2024-04-19,167,76,91,0,76,0,0,0.0
2024-04-21,7,7,0,0,7,0,0,0.0
2024-04-22,213,153,60,0,153,0,0,0.0
2024-04-23,212,116,96,0,116,0,0,0.0
2024-04-24,242,145,97,0,145,0,0,0.0
2024-04-25,148,47,101,0,47,0,0,0.0
2024-04-26,205,121,84,0,121,0,0,0.0
2024-04-28,2,1,1,1,0,1,1,13.677142857144531
2024-04-29,160,71,89,2,69,2,1,-6.591428571426604
2024-04-30,207,111,96,0,111,0,0,0.0
2024-05-01,137,37,100,1,36,1,1,8.697142857144058
2024-05-02,265,157,108,0,157,0,0,0.0
2024-05-03,153,57,96,1,56,1,0,-10.925714285713639
2024-05-05,20,0,20,0,0,0,0,0.0
2024-05-06,269,155,114,0,155,0,0,0.0
2024-05-07,179,66,113,1,65,1,0,-4.74571428571312
2024-05-08,229,114,115,0,114,0,0,0.0
2024-05-09,159,62,97,1,61,1,1,8.148571428574314
2024-05-10,173,78,95,0,78,0,0,0.0
2024-05-12,21,1,20,0,1,0,0,0.0
2024-05-13,227,115,112,0,115,0,0,0.0
2024-05-14,136,30,106,1,29,1,0,-4.671428571427782
2024-05-15,157,58,99,1,57,1,0,-8.357142857142208
2024-05-16,167,56,111,1,55,1,0,-6.780000000000996
2024-05-17,205,109,96,0,109,0,0,0.0
2024-05-19,33,12,21,0,12,0,0,0.0
2024-05-20,227,115,112,0,115,0,0,0.0
2024-05-21,161,47,114,1,46,1,0,-6.048571428570881
2024-05-22,264,158,106,0,158,0,0,0.0
2024-05-23,137,59,78,1,58,1,0,-1.4242046192014186
2024-05-24,241,146,95,0,146,0,0,0.0
2024-05-26,14,12,2,0,12,0,0,0.0
2024-05-27,230,144,86,0,144,0,0,0.0
2024-05-28,268,158,110,0,158,0,0,0.0
2024-05-29,246,150,96,0,150,0,0,0.0
2024-05-30,226,120,106,0,120,0,0,0.0
2024-05-31,202,125,77,0,125,0,0,0.0
2024-06-02,18,12,6,0,12,0,0,0.0
2024-06-03,138,66,72,1,65,1,1,13.454285714285675
2024-06-04,162,56,106,1,55,1,0,-5.402857142857897
2024-06-05,164,52,112,1,51,1,0,-7.199999999997885
2024-06-06,266,159,107,0,159,0,0,0.0
2024-06-07,130,34,96,1,33,1,0,-8.651428571429165
2024-06-09,14,0,14,0,0,0,0,0.0
2024-06-10,202,96,106,0,96,0,0,0.0
2024-06-11,262,148,114,0,148,0,0,0.0
2024-06-12,169,49,120,1,48,1,0,-10.371428571426577
2024-06-13,241,129,112,0,129,0,0,0.0
2024-06-14,167,71,96,0,71,0,0,0.0
2024-06-16,24,5,19,0,5,0,0,0.0
2024-06-17,180,129,51,0,129,0,0,0.0
2024-06-18,181,93,88,0,93,0,0,0.0
2024-06-19,215,143,72,0,143,0,0,0.0
2024-06-20,239,133,106,0,133,0,0,0.0
2024-06-21,222,140,82,0,140,0,0,0.0
2024-06-23,29,12,17,0,12,0,0,0.0
2024-06-24,219,154,65,0,154,0,0,0.0
2024-06-25,240,131,109,0,131,0,0,0.0
2024-06-26,266,159,107,0,159,0,0,0.0
2024-06-27,260,155,105,0,155,0,0,0.0
2024-06-28,236,141,95,0,141,0,0,0.0
2024-06-30,19,12,7,0,12,0,0,0.0
2024-07-01,220,139,81,0,139,0,0,0.0
2024-07-02,246,134,112,0,134,0,0,0.0
2024-07-03,167,61,106,1,60,1,1,15.537142857143749
2024-07-04,229,126,103,0,126,0,0,0.0
2024-07-05,197,101,96,0,101,0,0,0.0
2024-07-07,17,10,7,0,10,0,0,0.0
2024-07-08,259,154,105,0,154,0,0,0.0
2024-07-09,193,78,115,1,77,1,1,10.900000000000432
2024-07-10,246,144,102,0,144,0,0,0.0
2024-07-11,149,47,102,1,46,1,0,-32.2314285714275
2024-07-12,77,37,40,1,36,1,0,-14.005714285713566
2024-07-14,16,0,16,0,0,0,0,0.0
2024-07-15,204,147,57,0,147,0,0,0.0
2024-07-16,257,157,100,0,157,0,0,0.0
2024-07-17,161,56,105,1,55,1,0,-7.0942857142829325
2024-07-18,251,161,90,0,161,0,0,0.0
2024-07-19,229,134,95,0,134,0,0,0.0
2024-07-21,30,12,18,0,12,0,0,0.0
2024-07-22,233,149,84,0,149,0,0,0.0
2024-07-23,229,118,111,0,118,0,0,0.0
2024-07-24,155,53,102,1,52,1,0,-6.794285714284342
2024-07-25,175,61,114,0,61,0,0,0.0
2024-07-26,166,70,96,0,70,0,0,0.0
2024-07-28,20,4,16,0,4,0,0,0.0
2024-07-29,214,105,109,0,105,0,0,0.0
2024-07-30,216,109,107,0,109,0,0,0.0
2024-07-31,213,106,107,0,106,0,0,0.0
2024-08-01,247,145,102,0,145,0,0,0.0
2024-08-02,113,37,76,1,36,1,0,-19.46571428571292
2024-08-04,9,0,9,0,0,0,0,0.0
2024-08-05,268,155,113,0,155,0,0,0.0
2024-08-06,204,105,99,0,105,0,0,0.0
2024-08-07,254,148,106,0,148,0,0,0.0
2024-08-08,158,70,88,0,70,0,0,0.0
2024-08-09,160,71,89,0,71,0,0,0.0
2024-08-11,28,8,20,0,8,0,0,0.0
2024-08-12,217,135,82,0,135,0,0,0.0
2024-08-13,220,104,116,0,104,0,0,0.0
2024-08-14,172,60,112,1,59,1,1,17.40571428571468
2024-08-15,136,45,91,1,44,1,0,-12.174285714286725
2024-08-16,204,115,89,0,115,0,0,0.0
2024-08-18,33,12,21,0,12,0,0,0.0
2024-08-19,187,81,106,0,81,0,0,0.0
2024-08-20,236,124,112,0,124,0,0,0.0
2024-08-21,241,136,105,0,136,0,0,0.0
2024-08-22,255,149,106,0,149,0,0,0.0
2024-08-23,244,149,95,0,149,0,0,0.0
2024-08-25,30,12,18,0,12,0,0,0.0
2024-08-26,258,150,108,0,150,0,0,0.0
2024-08-27,254,150,104,0,150,0,0,0.0
2024-08-28,247,140,107,0,140,0,0,0.0
2024-08-29,222,127,95,0,127,0,0,0.0
2024-08-30,218,141,77,0,141,0,0,0.0
2024-09-01,31,11,20,0,11,0,0,0.0
2024-09-02,211,141,70,0,141,0,0,0.0
2024-09-03,173,57,116,0,57,0,0,0.0
2024-09-04,235,141,94,0,141,0,0,0.0
2024-09-05,248,147,101,0,147,0,0,0.0
2024-09-06,145,49,96,1,48,1,0,-16.357142857143458
2024-09-08,10,0,10,0,0,0,0,0.0
2024-09-09,242,132,110,0,132,0,0,0.0
2024-09-10,261,158,103,0,158,0,0,0.0
2024-09-11,200,85,115,0,85,0,0,0.0
2024-09-12,231,123,108,0,123,0,0,0.0
2024-09-13,176,80,96,0,80,0,0,0.0
2024-09-15,25,10,15,0,10,0,0,0.0
2024-09-16,257,145,112,0,145,0,0,0.0
2024-09-17,154,47,107,1,46,1,1,19.71142857142877
2024-09-18,239,124,115,0,124,0,0,0.0
2024-09-19,257,140,117,0,140,0,0,0.0
2024-09-20,240,144,96,0,144,0,0,0.0
2024-09-22,21,11,10,0,11,0,0,0.0
2024-09-23,251,147,104,0,147,0,0,0.0
2024-09-24,253,150,103,0,150,0,0,0.0
2024-09-25,249,146,103,0,146,0,0,0.0
2024-09-26,262,146,116,0,146,0,0,0.0
2024-09-27,194,98,96,0,98,0,0,0.0
2024-09-29,28,9,19,0,9,0,0,0.0
2024-09-30,230,152,78,0,152,0,0,0.0
2024-10-01,267,156,111,0,156,0,0,0.0
2024-10-02,172,57,115,1,56,1,0,-5.131428571428842
2024-10-03,245,132,113,0,132,0,0,0.0
2024-10-04,160,64,96,1,63,1,0,-6.971428571430238
2024-10-06,0,0,0,0,0,0,0,0.0
2024-10-07,169,54,115,0,54,0,0,0.0
2024-10-08,263,157,106,0,157,0,0,0.0
2024-10-09,236,148,88,0,148,0,0,0.0
2024-10-10,162,82,80,0,82,0,0,0.0
2024-10-11,180,88,92,0,88,0,0,0.0
2024-10-13,26,9,17,0,9,0,0,0.0
2024-10-14,172,108,64,0,108,0,0,0.0
2024-10-15,223,113,110,0,113,0,0,0.0
2024-10-16,252,144,108,0,144,0,0,0.0
2024-10-17,266,158,108,0,158,0,0,0.0
2024-10-18,244,148,96,0,148,0,0,0.0
2024-10-20,27,12,15,0,12,0,0,0.0
2024-10-21,264,156,108,0,156,0,0,0.0
2024-10-22,220,117,103,0,117,0,0,0.0
2024-10-23,239,136,103,0,136,0,0,0.0
2024-10-24,267,158,109,0,158,0,0,0.0
2024-10-25,187,97,90,0,97,0,0,0.0
2024-10-27,27,12,15,0,12,0,0,0.0
2024-10-28,258,153,105,0,153,0,0,0.0
2024-10-29,184,68,116,1,67,1,1,13.505714285715953
2024-10-30,235,125,110,0,125,0,0,0.0
2024-10-31,270,155,115,0,155,0,0,0.0
2024-11-01,227,131,96,0,131,0,0,0.0
2024-11-03,6,0,6,0,0,0,0,0.0
2024-11-04,264,154,110,0,154,0,0,0.0
2024-11-05,266,154,112,0,154,0,0,0.0
2024-11-06,217,109,108,0,109,0,0,0.0
2024-11-07,234,128,106,0,128,0,0,0.0
2024-11-08,231,143,88,0,143,0,0,0.0
2024-11-10,20,0,20,0,0,0,0,0.0
2024-11-11,169,55,114,0,55,0,0,0.0
2024-11-12,270,160,110,0,160,0,0,0.0
2024-11-13,257,155,102,0,155,0,0,0.0
2024-11-14,241,126,115,0,126,0,0,0.0
2024-11-15,246,150,96,0,150,0,0,0.0
2024-11-17,16,0,16,0,0,0,0,0.0
2024-11-18,248,146,102,0,146,0,0,0.0
2024-11-19,267,159,108,0,159,0,0,0.0
2024-11-20,261,153,108,0,153,0,0,0.0
2024-11-21,181,73,108,1,72,1,1,14.465714285716558
2024-11-22,238,160,78,0,160,0,0,0.0
2024-11-24,4,0,4,0,0,0,0,0.0
2024-11-25,195,111,84,0,111,0,0,0.0
2024-11-26,219,114,105,0,114,0,0,0.0
2024-11-27,251,136,115,0,136,0,0,0.0
2024-11-28,249,137,112,0,137,0,0,0.0
2024-11-29,132,36,96,1,35,1,1,8.002857142858034
2024-12-01,19,0,19,0,0,0,0,0.0
2024-12-02,258,147,111,0,147,0,0,0.0
2024-12-03,171,57,114,1,56,1,1,20.560000000002788
2024-12-04,174,61,113,1,60,1,0,-5.402857142857897
2024-12-05,274,159,115,0,159,0,0,0.0
2024-12-06,160,72,88,1,71,1,1,28.85714285714255
2024-12-08,0,0,0,0,0,0,0,0.0
2024-12-09,197,138,59,0,138,0,0,0.0
2024-12-10,242,129,113,0,129,0,0,0.0
2024-12-11,167,63,104,1,62,1,1,18.828571428573582
2024-12-12,135,51,84,1,50,1,1,13.874285714288249
2024-12-13,256,160,96,0,160,0,0,0.0
2024-12-15,15,0,15,0,0,0,0,0.0
2024-12-16,240,147,93,0,147,0,0,0.0
2024-12-17,163,65,98,1,64,1,1,10.720000000002983
2024-12-18,187,102,85,1,101,1,1,1.7580176688109077
2024-12-19,176,63,113,1,62,1,0,-7.59428571428532
2024-12-20,137,42,95,1,41,1,1,8.46571428571633
2024-12-22,14,0,14,0,0,0,0,0.0
2024-12-23,200,96,104,0,96,0,0,0.0
2024-12-24,219,130,89,0,130,0,0,0.0
2024-12-25,119,0,119,0,0,0,0,0.0
2024-12-26,268,159,109,0,159,0,0,0.0
2024-12-27,167,71,96,1,70,1,1,7.2914285714285825
2024-12-29,15,0,15,0,0,0,0,0.0
2024-12-30,187,74,113,1,73,1,1,10.934285714287284
2024-12-31,148,52,96,1,51,1,0,-4.591428571427969
