date,breakouts,gate_pass,gate_block,ev_pass,ev_reject,fills,wins,pnl_pips
2018-01-01,9,0,9,0,0,0,0,0.0
2018-01-02,156,58,98,47,3,52,50,-29.829676869743988
2018-01-03,56,17,39,6,11,2,1,-3.105936136202287
2018-01-04,115,2,113,2,0,2,1,-8.719219173900171
2018-01-05,99,3,96,2,1,2,1,-5.458817407417195
2018-01-07,12,0,12,0,0,0,0,0.0
2018-01-08,149,61,88,1,60,1,0,-3.8099721149252157
2018-01-09,118,10,108,2,8,2,1,-0.66594700536728
2018-01-10,105,6,99,6,0,2,1,-2.2993005484909155
2018-01-11,104,2,102,2,0,2,2,6.933148236680138
2018-01-12,59,2,57,2,0,2,1,-4.133505368893833
2018-01-14,16,0,16,0,0,0,0,0.0
2018-01-15,201,95,106,6,89,1,0,-7.559455767440879
2018-01-16,123,14,109,6,8,1,0,-4.500965941903826
2018-01-17,124,23,101,3,20,2,1,-9.96665283653025
2018-01-18,101,17,84,12,5,2,1,0.17072857377149253
2018-01-19,91,3,88,3,0,2,0,-12.333693406656867
2018-01-21,12,0,12,0,0,0,0,0.0
2018-01-22,204,94,110,1,93,1,0,-5.8412329318057665
2018-01-23,195,100,95,1,99,1,0,-5.53604940485881
2018-01-24,200,95,105,7,88,1,1,-1.6655539982223004
2018-01-25,109,6,103,3,3,2,2,14.852625915449055
2018-01-26,89,12,77,2,10,2,0,-12.534203386934259
2018-01-28,10,0,10,0,0,0,0,0.0
2018-01-29,188,94,94,1,93,1,0,-6.551686544089942
2018-01-30,223,125,98,1,124,1,1,-0.199955430921833
2018-01-31,160,65,95,2,63,2,1,3.583823069291107
2018-02-01,206,97,109,7,90,1,0,-7.004900703095286
2018-02-02,100,6,94,4,2,2,1,1.5481856801080838
2018-02-04,12,0,12,0,0,0,0,0.0
2018-02-05,175,64,111,3,61,2,1,-1.2137498242908737
2018-02-06,152,42,110,2,40,2,1,-1.6026249053671684
2018-02-07,142,39,103,5,34,2,1,-4.792700031208052
2018-02-08,87,17,70,2,15,2,1,-2.1950820815113543
2018-02-09,171,77,94,2,75,2,2,12.988939940157692
2018-02-11,14,0,14,0,0,0,0,0.0
2018-02-12,120,7,113,7,0,2,2,-0.19010909882540172
2018-02-13,108,2,106,2,0,2,1,-8.713227054321523
2018-02-14,108,2,106,2,0,2,2,0.734359176801842
2018-02-15,113,2,111,2,0,2,0,-11.87995088499478
2018-02-16,96,3,93,2,1,2,0,-11.205457413765023
2018-02-18,17,0,17,0,0,0,0,0.0
2018-02-19,175,75,100,6,69,0,0,0.0
2018-02-20,152,43,109,2,41,1,0,-5.502059393775242
2018-02-21,125,17,108,5,12,2,1,-4.301541677449151
2018-02-22,116,2,114,2,0,2,1,-3.689470302937193
2018-02-23,191,95,96,6,89,1,0,-6.167090101383279
2018-02-25,5,0,5,0,0,0,0,0.0
2018-02-26,152,46,106,1,45,1,1,2.4389007246078704
2018-02-27,91,18,73,2,16,1,0,-6.4086726596613826
2018-02-28,116,11,105,6,5,2,1,-1.270669253525599
2018-03-01,165,58,107,5,53,1,1,2.194005149148677
2018-03-02,93,2,91,2,0,2,1,-1.773203239578078
2018-03-04,6,0,6,0,0,0,0,0.0
2018-03-05,86,56,30,2,54,2,2,0.987848682632833
2018-03-06,165,54,111,2,52,1,0,-7.022708766740457
2018-03-07,189,78,111,10,68,0,0,0.0
2018-03-08,161,55,106,2,53,1,1,2.582119361501512
2018-03-09,125,29,96,2,27,1,0,-6.6076338555224385
2018-03-11,14,0,14,0,0,0,0,0.0
2018-03-12,195,85,110,1,84,0,0,0.0
2018-03-13,162,54,108,4,50,1,0,-7.175515933488122
2018-03-14,242,149,93,3,146,0,0,0.0
2018-03-15,246,141,105,25,116,0,0,0.0
2018-03-16,214,118,96,17,101,0,0,0.0
2018-03-18,20,12,8,0,12,0,0,0.0
2018-03-19,254,144,110,8,136,0,0,0.0
2018-03-20,152,46,106,1,45,1,1,3.9443197140189277
2018-03-21,201,90,111,1,89,1,1,-1.1508726889130807
2018-03-22,116,2,114,2,0,2,0,-10.977779826893656
2018-03-23,167,71,96,2,69,1,0,-5.11225592806923
2018-03-25,20,12,8,0,12,0,0,0.0
2018-03-26,207,106,101,0,106,0,0,0.0
2018-03-27,170,66,104,4,62,1,1,5.346902621698455
2018-03-28,145,41,104,8,33,2,1,-3.8972013654106124
2018-03-29,246,141,105,0,141,0,0,0.0
2018-03-30,164,69,95,0,69,0,0,0.0
2018-04-01,8,6,2,0,6,0,0,0.0
2018-04-02,163,136,27,0,136,0,0,0.0
2018-04-03,198,94,104,0,94,0,0,0.0
2018-04-04,196,118,78,1,117,0,0,0.0
2018-04-05,261,151,110,0,151,0,0,0.0
2018-04-06,127,32,95,1,31,1,0,-6.817483079155971
2018-04-08,7,0,7,0,0,0,0,0.0
2018-04-09,182,121,61,0,121,0,0,0.0
2018-04-10,204,97,107,1,96,1,0,-4.323355685853615
2018-04-11,190,77,113,0,77,0,0,0.0
2018-04-12,192,78,114,0,78,0,0,0.0
2018-04-13,240,144,96,0,144,0,0,0.0
2018-04-15,12,12,0,0,12,0,0,0.0
2018-04-16,231,127,104,0,127,0,0,0.0
2018-04-17,251,144,107,0,144,0,0,0.0
2018-04-18,227,116,111,0,116,0,0,0.0
2018-04-19,228,123,105,0,123,0,0,0.0
2018-04-20,228,133,95,0,133,0,0,0.0
2018-04-22,22,12,10,0,12,0,0,0.0
2018-04-23,257,155,102,0,155,0,0,0.0
2018-04-24,223,124,99,0,124,0,0,0.0
2018-04-25,242,149,93,0,149,0,0,0.0
2018-04-26,248,143,105,0,143,0,0,0.0
2018-04-27,195,101,94,0,101,0,0,0.0
2018-04-29,28,12,16,0,12,0,0,0.0
2018-04-30,182,104,78,0,104,0,0,0.0
2018-05-01,258,145,113,0,145,0,0,0.0
2018-05-02,240,129,111,0,129,0,0,0.0
2018-05-03,263,150,113,0,150,0,0,0.0
2018-05-04,212,118,94,0,118,0,0,0.0
2018-05-06,25,12,13,0,12,0,0,0.0
2018-05-07,256,149,107,0,149,0,0,0.0
2018-05-08,175,89,86,5,84,1,0,2.4981669612887107
2018-05-09,67,57,10,0,57,0,0,0.0
2018-05-10,204,93,111,0,93,0,0,0.0
2018-05-11,224,129,95,0,129,0,0,0.0
2018-05-13,13,12,1,0,12,0,0,0.0
2018-05-14,184,111,73,0,111,0,0,0.0
2018-05-15,246,131,115,0,131,0,0,0.0
2018-05-16,249,144,105,0,144,0,0,0.0
2018-05-17,182,89,93,0,89,0,0,0.0
2018-05-18,215,129,86,0,129,0,0,0.0
2018-05-20,15,12,3,0,12,0,0,0.0
2018-05-21,252,137,115,0,137,0,0,0.0
2018-05-22,184,85,99,0,85,0,0,0.0
2018-05-23,204,105,99,0,105,0,0,0.0
2018-05-24,231,120,111,0,120,0,0,0.0
2018-05-25,182,86,96,0,86,0,0,0.0
2018-05-27,19,12,7,0,12,0,0,0.0
2018-05-28,247,142,105,0,142,0,0,0.0
2018-05-29,246,135,111,10,125,0,0,0.0
2018-05-30,149,41,108,1,40,1,1,6.017444436405469
2018-05-31,148,40,108,1,39,1,0,-5.216913863655297
2018-06-01,230,137,93,0,137,0,0,0.0
2018-06-03,15,12,3,0,12,0,0,0.0
2018-06-04,236,121,115,0,121,0,0,0.0
2018-06-05,212,118,94,0,118,0,0,0.0
2018-06-06,229,135,94,0,135,0,0,0.0
2018-06-07,252,150,102,0,150,0,0,0.0
2018-06-08,209,123,86,0,123,0,0,0.0
2018-06-10,13,12,1,0,12,0,0,0.0
2018-06-11,230,137,93,0,137,0,0,0.0
2018-06-12,219,118,101,0,118,0,0,0.0
2018-06-13,235,138,97,0,138,0,0,0.0
2018-06-14,181,114,67,0,114,0,0,0.0
2018-06-15,203,108,95,0,108,0,0,0.0
2018-06-17,23,12,11,0,12,0,0,0.0
2018-06-18,206,99,107,0,99,0,0,0.0
2018-06-19,253,145,108,0,145,0,0,0.0
2018-06-20,253,140,113,0,140,0,0,0.0
2018-06-21,255,151,104,0,151,0,0,0.0
2018-06-22,199,104,95,0,104,0,0,0.0
2018-06-24,20,12,8,0,12,0,0,0.0
2018-06-25,244,129,115,0,129,0,0,0.0
2018-06-26,230,124,106,0,124,0,0,0.0
2018-06-27,223,121,102,0,121,0,0,0.0
2018-06-28,259,156,103,0,156,0,0,0.0
2018-06-29,207,112,95,0,112,0,0,0.0
2018-07-01,17,8,9,0,8,0,0,0.0
2018-07-02,177,86,91,0,86,0,0,0.0
2018-07-03,249,136,113,0,136,0,0,0.0
2018-07-04,185,85,100,0,85,0,0,0.0
2018-07-05,219,123,96,0,123,0,0,0.0
2018-07-06,170,102,68,0,102,0,0,0.0
2018-07-08,17,12,5,0,12,0,0,0.0
2018-07-09,196,138,58,0,138,0,0,0.0
2018-07-10,244,148,96,0,148,0,0,0.0
2018-07-11,232,156,76,0,156,0,0,0.0
2018-07-12,204,90,114,0,90,0,0,0.0
2018-07-13,230,134,96,0,134,0,0,0.0
2018-07-15,25,12,13,0,12,0,0,0.0
2018-07-16,235,139,96,0,139,0,0,0.0
2018-07-17,258,149,109,0,149,0,0,0.0
2018-07-18,205,122,83,0,122,0,0,0.0
2018-07-19,181,78,103,5,73,1,1,11.138803351900549
2018-07-20,210,117,93,11,106,0,0,0.0
2018-07-22,30,12,18,0,12,0,0,0.0
2018-07-23,259,145,114,0,145,0,0,0.0
2018-07-24,229,139,90,0,139,0,0,0.0
2018-07-25,208,117,91,0,117,0,0,0.0
2018-07-26,253,150,103,0,150,0,0,0.0
2018-07-27,178,82,96,0,82,0,0,0.0
2018-07-29,12,8,4,0,8,0,0,0.0
2018-07-30,210,105,105,0,105,0,0,0.0
2018-07-31,184,74,110,0,74,0,0,0.0
2018-08-01,244,142,102,0,142,0,0,0.0
2018-08-02,253,150,103,0,150,0,0,0.0
2018-08-03,209,122,87,0,122,0,0,0.0
2018-08-05,13,12,1,0,12,0,0,0.0
2018-08-06,227,126,101,0,126,0,0,0.0
2018-08-07,271,157,114,0,157,0,0,0.0
2018-08-08,211,106,105,0,106,0,0,0.0
2018-08-09,258,144,114,0,144,0,0,0.0
2018-08-10,206,110,96,0,110,0,0,0.0
2018-08-12,12,12,0,0,12,0,0,0.0
2018-08-13,228,130,98,1,129,1,1,3.4143480210045434
2018-08-14,194,97,97,3,94,1,0,-5.5148998535439935
2018-08-15,249,128,121,0,128,0,0,0.0
2018-08-16,246,138,108,0,138,0,0,0.0
2018-08-17,203,107,96,0,107,0,0,0.0
2018-08-19,19,12,7,0,12,0,0,0.0
2018-08-20,203,105,98,0,105,0,0,0.0
2018-08-21,253,146,107,0,146,0,0,0.0
2018-08-22,249,155,94,0,155,0,0,0.0
2018-08-23,241,143,98,0,143,0,0,0.0
2018-08-24,180,125,55,0,125,0,0,0.0
2018-08-26,19,12,7,0,12,0,0,0.0
2018-08-27,242,135,107,0,135,0,0,0.0
2018-08-28,242,136,106,0,136,0,0,0.0
2018-08-29,252,151,101,0,151,0,0,0.0
2018-08-30,249,150,99,0,150,0,0,0.0
2018-08-31,177,115,62,0,115,0,0,0.0
2018-09-02,22,12,10,0,12,0,0,0.0
2018-09-03,221,115,106,0,115,0,0,0.0
2018-09-04,231,133,98,0,133,0,0,0.0
2018-09-05,133,58,75,0,58,0,0,0.0
2018-09-06,240,128,112,0,128,0,0,0.0
2018-09-07,214,119,95,3,116,0,0,0.0
2018-09-09,19,2,17,0,2,0,0,0.0
2018-09-10,208,111,97,0,111,0,0,0.0
2018-09-11,258,153,105,0,153,0,0,0.0
2018-09-12,207,107,100,0,107,0,0,0.0
2018-09-13,260,145,115,0,145,0,0,0.0
2018-09-14,166,74,92,0,74,0,0,0.0
2018-09-16,2,0,2,0,0,0,0,0.0
2018-09-17,177,139,38,0,139,0,0,0.0
2018-09-18,240,139,101,0,139,0,0,0.0
2018-09-19,134,43,91,0,43,0,0,0.0
2018-09-20,222,123,99,0,123,0,0,0.0
2018-09-21,207,114,93,0,114,0,0,0.0
2018-09-23,18,12,6,0,12,0,0,0.0
2018-09-24,223,127,96,0,127,0,0,0.0
2018-09-25,254,152,102,0,152,0,0,0.0
2018-09-26,255,132,123,0,132,0,0,0.0
2018-09-27,261,154,107,0,154,0,0,0.0
2018-09-28,213,118,95,0,118,0,0,0.0
2018-09-30,27,12,15,0,12,0,0,0.0
2018-10-01,248,134,114,0,134,0,0,0.0
2018-10-02,238,136,102,0,136,0,0,0.0
2018-10-03,256,150,106,0,150,0,0,0.0
2018-10-04,233,123,110,4,119,0,0,0.0
2018-10-05,202,134,68,2,132,0,0,0.0
2018-10-07,18,12,6,0,12,0,0,0.0
2018-10-08,229,121,108,0,121,0,0,0.0
2018-10-09,227,125,102,0,125,0,0,0.0
2018-10-10,256,156,100,0,156,0,0,0.0
2018-10-11,95,26,69,7,19,2,2,10.171048464429813
2018-10-12,229,134,95,0,134,0,0,0.0
2018-10-14,19,12,7,0,12,0,0,0.0
2018-10-15,225,125,100,0,125,0,0,0.0
2018-10-16,221,109,112,0,109,0,0,0.0
2018-10-17,225,126,99,0,126,0,0,0.0
2018-10-18,181,78,103,4,74,1,1,4.6736699716947205
2018-10-19,223,127,96,9,118,0,0,0.0
2018-10-21,28,12,16,0,12,0,0,0.0
2018-10-22,220,113,107,2,111,0,0,0.0
2018-10-23,163,59,104,1,58,1,0,-6.4733753021068665
2018-10-24,251,147,104,0,147,0,0,0.0
2018-10-25,225,146,79,0,146,0,0,0.0
2018-10-26,150,57,93,5,52,1,1,5.087319995257398
2018-10-28,9,0,9,0,0,0,0,0.0
2018-10-29,191,104,87,10,94,1,0,-7.540162187618444
2018-10-30,234,121,113,0,121,0,0,0.0
2018-10-31,215,107,108,0,107,0,0,0.0
2018-11-01,248,144,104,0,144,0,0,0.0
2018-11-02,220,124,96,0,124,0,0,0.0
2018-11-04,15,0,15,0,0,0,0,0.0
2018-11-05,214,152,62,0,152,0,0,0.0
2018-11-06,250,146,104,0,146,0,0,0.0
2018-11-07,223,131,92,0,131,0,0,0.0
2018-11-08,239,136,103,0,136,0,0,0.0
2018-11-09,209,113,96,0,113,0,0,0.0
2018-11-11,8,0,8,0,0,0,0,0.0
2018-11-12,227,120,107,0,120,0,0,0.0
2018-11-13,234,131,103,0,131,0,0,0.0
2018-11-14,207,102,105,8,94,1,1,5.377670922460706
2018-11-15,226,140,86,21,119,0,0,0.0
2018-11-16,140,56,84,5,51,1,1,4.00603774076735
2018-11-18,14,0,14,0,0,0,0,0.0
2018-11-19,204,119,85,0,119,0,0,0.0
2018-11-20,129,53,76,6,47,1,1,2.6187923816640213
2018-11-21,198,95,103,5,90,0,0,0.0
2018-11-22,144,117,27,0,117,0,0,0.0
2018-11-23,212,134,78,0,134,0,0,0.0
2018-11-25,11,0,11,0,0,0,0,0.0
2018-11-26,245,138,107,0,138,0,0,0.0
2018-11-27,154,53,101,3,50,1,1,1.3622483981997724
2018-11-28,191,84,107,1,83,1,0,-5.600655117954991
2018-11-29,180,84,96,1,83,1,1,1.851215350188177
2018-11-30,112,112,0,0,112,0,0,0.0
2018-12-02,14,0,14,0,0,0,0,0.0
2018-12-03,161,72,89,3,69,1,0,-5.998246310007278
2018-12-04,255,149,106,0,149,0,0,0.0
2018-12-05,266,153,113,0,153,0,0,0.0
2018-12-06,173,61,112,2,59,1,1,2.486693518913428
2018-12-07,117,23,94,1,22,1,1,1.5934318450935123
2018-12-09,14,0,14,0,0,0,0,0.0
2018-12-10,152,46,106,3,43,1,1,0.8416998785705019
2018-12-11,159,49,110,5,44,1,1,0.264329224097545
2018-12-12,132,36,96,7,29,1,1,2.4194984902048002
2018-12-13,111,15,96,3,12,1,1,-1.103221754872299
2018-12-14,129,57,72,4,53,1,1,-1.6592315040004073
2018-12-16,18,0,18,0,0,0,0,0.0
2018-12-17,159,57,102,3,54,1,1,-1.8771451524727905
2018-12-18,163,52,111,1,51,1,0,-6.050649950585486
2018-12-19,166,67,99,3,64,1,1,-0.6322440243664693
2018-12-20,153,59,94,4,55,1,1,-0.33432607707188966
2018-12-21,82,5,77,4,1,2,0,-11.274969471873007
2018-12-23,5,0,5,0,0,0,0,0.0
2018-12-24,34,25,9,1,24,1,0,-4.861631968663227
2018-12-25,117,0,117,0,0,0,0,0.0
2018-12-26,157,80,77,4,76,1,1,0.9978129361523855
2018-12-27,142,30,112,5,25,1,0,-5.7098934689979295
2018-12-28,133,38,95,3,35,1,0,-4.603058820129357
2018-12-30,13,0,13,0,0,0,0,0.0
2018-12-31,149,57,92,12,45,1,1,1.4522374580178534
2019-01-01,16,0,16,0,0,0,0,0.0
2019-01-02,115,5,110,5,0,2,1,-1.848572303708555
2019-01-03,121,10,111,4,6,2,0,-22.066313769920225
2019-01-04,109,13,96,2,11,2,2,14.446553599600163
2019-01-06,11,0,11,0,0,0,0,0.0
2019-01-07,168,80,88,10,70,1,1,2.7618632190301695
2019-01-08,157,49,108,3,46,1,0,-6.464398813638599
2019-01-09,130,27,103,3,24,1,1,1.4433780838021002
2019-01-10,168,63,105,9,54,1,0,-6.262910354290408
2019-01-11,115,30,85,5,25,1,1,1.6595074113319932
2019-01-13,13,0,13,0,0,0,0,0.0
2019-01-14,155,43,112,8,35,1,1,1.2585918890934156
2019-01-15,147,50,97,1,49,1,1,-1.9926786067194562
2019-01-16,149,47,102,6,41,1,0,-6.165390281734414
2019-01-17,128,23,105,1,22,1,1,1.0053019885763952
2019-01-18,141,46,95,3,43,1,0,-4.699765104855331
2019-01-20,8,0,8,0,0,0,0,0.0
2019-01-21,182,80,102,0,80,0,0,0.0
2019-01-22,154,66,88,5,61,1,0,-5.135152013609144
2019-01-23,147,48,99,3,45,1,1,2.011441267189028
2019-01-24,135,48,87,3,45,1,1,1.7184082291466576
2019-01-25,152,57,95,4,53,1,1,1.0523734081369815
2019-01-27,17,0,17,0,0,0,0,0.0
2019-01-28,155,52,103,5,47,1,1,0.8197263769706975
2019-01-29,160,71,89,3,68,1,1,1.9605184215479676
2019-01-30,110,62,48,1,61,1,1,1.170418483362516
2019-01-31,151,51,100,2,49,1,1,-0.4802822096668131
2019-02-01,137,50,87,1,49,1,1,-3.1642142232216113
2019-02-03,18,0,18,0,0,0,0,0.0
2019-02-04,134,29,105,3,26,1,1,-1.1825942915855894
2019-02-05,134,53,81,5,48,1,1,-1.4805458847227682
2019-02-06,165,61,104,6,55,1,0,-5.930559765319073
2019-02-07,123,35,88,1,34,1,0,-4.519792728001483
2019-02-08,118,64,54,5,59,1,0,-5.763326314574378
2019-02-10,8,0,8,0,0,0,0,0.0
2019-02-11,144,59,85,5,54,1,1,0.3662987090255816
2019-02-12,233,133,100,3,130,0,0,0.0
2019-02-13,149,39,110,1,38,1,1,1.0301108185836376
2019-02-14,148,49,99,1,48,1,1,1.145850899826606
2019-02-15,137,53,84,1,52,1,1,-2.7936218811407256
2019-02-17,13,0,13,0,0,0,0,0.0
2019-02-18,236,135,101,0,135,0,0,0.0
2019-02-19,153,58,95,3,55,1,1,-0.9000446137730678
2019-02-20,181,74,107,17,57,1,1,-1.0713679063773007
2019-02-21,115,20,95,2,18,1,0,-4.406817012897882
2019-02-22,148,58,90,2,56,1,1,-0.5954592172244118
2019-02-24,17,0,17,0,0,0,0,0.0
2019-02-25,133,64,69,8,56,1,1,-0.46221214200898864
2019-02-26,154,57,97,2,55,1,1,-1.0993011118741958
2019-02-27,135,54,81,1,53,1,1,-0.10540673922044252
2019-02-28,144,31,113,1,30,1,1,-1.5362841627778145
2019-03-01,122,26,96,1,25,1,0,-4.797057292972221
2019-03-03,19,0,19,0,0,0,0,0.0
2019-03-04,153,57,96,6,51,1,0,-5.062902159854218
2019-03-05,164,58,106,1,57,1,1,-1.5257691262584925
2019-03-06,141,42,99,1,41,1,0,-5.2206830856410935
2019-03-07,149,60,89,4,56,1,0,-5.561299054967029
2019-03-08,138,43,95,1,42,1,1,-2.0579594555033096
2019-03-10,13,0,13,0,0,0,0,0.0
2019-03-11,110,48,62,1,47,1,0,-5.579220720644873
2019-03-12,136,44,92,1,43,1,0,-3.9871777516955342
2019-03-13,208,97,111,7,90,1,1,1.0651872167831842
2019-03-14,147,33,114,5,28,1,1,0.6445666947955488
2019-03-15,119,30,89,1,29,1,1,-1.3435136107262806
2019-03-17,11,0,11,0,0,0,0,0.0
2019-03-18,181,68,113,3,65,1,1,0.18315542397346607
2019-03-19,148,33,115,1,32,1,0,-3.9778607876510823
2019-03-20,193,82,111,6,76,1,1,0.4552375374951505
2019-03-21,155,55,100,1,54,1,0,-5.6602805939066565
2019-03-22,148,56,92,2,54,1,0,-5.636835638275893
2019-03-24,13,0,13,0,0,0,0,0.0
2019-03-25,102,18,84,6,12,2,1,-2.0528380741407117
2019-03-26,140,50,90,9,41,1,0,-4.433335625779939
2019-03-27,64,49,15,1,48,1,0,-4.635935620259973
2019-03-28,107,2,105,2,0,2,1,-4.694469715536016
2019-03-29,106,11,95,4,7,1,1,3.472468232283404
2019-03-31,6,0,6,0,0,0,0,0.0
2019-04-01,154,47,107,1,46,1,1,2.5998338737466384
2019-04-02,188,116,72,0,116,0,0,0.0
2019-04-03,155,46,109,6,40,1,0,-5.719614565314326
2019-04-04,237,128,109,0,128,0,0,0.0
2019-04-05,119,23,96,1,22,1,0,-5.269412978615551
2019-04-07,12,0,12,0,0,0,0,0.0
2019-04-08,247,132,115,0,132,0,0,0.0
2019-04-09,251,141,110,0,141,0,0,0.0
2019-04-10,137,43,94,1,42,1,1,4.059151907631378
2019-04-11,237,128,109,0,128,0,0,0.0
2019-04-12,216,120,96,0,120,0,0,0.0
2019-04-14,31,12,19,0,12,0,0,0.0
2019-04-15,162,64,98,0,64,0,0,0.0
2019-04-16,148,64,84,0,64,0,0,0.0
2019-04-17,225,119,106,0,119,0,0,0.0
2019-04-18,196,99,97,0,99,0,0,0.0
2019-04-19,136,49,87,0,49,0,0,0.0
2019-04-21,27,12,15,0,12,0,0,0.0
2019-04-22,134,50,84,0,50,0,0,0.0
2019-04-23,242,133,109,0,133,0,0,0.0
2019-04-24,217,115,102,2,113,1,1,2.4111400334281186
2019-04-25,156,48,108,7,41,1,1,2.0309683764509963
2019-04-26,144,48,96,1,47,1,1,5.966064474178575
2019-04-28,11,0,11,0,0,0,0,0.0
2019-04-29,220,118,102,0,118,0,0,0.0
2019-04-30,157,52,105,7,45,1,0,-4.457533080328
2019-05-01,169,68,101,3,65,1,1,1.4258739771277498
2019-05-02,230,124,106,3,121,0,0,0.0
2019-05-03,127,36,91,1,35,1,0,-5.1496511914376875
2019-05-05,15,0,15,0,0,0,0,0.0
2019-05-06,199,109,90,2,107,1,1,1.4176020425626468
2019-05-07,128,53,75,4,49,1,1,1.1194968883689924
2019-05-08,150,51,99,1,50,1,0,-5.491400203036164
2019-05-09,166,58,108,3,55,1,1,1.1410705855997276
2019-05-10,153,58,95,6,52,1,1,0.7714657101118787
2019-05-12,5,0,5,0,0,0,0,0.0
2019-05-13,89,36,53,2,34,2,1,-1.3232990476361621
2019-05-14,256,145,111,16,129,0,0,0.0
2019-05-15,160,53,107,1,52,1,0,-6.669640728190307
2019-05-16,263,157,106,16,141,0,0,0.0
2019-05-17,146,50,96,8,42,1,1,1.827550497913607
2019-05-19,10,0,10,0,0,0,0,0.0
2019-05-20,173,62,111,6,56,1,0,-4.693961914564397
2019-05-21,233,123,110,3,120,0,0,0.0
2019-05-22,230,137,93,5,132,0,0,0.0
2019-05-23,160,58,102,4,54,1,1,1.4484623376590247
2019-05-24,157,62,95,4,58,1,1,1.793774392642069
2019-05-26,19,0,19,0,0,0,0,0.0
2019-05-27,255,140,115,0,140,0,0,0.0
2019-05-28,124,34,90,11,23,1,1,1.261943820219441
2019-05-29,132,35,97,2,33,1,1,-2.3268640233481257
2019-05-30,156,48,108,6,42,1,1,0.6666107313681482
2019-05-31,128,32,96,1,31,1,0,-4.721490897456006
2019-06-02,6,0,6,0,0,0,0,0.0
2019-06-03,131,54,77,5,49,1,1,1.8432429574628522
2019-06-04,131,46,85,1,45,1,0,-4.474056337024676
2019-06-05,144,54,90,1,53,1,0,-6.282670369267304
2019-06-06,147,63,84,1,62,1,0,-5.955812917427302
2019-06-07,134,38,96,2,36,2,1,-3.191292917305027
2019-06-09,3,0,3,0,0,0,0,0.0
2019-06-10,169,98,71,1,97,1,0,-5.9644915856919845
2019-06-11,253,154,99,0,154,0,0,0.0
2019-06-12,140,37,103,2,35,1,0,-5.620749607222018
2019-06-13,259,152,107,0,152,0,0,0.0
2019-06-14,135,39,96,1,38,1,0,-6.687454234504794
2019-06-16,6,0,6,0,0,0,0,0.0
2019-06-17,229,123,106,0,123,0,0,0.0
2019-06-18,120,11,109,1,10,1,1,4.066304391718202
2019-06-19,191,90,101,1,89,1,1,3.254341403415266
2019-06-20,248,146,102,2,144,0,0,0.0
2019-06-21,128,50,78,2,48,1,1,2.5003286235769715
2019-06-23,18,0,18,0,0,0,0,0.0
2019-06-24,242,146,96,1,145,0,0,0.0
2019-06-25,179,86,93,15,71,1,1,1.8088427064450414
2019-06-26,188,85,103,3,82,1,1,1.6859646482045247
2019-06-27,263,154,109,5,149,0,0,0.0
2019-06-28,219,123,96,19,104,0,0,0.0
2019-06-30,18,1,17,1,0,1,1,1.5807931248351714
2019-07-01,157,117,40,0,117,0,0,0.0
2019-07-02,87,57,30,8,49,1,1,0.9499978828298103
2019-07-03,177,63,114,5,58,1,1,0.18140345987159812
2019-07-04,164,68,96,0,68,0,0,0.0
2019-07-05,125,29,96,1,28,1,0,-5.262445733727466
2019-07-07,0,0,0,0,0,0,0,0.0
2019-07-08,243,156,87,0,156,0,0,0.0
2019-07-09,198,90,108,0,90,0,0,0.0
2019-07-10,149,37,112,1,36,1,0,-5.853730764387517
2019-07-11,154,47,107,1,46,1,1,4.686059648664852
2019-07-12,215,119,96,10,109,0,0,0.0
2019-07-14,19,12,7,1,11,0,0,0.0
2019-07-15,194,103,91,0,103,0,0,0.0
2019-07-16,161,56,105,1,55,1,0,-5.366714425350751
2019-07-17,215,120,95,0,120,0,0,0.0
2019-07-18,195,99,96,6,93,1,1,1.8285310377493913
2019-07-19,102,72,30,6,66,1,1,1.122566417289785
2019-07-21,16,0,16,0,0,0,0,0.0
2019-07-22,195,91,104,0,91,0,0,0.0
2019-07-23,241,132,109,9,123,0,0,0.0
2019-07-24,239,134,105,0,134,0,0,0.0
2019-07-25,96,15,81,1,14,1,0,-5.195247131084203
2019-07-26,105,31,74,3,28,1,0,-6.156468762245323
2019-07-28,6,0,6,0,0,0,0,0.0
2019-07-29,232,140,92,0,140,0,0,0.0
2019-07-30,236,135,101,0,135,0,0,0.0
2019-07-31,167,61,106,1,60,1,1,-1.3568382023230874
2019-08-01,164,53,111,1,52,1,0,-5.065847484506887
2019-08-02,98,3,95,2,1,2,1,6.63610165049499
2019-08-04,7,0,7,0,0,0,0,0.0
2019-08-05,153,53,100,1,52,1,0,-4.806317524878446
2019-08-06,131,26,105,1,25,1,0,-5.103758273531371
2019-08-07,136,32,104,1,31,1,0,-6.426875631464087
2019-08-08,90,41,49,2,39,1,0,-6.448661361354901
2019-08-09,160,67,93,5,62,1,0,-3.8255228461348634
2019-08-11,15,0,15,0,0,0,0,0.0
2019-08-12,256,148,108,3,145,0,0,0.0
2019-08-13,162,48,114,2,46,1,1,8.275928408804573
2019-08-14,158,45,113,1,44,1,0,-7.4332319485834635
2019-08-15,115,11,104,4,7,2,1,-4.430570181435973
2019-08-16,113,32,81,3,29,1,1,2.8037062980263032
2019-08-18,16,1,15,0,1,0,0,0.0
2019-08-19,99,71,28,0,71,0,0,0.0
2019-08-20,177,101,76,3,98,0,0,0.0
2019-08-21,252,145,107,0,145,0,0,0.0
2019-08-22,253,148,105,0,148,0,0,0.0
2019-08-23,152,48,104,1,47,1,1,6.646846526876032
2019-08-25,10,0,10,0,0,0,0,0.0
2019-08-26,154,50,104,1,49,1,1,5.4956664558257575
2019-08-27,196,91,105,1,90,1,1,-2.664924973847093
2019-08-28,124,19,105,3,16,2,2,-0.2583113534744772
2019-08-29,263,156,107,5,151,1,1,-0.22285784467020386
2019-08-30,226,131,95,0,131,0,0,0.0
2019-09-01,13,12,1,0,12,0,0,0.0
2019-09-02,236,150,86,0,150,0,0,0.0
2019-09-03,146,37,109,2,35,1,1,4.9797689568384245
2019-09-04,189,95,94,0,95,0,0,0.0
2019-09-05,171,60,111,3,57,1,1,3.798703694596832
2019-09-06,116,37,79,1,36,1,1,5.589265566697181
2019-09-08,7,0,7,0,0,0,0,0.0
2019-09-09,174,129,45,0,129,0,0,0.0
2019-09-10,238,134,104,6,128,0,0,0.0
2019-09-11,220,115,105,0,115,0,0,0.0
2019-09-12,144,35,109,1,34,1,0,-6.037115235143964
2019-09-13,98,49,49,3,46,0,0,0.0
2019-09-15,1,1,0,1,0,1,1,2.971956200826198
2019-09-16,176,150,26,4,146,1,0,-4.34673108343038
2019-09-17,116,18,98,2,16,1,0,-7.071043011256221
2019-09-18,220,106,114,0,106,0,0,0.0
2019-09-19,245,143,102,0,143,0,0,0.0
2019-09-20,218,122,96,1,121,0,0,0.0
2019-09-22,18,12,6,0,12,0,0,0.0
2019-09-23,80,48,32,1,47,1,1,0.49128665284691353
2019-09-24,211,103,108,16,87,1,1,4.018488273742249
2019-09-25,115,11,104,5,6,2,1,-4.403304165440183
2019-09-26,156,49,107,3,46,1,1,3.693854165207433
2019-09-27,160,67,93,9,58,1,0,-6.659465406681922
2019-09-29,17,0,17,0,0,0,0,0.0
2019-09-30,218,145,73,6,139,0,0,0.0
2019-10-01,134,39,95,1,38,1,0,-7.217476129744399
2019-10-02,160,60,100,7,53,1,1,1.5899420331587901
2019-10-03,158,57,101,1,56,1,1,-2.9940705538660635
2019-10-04,142,42,100,1,41,1,0,-6.416660722513955
2019-10-06,14,0,14,0,0,0,0,0.0
2019-10-07,176,90,86,6,84,1,1,3.507273491059755
2019-10-08,167,53,114,7,46,1,0,-5.859683962568663
2019-10-09,221,116,105,5,111,1,1,0.39228414538531586
2019-10-10,186,101,85,4,97,1,1,-0.24465073676964266
2019-10-11,196,106,90,25,81,2,2,3.1722067639982923
2019-10-13,16,0,16,0,0,0,0,0.0
2019-10-14,239,134,105,0,134,0,0,0.0
2019-10-15,167,69,98,2,67,1,1,3.7452370760797438
2019-10-16,155,41,114,1,40,1,0,-5.849302961683648
2019-10-17,154,49,105,1,48,1,0,-5.0835132505684495
2019-10-18,162,69,93,0,69,0,0,0.0
2019-10-20,4,4,0,0,4,0,0,0.0
2019-10-21,229,120,109,0,120,0,0,0.0
2019-10-22,255,143,112,5,138,0,0,0.0
2019-10-23,240,134,106,0,134,0,0,0.0
2019-10-24,186,91,95,2,89,0,0,0.0
2019-10-25,232,138,94,0,138,0,0,0.0
2019-10-27,14,12,2,0,12,0,0,0.0
2019-10-28,258,154,104,0,154,0,0,0.0
2019-10-29,172,117,55,0,117,0,0,0.0
2019-10-30,178,100,78,2,98,1,1,2.604579864831111
2019-10-31,214,117,97,3,114,1,1,2.8094552752859014
2019-11-01,119,46,73,1,45,1,1,5.571528618734925
2019-11-03,2,0,2,0,0,0,0,0.0
2019-11-04,155,123,32,3,120,0,0,0.0
2019-11-05,122,26,96,1,25,1,1,-2.4926925131381377
2019-11-06,143,49,94,8,41,1,1,2.6746491813806466
2019-11-07,134,38,96,8,30,2,1,-4.1933008526387825
2019-11-08,158,70,88,1,69,1,1,1.4639058372529878
2019-11-10,17,0,17,0,0,0,0,0.0
2019-11-11,215,123,92,0,123,0,0,0.0
2019-11-12,206,107,99,13,94,1,1,-1.6924490550298739
2019-11-13,157,63,94,1,62,1,1,-0.6083675960946464
2019-11-14,172,85,87,2,83,1,1,1.2737314500710752
2019-11-15,152,56,96,6,50,1,0,-7.331710061086552
2019-11-17,13,0,13,0,0,0,0,0.0
2019-11-18,150,48,102,3,45,1,1,3.1715483266318287
2019-11-19,186,79,107,5,74,1,1,-0.45800349647115857
2019-11-20,109,3,106,3,0,2,1,-3.8060654621686343
2019-11-21,100,42,58,2,40,1,0,-4.577266390978045
2019-11-22,144,74,70,3,71,1,1,-1.2339627192855298
2019-11-24,13,0,13,0,0,0,0,0.0
2019-11-25,204,91,113,0,91,0,0,0.0
2019-11-26,128,26,102,2,24,1,1,-1.674893148605186
2019-11-27,174,66,108,1,65,1,1,-1.4862436535529575
2019-11-28,240,145,95,0,145,0,0,0.0
2019-11-29,156,60,96,6,54,1,1,-2.1080585691658293
2019-12-01,11,0,11,0,0,0,0,0.0
2019-12-02,148,49,99,1,48,1,1,-1.588626231174907
2019-12-03,148,51,97,1,50,1,0,-3.795912608478054
2019-12-04,150,50,100,1,49,1,1,1.2310192173468963
2019-12-05,117,43,74,2,41,1,0,-6.078564002975307
2019-12-06,145,56,89,1,55,1,1,-1.5571808861576548
2019-12-08,14,0,14,0,0,0,0,0.0
2019-12-09,231,134,97,1,133,0,0,0.0
2019-12-10,166,56,110,5,51,1,0,-5.735299603363151
2019-12-11,127,116,11,4,112,1,1,-1.5515335856778334
2019-12-12,124,47,77,2,45,1,0,-5.069950601702596
2019-12-13,99,40,59,1,39,1,0,-4.579037235192998
2019-12-15,17,0,17,0,0,0,0,0.0
2019-12-16,221,108,113,0,108,0,0,0.0
2019-12-17,154,119,35,0,119,0,0,0.0
2019-12-18,132,47,85,9,38,1,0,-5.689132475334899
2019-12-19,195,140,55,0,140,0,0,0.0
2019-12-20,157,137,20,0,137,0,0,0.0
2019-12-22,19,0,19,0,0,0,0,0.0
2019-12-23,178,135,43,0,135,0,0,0.0
2019-12-24,211,129,82,0,129,0,0,0.0
2019-12-25,98,0,98,0,0,0,0,0.0
2019-12-26,240,144,96,0,144,0,0,0.0
2019-12-27,196,104,92,0,104,0,0,0.0
2019-12-29,4,0,4,0,0,0,0,0.0
2019-12-30,155,60,95,3,57,1,1,2.2535943757335932
2019-12-31,143,56,87,1,55,1,1,-0.401026788832457
2020-01-01,0,0,0,0,0,0,0,0.0
2020-01-02,64,44,20,2,42,1,1,2.559565152003256
2020-01-03,100,14,86,2,12,2,0,-10.755632973076455
2020-01-05,14,0,14,0,0,0,0,0.0
2020-01-06,169,60,109,3,57,1,1,1.9054673912647773
2020-01-07,143,38,105,3,35,1,1,2.0675585104142327
2020-01-08,141,38,103,1,37,1,1,2.2551121468879707
2020-01-09,201,105,96,12,93,1,1,-0.812548505230962
2020-01-10,100,61,39,2,59,1,1,3.290447074747283
2020-01-12,15,0,15,0,0,0,0,0.0
2020-01-13,179,75,104,5,70,1,0,-3.3474400261935795
2020-01-14,133,29,104,4,25,1,0,-5.253243555853003
2020-01-15,208,109,99,1,108,0,0,0.0
2020-01-16,164,56,108,5,51,1,1,-0.4413555018645483
2020-01-17,161,72,89,7,65,1,0,-4.670804197116157
2020-01-19,5,0,5,0,0,0,0,0.0
2020-01-20,204,133,71,0,133,0,0,0.0
2020-01-21,160,53,107,3,50,1,1,-0.5150075133699685
2020-01-22,251,140,111,2,138,0,0,0.0
2020-01-23,144,31,113,1,30,1,0,-5.917650815683546
2020-01-24,160,69,91,7,62,1,1,1.282190541433317
2020-01-26,13,0,13,0,0,0,0,0.0
2020-01-27,127,63,64,1,62,1,0,-4.351340753240834
2020-01-28,171,67,104,4,63,1,1,-0.07437580332390326
2020-01-29,98,31,67,1,30,1,1,1.3705348849699412
2020-01-30,145,37,108,1,36,1,1,-1.850570826470808
2020-01-31,163,70,93,7,63,1,1,0.5627931744404366
2020-02-02,0,0,0,0,0,0,0,0.0
2020-02-03,122,16,106,3,13,1,1,1.354296929843522
2020-02-04,131,35,96,17,18,1,1,0.3096565359125867
2020-02-05,124,56,68,1,55,1,0,-5.1613129555101755
2020-02-06,159,55,104,6,49,1,0,-5.692420241475828
2020-02-07,147,51,96,1,50,1,0,-4.035779916292178
2020-02-09,18,0,18,0,0,0,0,0.0
2020-02-10,181,85,96,0,85,0,0,0.0
2020-02-11,172,75,97,9,66,1,1,-0.059075015814271215
2020-02-12,257,158,99,0,158,0,0,0.0
2020-02-13,159,52,107,3,49,1,1,0.24018710702520174
2020-02-14,126,68,58,7,61,1,1,-0.7470857020957471
2020-02-16,0,0,0,0,0,0,0,0.0
2020-02-17,173,149,24,0,149,0,0,0.0
2020-02-18,147,45,102,16,29,1,1,1.4555616004681362
2020-02-19,167,54,113,1,53,1,1,-0.11544436610154518
2020-02-20,106,2,104,2,0,2,0,-9.06602227198092
2020-02-21,109,15,94,14,1,2,1,-4.750832119812902
2020-02-23,13,0,13,0,0,0,0,0.0
2020-02-24,175,69,106,2,67,1,1,4.9377697608602045
2020-02-25,119,4,115,2,2,2,1,-0.9730379842242649
2020-02-26,112,6,106,6,0,2,1,-1.4552468473894677
2020-02-27,108,2,106,2,0,2,1,-5.972017631393179
2020-02-28,119,51,68,2,49,2,1,0.9305251868174196
2020-03-01,3,0,3,0,0,0,0,0.0
2020-03-02,181,84,97,1,83,1,0,-6.183392899191608
2020-03-03,113,3,110,2,1,2,0,-14.061656390432194
2020-03-04,125,20,105,2,18,1,0,-6.374548283423731
2020-03-05,119,13,106,7,6,2,2,7.072657428137914
2020-03-06,101,10,91,2,8,2,1,-4.673775249188019
2020-03-08,15,0,15,0,0,0,0,0.0
2020-03-09,176,64,112,1,63,1,0,-12.846908095989267
2020-03-10,190,89,101,1,88,1,0,-11.836584257844443
2020-03-11,178,65,113,1,64,1,0,-8.413469083541127
2020-03-12,207,103,104,1,102,1,0,-9.57481515396341
2020-03-13,176,81,95,1,80,1,0,-9.915825032634345
2020-03-15,18,12,6,0,12,0,0,0.0
2020-03-16,140,101,39,1,100,1,0,-9.646951229823541
2020-03-17,242,127,115,4,123,0,0,0.0
2020-03-18,216,114,102,1,113,1,1,9.030877938507258
2020-03-19,242,133,109,9,124,0,0,0.0
2020-03-20,171,78,93,2,76,1,0,-11.570660104080975
2020-03-22,6,0,6,0,0,0,0,0.0
2020-03-23,155,47,108,1,46,1,0,-4.900338068729767
2020-03-24,263,149,114,0,149,0,0,0.0
2020-03-25,202,95,107,1,94,1,1,5.43194200826835
2020-03-26,207,96,111,0,96,0,0,0.0
2020-03-27,128,32,96,1,31,1,1,8.193815137666682
2020-03-29,12,0,12,0,0,0,0,0.0
2020-03-30,163,71,92,0,71,0,0,0.0
2020-03-31,160,46,114,1,45,1,1,6.75240130364801
2020-04-01,161,50,111,1,49,1,1,5.595394697944746
2020-04-02,134,23,111,1,22,1,0,-7.615135959412967
2020-04-03,85,53,32,1,52,1,0,-8.377132919472064
2020-04-05,11,0,11,0,0,0,0,0.0
2020-04-06,183,70,113,5,65,1,1,2.0143391256553125
2020-04-07,156,45,111,1,44,1,0,-6.204922145863255
2020-04-08,151,55,96,1,54,1,1,4.719358802828541
2020-04-09,172,58,114,3,55,1,1,1.0546899017509341
2020-04-10,204,115,89,0,115,0,0,0.0
2020-04-12,11,10,1,6,4,0,0,0.0
2020-04-13,130,29,101,1,28,1,1,0.7459932662245978
2020-04-14,140,50,90,1,49,1,0,-6.216007808807003
2020-04-15,138,33,105,1,32,1,0,-6.336993593408851
2020-04-16,149,49,100,1,48,1,0,-5.930179039809741
2020-04-17,151,55,96,1,54,1,1,5.184765601915549
2020-04-19,18,0,18,0,0,0,0,0.0
2020-04-20,161,52,109,7,45,1,1,1.899197437182832
2020-04-21,141,33,108,1,32,1,0,-5.592771912799239
2020-04-22,128,36,92,9,27,1,1,2.3852673930869135
2020-04-23,87,34,53,1,33,1,0,-4.789668287204248
2020-04-24,230,136,94,4,132,0,0,0.0
2020-04-26,19,6,13,1,5,1,1,0.41457215888913534
2020-04-27,156,56,100,3,53,1,1,2.207044367259039
2020-04-28,164,51,113,1,50,1,0,-5.41284400503319
2020-04-29,145,49,96,1,48,1,0,-7.595791408580791
2020-04-30,145,42,103,9,33,1,1,2.2347459811685795
2020-05-01,105,65,40,3,62,1,1,4.56390992560746
2020-05-03,6,0,6,0,0,0,0,0.0
2020-05-04,153,41,112,2,39,1,1,1.0469094033442667
2020-05-05,147,37,110,2,35,1,1,-0.15578353263215794
2020-05-06,159,45,114,7,38,1,1,0.47497873123898726
2020-05-07,159,49,110,1,48,1,0,-6.206577887546469
2020-05-08,117,22,95,1,21,1,0,-5.975799007222022
2020-05-10,17,0,17,0,0,0,0,0.0
2020-05-11,146,59,87,1,58,1,1,1.5435963556931407
2020-05-12,143,33,110,1,32,1,0,-4.726599994351888
2020-05-13,138,37,101,1,36,1,0,-5.591700709164792
2020-05-14,148,45,103,1,44,1,1,0.8457564326029683
2020-05-15,121,47,74,1,46,1,1,3.1433491429986704
2020-05-17,16,0,16,0,0,0,0,0.0
2020-05-18,92,60,32,3,57,1,1,1.5430325271523597
2020-05-19,170,55,115,1,54,1,0,-6.24257286586778
2020-05-20,134,61,73,10,51,1,1,1.5860552722752765
2020-05-21,125,28,97,1,27,1,0,-4.503174885854912
2020-05-22,170,90,80,0,90,0,0,0.0
2020-05-24,16,6,10,0,6,0,0,0.0
2020-05-25,165,103,62,0,103,0,0,0.0
2020-05-26,162,59,103,6,53,1,1,2.599194863929549
2020-05-27,130,54,76,2,52,1,0,-5.211185826858079
2020-05-28,152,53,99,3,50,1,1,0.8262948828223773
2020-05-29,119,29,90,1,28,1,1,4.371074799926106
2020-05-31,12,0,12,0,0,0,0,0.0
2020-06-01,160,57,103,9,48,1,1,1.0928189544973679
2020-06-02,138,40,98,1,39,1,0,-5.172395574672695
2020-06-03,156,46,110,1,45,1,0,-4.320596704350795
2020-06-04,160,52,108,1,51,1,0,-6.543940333406607
2020-06-05,140,55,85,1,54,1,0,-6.339610120586583
2020-06-07,3,0,3,0,0,0,0,0.0
2020-06-08,153,43,110,1,42,1,0,-4.361695004282753
2020-06-09,164,53,111,1,52,1,0,-4.61337260839778
2020-06-10,167,60,107,7,53,1,1,3.83657590362182
2020-06-11,130,41,89,1,40,1,0,-6.101143849502332
2020-06-12,142,62,80,4,58,1,0,-6.65490448702685
2020-06-14,4,0,4,0,0,0,0,0.0
2020-06-15,221,120,101,0,120,0,0,0.0
2020-06-16,136,50,86,5,45,1,1,5.153867921552267
2020-06-17,119,19,100,1,18,1,1,3.1864667760035754
2020-06-18,145,39,106,1,38,1,1,-1.7795051045133126
2020-06-19,134,49,85,4,45,1,0,-5.664524558918221
2020-06-21,2,0,2,0,0,0,0,0.0
2020-06-22,212,114,98,0,114,0,0,0.0
2020-06-23,151,40,111,1,39,1,1,7.204447757847991
2020-06-24,205,115,90,10,105,0,0,0.0
2020-06-25,207,147,60,3,144,1,1,1.3207165163051184
2020-06-26,146,65,81,2,63,1,1,0.5564541302451222
2020-06-28,2,0,2,0,0,0,0,0.0
2020-06-29,108,45,63,1,44,1,1,4.715548018061195
2020-06-30,154,53,101,5,48,1,0,-6.407433790489906
2020-07-01,157,53,104,7,46,0,0,0.0
2020-07-02,112,30,82,1,29,1,1,4.457727532013829
2020-07-03,164,106,58,0,106,0,0,0.0
2020-07-05,19,8,11,0,8,0,0,0.0
2020-07-06,160,54,106,4,50,1,0,-6.471151139729457
2020-07-07,248,148,100,1,147,0,0,0.0
2020-07-08,259,153,106,0,153,0,0,0.0
2020-07-09,159,59,100,7,52,1,1,0.37043832952084044
2020-07-10,166,70,96,5,65,1,0,-4.632843545470301
2020-07-12,13,0,13,0,0,0,0,0.0
2020-07-13,179,95,84,5,90,0,0,0.0
2020-07-14,240,151,89,0,151,0,0,0.0
2020-07-15,121,60,61,1,59,1,1,2.362325213731592
2020-07-16,151,55,96,1,54,1,0,-4.63158156410971
2020-07-17,206,113,93,0,113,0,0,0.0
2020-07-19,11,10,1,0,10,0,0,0.0
2020-07-20,248,142,106,0,142,0,0,0.0
2020-07-21,165,52,113,4,48,1,1,0.9393777889457875
2020-07-22,221,143,78,0,143,0,0,0.0
2020-07-23,114,34,80,2,32,1,1,0.4936825144205059
2020-07-24,136,40,96,1,39,1,0,-2.1145025816834018
2020-07-26,7,0,7,0,0,0,0,0.0
2020-07-27,208,113,95,8,105,0,0,0.0
2020-07-28,152,56,96,2,54,1,0,-6.730669387347607
2020-07-29,157,60,97,1,59,1,1,1.817197923071923
2020-07-30,156,44,112,1,43,1,0,-7.983577795523805
2020-07-31,146,50,96,1,49,1,0,-7.837443508472932
2020-08-02,4,0,4,0,0,0,0,0.0
2020-08-03,236,150,86,4,146,0,0,0.0
2020-08-04,157,46,111,1,45,1,1,2.691349086700987
2020-08-05,193,93,100,0,93,0,0,0.0
2020-08-06,188,90,98,0,90,0,0,0.0
2020-08-07,119,25,94,3,22,1,1,6.36630725519384
2020-08-09,6,0,6,0,0,0,0,0.0
2020-08-10,165,63,102,1,62,1,1,0.4220462948053183
2020-08-11,143,35,108,1,34,1,1,3.0203512215416883
2020-08-12,239,139,100,0,139,0,0,0.0
2020-08-13,220,109,111,0,109,0,0,0.0
2020-08-14,140,63,77,1,62,1,1,0.004726522781408615
2020-08-16,9,0,9,0,0,0,0,0.0
2020-08-17,243,151,92,0,151,0,0,0.0
2020-08-18,143,34,109,1,33,1,0,-7.698107421590463
2020-08-19,152,47,105,1,46,1,0,-6.521176678171084
2020-08-20,229,130,99,0,130,0,0,0.0
2020-08-21,148,52,96,1,51,1,0,-5.37393249916371
2020-08-23,18,0,18,0,0,0,0,0.0
2020-08-24,199,141,58,0,141,0,0,0.0
2020-08-25,156,56,100,1,55,1,0,-6.609191617497483
2020-08-26,134,29,105,1,28,1,1,0.9878537714337705
2020-08-27,87,2,85,1,1,1,0,-9.779779046663602
2020-08-28,152,56,96,1,55,1,0,-8.45783398778023
2020-08-30,2,0,2,0,0,0,0,0.0
2020-08-31,174,147,27,0,147,0,0,0.0
2020-09-01,166,57,109,1,56,1,1,1.3445161898329911
2020-09-02,124,13,111,1,12,1,0,-5.192920868837282
2020-09-03,257,147,110,0,147,0,0,0.0
2020-09-04,190,122,68,0,122,0,0,0.0
2020-09-06,26,12,14,0,12,0,0,0.0
2020-09-07,246,142,104,0,142,0,0,0.0
2020-09-08,157,50,107,1,49,1,0,-6.735754389818676
2020-09-09,110,81,29,0,81,0,0,0.0
2020-09-10,232,128,104,0,128,0,0,0.0
2020-09-11,199,112,87,0,112,0,0,0.0
2020-09-13,24,12,12,0,12,0,0,0.0
2020-09-14,253,153,100,0,153,0,0,0.0
2020-09-15,230,130,100,0,130,0,0,0.0
2020-09-16,157,43,114,1,42,1,0,-5.459594715500649
2020-09-17,268,155,113,0,155,0,0,0.0
2020-09-18,197,104,93,0,104,0,0,0.0
2020-09-20,12,12,0,0,12,0,0,0.0
2020-09-21,198,111,87,0,111,0,0,0.0
2020-09-22,259,158,101,0,158,0,0,0.0
2020-09-23,231,133,98,0,133,0,0,0.0
2020-09-24,199,93,106,0,93,0,0,0.0
2020-09-25,227,142,85,0,142,0,0,0.0
2020-09-27,22,12,10,0,12,0,0,0.0
2020-09-28,211,102,109,0,102,0,0,0.0
2020-09-29,181,86,95,0,86,0,0,0.0
2020-09-30,254,154,100,3,151,0,0,0.0
2020-10-01,221,130,91,0,130,0,0,0.0
2020-10-02,201,117,84,0,117,0,0,0.0
2020-10-04,20,8,12,0,8,0,0,0.0
2020-10-05,211,109,102,0,109,0,0,0.0
2020-10-06,210,107,103,0,107,0,0,0.0
2020-10-07,246,155,91,0,155,0,0,0.0
2020-10-08,176,95,81,0,95,0,0,0.0
2020-10-09,213,117,96,0,117,0,0,0.0
2020-10-11,31,12,19,0,12,0,0,0.0
2020-10-12,188,82,106,0,82,0,0,0.0
2020-10-13,186,91,95,0,91,0,0,0.0
2020-10-14,240,135,105,0,135,0,0,0.0
2020-10-15,256,142,114,0,142,0,0,0.0
2020-10-16,208,112,96,0,112,0,0,0.0
2020-10-18,11,0,11,0,0,0,0,0.0
2020-10-19,214,148,66,0,148,0,0,0.0
2020-10-20,252,152,100,0,152,0,0,0.0
2020-10-21,241,133,108,0,133,0,0,0.0
2020-10-22,256,150,106,0,150,0,0,0.0
2020-10-23,160,65,95,0,65,0,0,0.0
2020-10-25,29,12,17,0,12,0,0,0.0
2020-10-26,246,139,107,0,139,0,0,0.0
2020-10-27,246,146,100,0,146,0,0,0.0
2020-10-28,219,120,99,0,120,0,0,0.0
2020-10-29,251,150,101,0,150,0,0,0.0
2020-10-30,188,92,96,0,92,0,0,0.0
2020-11-01,8,0,8,0,0,0,0,0.0
2020-11-02,244,148,96,0,148,0,0,0.0
2020-11-03,188,147,41,0,147,0,0,0.0
2020-11-04,248,136,112,0,136,0,0,0.0
2020-11-05,198,83,115,0,83,0,0,0.0
2020-11-06,185,97,88,0,97,0,0,0.0
2020-11-08,10,0,10,0,0,0,0,0.0
2020-11-09,148,47,101,1,46,1,0,-10.38311396995233
2020-11-10,162,66,96,0,66,0,0,0.0
2020-11-11,176,81,95,0,81,0,0,0.0
2020-11-12,248,144,104,0,144,0,0,0.0
2020-11-13,240,144,96,0,144,0,0,0.0
2020-11-15,0,0,0,0,0,0,0,0.0
2020-11-16,233,151,82,0,151,0,0,0.0
2020-11-17,205,91,114,0,91,0,0,0.0
2020-11-18,231,123,108,0,123,0,0,0.0
2020-11-19,216,131,85,0,131,0,0,0.0
2020-11-20,160,71,89,0,71,0,0,0.0
2020-11-22,16,0,16,0,0,0,0,0.0
2020-11-23,100,55,45,1,54,1,1,4.8029189652709565
2020-11-24,198,107,91,2,105,0,0,0.0
2020-11-25,191,87,104,0,87,0,0,0.0
2020-11-26,207,95,112,0,95,0,0,0.0
2020-11-27,224,128,96,0,128,0,0,0.0
2020-11-29,11,0,11,0,0,0,0,0.0
2020-11-30,232,128,104,0,128,0,0,0.0
2020-12-01,220,110,110,0,110,0,0,0.0
2020-12-02,250,135,115,0,135,0,0,0.0
2020-12-03,211,111,100,0,111,0,0,0.0
2020-12-04,175,121,54,3,118,0,0,0.0
2020-12-06,17,0,17,0,0,0,0,0.0
2020-12-07,211,142,69,0,142,0,0,0.0
2020-12-08,152,60,92,0,60,0,0,0.0
2020-12-09,261,152,109,0,152,0,0,0.0
2020-12-10,228,128,100,0,128,0,0,0.0
2020-12-11,219,123,96,0,123,0,0,0.0
2020-12-13,0,0,0,0,0,0,0,0.0
2020-12-14,182,148,34,0,148,0,0,0.0
2020-12-15,229,143,86,0,143,0,0,0.0
2020-12-16,169,63,106,2,61,1,1,2.1266604936747
2020-12-17,148,47,101,1,46,1,1,3.7874771747806024
2020-12-18,168,72,96,0,72,0,0,0.0
2020-12-20,0,0,0,0,0,0,0,0.0
2020-12-21,148,130,18,0,130,0,0,0.0
2020-12-22,224,116,108,0,116,0,0,0.0
2020-12-23,168,57,111,0,57,0,0,0.0
2020-12-24,224,115,109,0,115,0,0,0.0
2020-12-25,58,0,58,0,0,0,0,0.0
2020-12-27,17,0,17,0,0,0,0,0.0
2020-12-28,223,145,78,0,145,0,0,0.0
2020-12-29,212,109,103,0,109,0,0,0.0
2020-12-30,244,145,99,0,145,0,0,0.0
2020-12-31,132,132,0,0,132,0,0,0.0
2021-01-03,10,0,10,0,0,0,0,0.0
2021-01-04,245,143,102,0,143,0,0,0.0
2021-01-05,245,140,105,0,140,0,0,0.0
2021-01-06,222,134,88,0,134,0,0,0.0
2021-01-07,245,145,100,0,145,0,0,0.0
2021-01-08,141,55,86,1,54,1,1,2.2114591305840796
2021-01-10,18,0,18,0,0,0,0,0.0
2021-01-11,219,117,102,0,117,0,0,0.0
2021-01-12,182,107,75,0,107,0,0,0.0
2021-01-13,173,69,104,5,64,1,1,0.12626853527570958
2021-01-14,207,107,100,2,105,0,0,0.0
2021-01-15,160,125,35,2,123,0,0,0.0
2021-01-17,5,0,5,0,0,0,0,0.0
2021-01-18,231,128,103,0,128,0,0,0.0
2021-01-19,201,105,96,0,105,0,0,0.0
2021-01-20,247,147,100,0,147,0,0,0.0
2021-01-21,153,56,97,3,53,1,1,-0.07525151134977515
2021-01-22,198,103,95,0,103,0,0,0.0
2021-01-24,1,0,1,0,0,0,0,0.0
2021-01-25,185,113,72,2,111,0,0,0.0
2021-01-26,177,107,70,0,107,0,0,0.0
2021-01-27,168,75,93,1,74,1,1,0.4326232165474586
2021-01-28,218,114,104,0,114,0,0,0.0
2021-01-29,162,66,96,1,65,1,1,-0.3427428401012902
2021-01-31,18,0,18,0,0,0,0,0.0
2021-02-01,183,84,99,0,84,0,0,0.0
2021-02-02,220,133,87,0,133,0,0,0.0
2021-02-03,132,34,98,0,34,0,0,0.0
2021-02-04,254,151,103,0,151,0,0,0.0
2021-02-05,133,77,56,5,72,1,1,0.9941483637213526
2021-02-07,17,0,17,0,0,0,0,0.0
2021-02-08,258,154,104,0,154,0,0,0.0
2021-02-09,167,58,109,4,54,1,0,-7.384169660842116
2021-02-10,165,72,93,2,70,1,1,0.1581854054102072
2021-02-11,158,135,23,2,133,0,0,0.0
2021-02-12,230,142,88,15,127,0,0,0.0
2021-02-14,11,0,11,0,0,0,0,0.0
2021-02-15,218,115,103,0,115,0,0,0.0
2021-02-16,163,50,113,1,49,1,0,-5.466949464602429
2021-02-17,219,124,95,0,124,0,0,0.0
2021-02-18,130,41,89,1,40,1,0,-6.6842687506987915
2021-02-19,158,69,89,2,67,1,1,0.875130293963986
2021-02-21,14,0,14,0,0,0,0,0.0
2021-02-22,245,146,99,0,146,0,0,0.0
2021-02-23,242,146,96,0,146,0,0,0.0
2021-02-24,222,109,113,0,109,0,0,0.0
2021-02-25,160,52,108,1,51,1,0,-5.5444903903580585
2021-02-26,232,148,84,0,148,0,0,0.0
2021-02-28,6,0,6,0,0,0,0,0.0
2021-03-01,233,142,91,0,142,0,0,0.0
2021-03-02,238,132,106,2,130,0,0,0.0
2021-03-03,261,147,114,0,147,0,0,0.0
2021-03-04,265,156,109,5,151,0,0,0.0
2021-03-05,141,52,89,1,51,1,1,5.844001821144539
2021-03-07,13,0,13,0,0,0,0,0.0
2021-03-08,236,146,90,0,146,0,0,0.0
2021-03-09,162,51,111,1,50,1,0,-4.886599479288272
2021-03-10,143,34,109,3,31,1,1,8.486452082997932
2021-03-11,214,110,104,0,110,0,0,0.0
2021-03-12,149,53,96,0,53,0,0,0.0
2021-03-14,22,4,18,0,4,0,0,0.0
2021-03-15,209,116,93,0,116,0,0,0.0
2021-03-16,147,47,100,1,46,1,0,-5.618981235392659
2021-03-17,224,113,111,1,112,1,1,4.594691332357395
2021-03-18,237,146,91,0,146,0,0,0.0
2021-03-19,156,63,93,0,63,0,0,0.0
2021-03-21,21,12,9,0,12,0,0,0.0
2021-03-22,105,77,28,0,77,0,0,0.0
2021-03-23,220,117,103,0,117,0,0,0.0
2021-03-24,184,82,102,3,79,0,0,0.0
2021-03-25,229,119,110,0,119,0,0,0.0
2021-03-26,151,55,96,2,53,1,0,-5.3904308721791345
2021-03-28,16,0,16,0,0,0,0,0.0
2021-03-29,236,138,98,0,138,0,0,0.0
2021-03-30,179,69,110,0,69,0,0,0.0
2021-03-31,208,94,114,0,94,0,0,0.0
2021-04-01,215,122,93,0,122,0,0,0.0
2021-04-02,147,56,91,0,56,0,0,0.0
2021-04-04,12,0,12,0,0,0,0,0.0
2021-04-05,195,126,69,0,126,0,0,0.0
2021-04-06,177,73,104,0,73,0,0,0.0
2021-04-07,129,35,94,1,34,1,1,2.559154711450658
2021-04-08,145,48,97,1,47,1,0,-6.63405824592019
2021-04-09,190,144,46,0,144,0,0,0.0
2021-04-11,30,11,19,0,11,0,0,0.0
2021-04-12,258,152,106,0,152,0,0,0.0
2021-04-13,158,44,114,1,43,1,0,-6.02538386997412
2021-04-14,202,100,102,0,100,0,0,0.0
2021-04-15,220,117,103,3,114,0,0,0.0
2021-04-16,223,129,94,0,129,0,0,0.0
2021-04-18,29,12,17,0,12,0,0,0.0
2021-04-19,143,40,103,0,40,0,0,0.0
2021-04-20,242,139,103,0,139,0,0,0.0
2021-04-21,263,150,113,0,150,0,0,0.0
2021-04-22,240,127,113,7,120,0,0,0.0
2021-04-23,119,42,77,1,41,1,1,3.5279018718806796
2021-04-25,17,0,17,0,0,0,0,0.0
2021-04-26,240,127,113,5,122,0,0,0.0
2021-04-27,252,140,112,0,140,0,0,0.0
2021-04-28,146,31,115,4,27,1,1,2.2856255109221566
2021-04-29,159,51,108,1,50,1,0,-6.014258845548159
2021-04-30,229,133,96,0,133,0,0,0.0
2021-05-02,13,12,1,0,12,0,0,0.0
2021-05-03,177,68,109,2,66,1,1,3.603396412655341
2021-05-04,160,52,108,1,51,1,0,-6.727080189642566
2021-05-05,220,113,107,7,106,0,0,0.0
2021-05-06,171,62,109,1,61,1,1,2.557989995365984
2021-05-07,128,36,92,1,35,1,0,-11.142530832506266
2021-05-09,0,0,0,0,0,0,0,0.0
2021-05-10,210,111,99,0,111,0,0,0.0
2021-05-11,157,57,100,1,56,1,0,-5.391233901624891
2021-05-12,150,50,100,2,48,1,1,7.018374293448651
2021-05-13,108,23,85,1,22,1,0,-5.998771943863149
2021-05-14,106,10,96,1,9,1,0,-5.318508758451574
2021-05-16,19,0,19,0,0,0,0,0.0
2021-05-17,148,90,58,0,90,0,0,0.0
2021-05-18,176,80,96,0,80,0,0,0.0
2021-05-19,165,52,113,1,51,1,0,-8.206316723320976
2021-05-20,253,139,114,0,139,0,0,0.0
2021-05-21,211,117,94,0,117,0,0,0.0
2021-05-23,16,12,4,0,12,0,0,0.0
2021-05-24,240,156,84,0,156,0,0,0.0
2021-05-25,224,134,90,0,134,0,0,0.0
2021-05-26,222,147,75,0,147,0,0,0.0
2021-05-27,263,155,108,0,155,0,0,0.0
2021-05-28,225,130,95,0,130,0,0,0.0
2021-05-30,23,12,11,0,12,0,0,0.0
2021-05-31,249,136,113,0,136,0,0,0.0
2021-06-01,217,115,102,0,115,0,0,0.0
2021-06-02,264,152,112,0,152,0,0,0.0
2021-06-03,262,151,111,0,151,0,0,0.0
2021-06-04,231,134,97,1,133,0,0,0.0
2021-06-06,29,12,17,0,12,0,0,0.0
2021-06-07,98,29,69,0,29,0,0,0.0
2021-06-08,253,148,105,0,148,0,0,0.0
2021-06-09,243,143,100,0,143,0,0,0.0
2021-06-10,254,151,103,1,150,0,0,0.0
2021-06-11,192,104,88,0,104,0,0,0.0
2021-06-13,3,0,3,0,0,0,0,0.0
2021-06-14,229,141,88,0,141,0,0,0.0
2021-06-15,169,71,98,0,71,0,0,0.0
2021-06-16,181,82,99,3,79,1,1,5.313694823312393
2021-06-17,246,145,101,0,145,0,0,0.0
2021-06-18,164,72,92,6,66,1,0,-7.369834554037409
2021-06-20,0,0,0,0,0,0,0,0.0
2021-06-21,232,133,99,0,133,0,0,0.0
2021-06-22,184,83,101,0,83,0,0,0.0
2021-06-23,242,138,104,0,138,0,0,0.0
2021-06-24,229,135,94,0,135,0,0,0.0
2021-06-25,215,134,81,0,134,0,0,0.0
2021-06-27,12,12,0,0,12,0,0,0.0
2021-06-28,246,152,94,0,152,0,0,0.0
2021-06-29,251,150,101,0,150,0,0,0.0
2021-06-30,224,123,101,0,123,0,0,0.0
2021-07-01,244,150,94,0,150,0,0,0.0
2021-07-02,128,32,96,1,31,1,0,-7.12561931477498
2021-07-04,19,0,19,0,0,0,0,0.0
2021-07-05,163,83,80,0,83,0,0,0.0
2021-07-06,246,142,104,0,142,0,0,0.0
2021-07-07,174,67,107,0,67,0,0,0.0
2021-07-08,244,131,113,0,131,0,0,0.0
2021-07-09,232,136,96,0,136,0,0,0.0
2021-07-11,20,12,8,0,12,0,0,0.0
2021-07-12,187,157,30,0,157,0,0,0.0
2021-07-13,233,123,110,1,122,0,0,0.0
2021-07-14,249,135,114,0,135,0,0,0.0
2021-07-15,215,103,112,0,103,0,0,0.0
2021-07-16,226,130,96,0,130,0,0,0.0
2021-07-18,26,12,14,0,12,0,0,0.0
2021-07-19,209,96,113,0,96,0,0,0.0
2021-07-20,259,152,107,0,152,0,0,0.0
2021-07-21,154,59,95,0,59,0,0,0.0
2021-07-22,173,70,103,0,70,0,0,0.0
2021-07-23,175,84,91,0,84,0,0,0.0
2021-07-25,4,0,4,0,0,0,0,0.0
2021-07-26,176,68,108,0,68,0,0,0.0
2021-07-27,227,117,110,0,117,0,0,0.0
2021-07-28,240,129,111,0,129,0,0,0.0
2021-07-29,219,108,111,0,108,0,0,0.0
2021-07-30,176,80,96,0,80,0,0,0.0
2021-08-01,16,12,4,0,12,0,0,0.0
2021-08-02,180,149,31,0,149,0,0,0.0
2021-08-03,255,145,110,0,145,0,0,0.0
2021-08-04,210,123,87,0,123,0,0,0.0
2021-08-05,246,143,103,0,143,0,0,0.0
2021-08-06,240,142,98,0,142,0,0,0.0
2021-08-08,18,11,7,0,11,0,0,0.0
2021-08-09,218,138,80,0,138,0,0,0.0
2021-08-10,216,145,71,0,145,0,0,0.0
2021-08-11,208,99,109,1,98,0,0,0.0
2021-08-12,247,138,109,0,138,0,0,0.0
2021-08-13,195,112,83,0,112,0,0,0.0
2021-08-15,13,12,1,0,12,0,0,0.0
2021-08-16,164,52,112,0,52,0,0,0.0
2021-08-17,208,107,101,0,107,0,0,0.0
2021-08-18,212,122,90,0,122,0,0,0.0
2021-08-19,150,48,102,0,48,0,0,0.0
2021-08-20,142,54,88,0,54,0,0,0.0
2021-08-22,30,12,18,0,12,0,0,0.0
2021-08-23,217,105,112,0,105,0,0,0.0
2021-08-24,255,151,104,0,151,0,0,0.0
2021-08-25,226,119,107,0,119,0,0,0.0
2021-08-26,241,133,108,0,133,0,0,0.0
2021-08-27,213,117,96,12,105,0,0,0.0
2021-08-29,18,12,6,0,12,0,0,0.0
2021-08-30,193,105,88,0,105,0,0,0.0
2021-08-31,247,146,101,0,146,0,0,0.0
2021-09-01,178,73,105,0,73,0,0,0.0
2021-09-02,235,129,106,0,129,0,0,0.0
2021-09-03,150,54,96,2,52,1,1,7.505269731263435
2021-09-05,4,0,4,0,0,0,0,0.0
2021-09-06,168,63,105,0,63,0,0,0.0
2021-09-07,217,107,110,0,107,0,0,0.0
2021-09-08,170,72,98,0,72,0,0,0.0
2021-09-09,211,101,110,0,101,0,0,0.0
2021-09-10,154,75,79,0,75,0,0,0.0
2021-09-12,10,7,3,0,7,0,0,0.0
2021-09-13,219,110,109,0,110,0,0,0.0
2021-09-14,247,144,103,0,144,0,0,0.0
2021-09-15,205,91,114,0,91,0,0,0.0
2021-09-16,185,79,106,0,79,0,0,0.0
2021-09-17,236,140,96,0,140,0,0,0.0
2021-09-19,13,12,1,0,12,0,0,0.0
2021-09-20,228,128,100,0,128,0,0,0.0
2021-09-21,224,110,114,0,110,0,0,0.0
2021-09-22,225,121,104,0,121,0,0,0.0
2021-09-23,245,149,96,0,149,0,0,0.0
2021-09-24,209,113,96,0,113,0,0,0.0
2021-09-26,12,12,0,0,12,0,0,0.0
2021-09-27,235,147,88,0,147,0,0,0.0
2021-09-28,168,56,112,3,53,1,1,5.506027984160172
2021-09-29,249,141,108,0,141,0,0,0.0
2021-09-30,182,73,109,4,69,1,1,4.3035376680690085
2021-10-01,148,58,90,0,58,0,0,0.0
2021-10-03,12,12,0,0,12,0,0,0.0
2021-10-04,233,155,78,0,155,0,0,0.0
2021-10-05,265,153,112,0,153,0,0,0.0
2021-10-06,210,99,111,0,99,0,0,0.0
2021-10-07,237,125,112,0,125,0,0,0.0
2021-10-08,152,53,99,1,52,1,1,7.783149427572509
2021-10-10,3,0,3,0,0,0,0,0.0
2021-10-11,228,129,99,0,129,0,0,0.0
2021-10-12,142,45,97,0,45,0,0,0.0
2021-10-13,138,26,112,1,25,1,1,6.000972796527348
2021-10-14,244,138,106,0,138,0,0,0.0
2021-10-15,238,142,96,1,141,0,0,0.0
2021-10-17,14,12,2,0,12,0,0,0.0
2021-10-18,109,45,64,0,45,0,0,0.0
2021-10-19,223,115,108,2,113,0,0,0.0
2021-10-20,172,61,111,1,60,0,0,0.0
2021-10-21,154,48,106,1,47,1,0,-6.790869699220205
2021-10-22,223,127,96,0,127,0,0,0.0
2021-10-24,27,12,15,0,12,0,0,0.0
2021-10-25,220,119,101,0,119,0,0,0.0
2021-10-26,207,108,99,0,108,0,0,0.0
2021-10-27,155,50,105,2,48,1,1,2.8039109370471706
2021-10-28,146,49,97,1,48,1,1,4.902937439597525
2021-10-29,147,51,96,1,50,1,0,-6.021371348507309
2021-10-31,7,0,7,0,0,0,0,0.0
2021-11-01,221,131,90,0,131,0,0,0.0
2021-11-02,230,133,97,0,133,0,0,0.0
2021-11-03,208,101,107,1,100,1,1,4.35033503187875
2021-11-04,266,152,114,0,152,0,0,0.0
2021-11-05,135,43,92,2,41,1,1,4.123585182389699
2021-11-07,19,0,19,0,0,0,0,0.0
2021-11-08,177,63,114,1,62,1,1,2.8519383676703853
2021-11-09,145,34,111,1,33,1,1,0.46189163688246815
2021-11-10,158,64,94,2,62,1,1,6.988215104753956
2021-11-11,225,124,101,6,118,0,0,0.0
2021-11-12,142,46,96,6,40,1,1,-3.2071053753475507
2021-11-14,17,0,17,0,0,0,0,0.0
2021-11-15,239,143,96,0,143,0,0,0.0
2021-11-16,153,39,114,1,38,1,1,3.2208890659855527
2021-11-17,167,63,104,1,62,1,1,-0.11604074175840395
2021-11-18,132,69,63,0,69,0,0,0.0
2021-11-19,146,50,96,1,49,1,0,-8.144946468274728
2021-11-21,18,0,18,0,0,0,0,0.0
2021-11-22,130,30,100,3,27,1,1,5.085862518298276
2021-11-23,182,81,101,8,73,0,0,0.0
2021-11-24,158,68,90,3,65,1,1,2.5567529822536414
2021-11-25,147,100,47,0,100,0,0,0.0
2021-11-26,102,6,96,1,5,1,0,-8.20597744709411
2021-11-28,11,0,11,0,0,0,0,0.0
2021-11-29,138,82,56,0,82,0,0,0.0
2021-11-30,171,60,111,4,56,1,1,5.325435932700876
2021-12-01,147,38,109,6,32,1,1,3.5956258045746106
2021-12-02,155,43,112,5,38,1,0,-7.2236443596750775
2021-12-03,129,55,74,3,52,1,1,6.347016920261084
2021-12-05,14,0,14,0,0,0,0,0.0
2021-12-06,247,134,113,0,134,0,0,0.0
2021-12-07,140,36,104,1,35,1,1,-0.7514667031160642
2021-12-08,130,43,87,1,42,1,0,-7.069233528455415
2021-12-09,241,134,107,1,133,0,0,0.0
2021-12-10,150,55,95,1,54,1,1,1.040665903556088
2021-12-12,17,0,17,0,0,0,0,0.0
2021-12-13,249,138,111,0,138,0,0,0.0
2021-12-14,159,57,102,5,52,1,1,1.7581833712120267
2021-12-15,148,53,95,1,52,1,1,1.5869643789889651
2021-12-16,156,43,113,4,39,1,1,2.96321082731329
2021-12-17,149,56,93,1,55,1,0,-5.367222865652634
2021-12-19,11,0,11,0,0,0,0,0.0
2021-12-20,218,126,92,0,126,0,0,0.0
2021-12-21,241,140,101,0,140,0,0,0.0
2021-12-22,157,80,77,0,80,0,0,0.0
2021-12-23,174,59,115,1,58,1,0,-3.5908109125635694
2021-12-24,216,118,98,0,118,0,0,0.0
2021-12-26,2,0,2,0,0,0,0,0.0
2021-12-27,224,151,73,0,151,0,0,0.0
2021-12-28,164,63,101,1,62,1,1,2.525764360552351
2021-12-29,161,48,113,4,44,1,0,-7.428494625526726
2021-12-30,193,78,115,10,68,0,0,0.0
2021-12-31,219,123,96,0,123,0,0,0.0
2022-01-02,18,0,18,0,0,0,0,0.0
2022-01-03,264,149,115,0,149,0,0,0.0
2022-01-04,196,82,114,6,76,1,1,4.173761758495331
2022-01-05,165,50,115,1,49,1,0,-5.77428447526234
2022-01-06,147,32,115,4,28,1,1,3.6911785692390766
2022-01-07,157,61,96,2,59,1,0,-5.711551726105111
2022-01-09,6,0,6,0,0,0,0,0.0
2022-01-10,237,132,105,0,132,0,0,0.0
2022-01-11,171,59,112,2,57,1,1,-0.9024472236715639
2022-01-12,148,41,107,2,39,1,0,-6.116030708439745
2022-01-13,151,54,97,3,51,1,0,-6.160622444454193
2022-01-14,150,54,96,1,53,1,1,2.595959752093899
2022-01-16,18,0,18,0,0,0,0,0.0
2022-01-17,213,107,106,0,107,0,0,0.0
2022-01-18,142,44,98,1,43,1,1,-2.6080856751288466
2022-01-19,167,52,115,1,51,1,1,-2.9107269701362473
2022-01-20,160,52,108,1,51,1,1,1.0218782845277503
2022-01-21,230,134,96,4,130,0,0,0.0
2022-01-23,16,0,16,0,0,0,0,0.0
2022-01-24,165,51,114,1,50,1,1,4.318578143718278
2022-01-25,172,65,107,1,64,1,1,1.0458876899697733
2022-01-26,156,57,99,1,56,1,0,-7.409918600939994
2022-01-27,169,66,103,8,58,1,0,-5.590894613391257
2022-01-28,107,13,94,3,10,1,1,3.924376375000903
2022-01-30,17,0,17,0,0,0,0,0.0
2022-01-31,153,41,112,4,37,1,0,-5.668775716707981
2022-02-01,169,55,114,1,54,1,0,-5.9523326249599195
2022-02-02,173,62,111,1,61,1,0,-4.777470727079718
2022-02-03,203,115,88,7,108,0,0,0.0
2022-02-04,145,55,90,1,54,1,1,-1.1738994672172955
2022-02-06,3,0,3,0,0,0,0,0.0
2022-02-07,211,155,56,0,155,0,0,0.0
2022-02-08,250,139,111,0,139,0,0,0.0
2022-02-09,208,97,111,0,97,0,0,0.0
2022-02-10,174,60,114,4,56,1,1,4.681381621691456
2022-02-11,117,29,88,1,28,1,0,-5.9450149460323685
2022-02-13,18,0,18,0,0,0,0,0.0
2022-02-14,109,39,70,1,38,1,0,-7.1286578960280105
2022-02-15,159,54,105,5,49,1,0,-5.954066302873658
2022-02-16,123,15,108,2,13,1,1,2.6692202489227244
2022-02-17,112,9,103,1,8,1,1,-1.4231101803558166
2022-02-18,169,73,96,0,73,0,0,0.0
2022-02-20,17,0,17,0,0,0,0,0.0
2022-02-21,241,133,108,0,133,0,0,0.0
2022-02-22,233,126,107,0,126,0,0,0.0
2022-02-23,213,117,96,5,112,0,0,0.0
2022-02-24,127,14,113,4,10,1,1,5.611364066278252
2022-02-25,229,133,96,0,133,0,0,0.0
2022-02-27,0,0,0,0,0,0,0,0.0
2022-02-28,75,57,18,3,54,1,1,4.455061577500944
2022-03-01,176,68,108,4,64,1,0,-5.566528384632556
2022-03-02,148,44,104,1,43,1,0,-5.098873027502965
2022-03-03,138,28,110,3,25,1,0,-6.485855900108441
2022-03-04,141,46,95,3,43,1,0,-5.37022605861808
2022-03-06,2,0,2,0,0,0,0,0.0
2022-03-07,193,138,55,0,138,0,0,0.0
2022-03-08,234,128,106,0,128,0,0,0.0
2022-03-09,193,79,114,2,77,0,0,0.0
2022-03-10,256,147,109,1,146,0,0,0.0
2022-03-11,249,153,96,0,153,0,0,0.0
2022-03-13,31,12,19,0,12,0,0,0.0
2022-03-14,192,96,96,0,96,0,0,0.0
2022-03-15,205,104,101,0,104,0,0,0.0
2022-03-16,123,28,95,1,27,1,1,2.780201569670379
2022-03-17,204,142,62,0,142,0,0,0.0
2022-03-18,201,106,95,1,105,0,0,0.0
2022-03-20,24,12,12,0,12,0,0,0.0
2022-03-21,155,126,29,0,126,0,0,0.0
2022-03-22,160,50,110,1,49,1,0,-7.117192274151434
2022-03-23,210,113,97,0,113,0,0,0.0
2022-03-24,208,114,94,1,113,0,0,0.0
2022-03-25,120,24,96,3,21,1,0,-7.742602022392914
2022-03-27,17,0,17,0,0,0,0,0.0
2022-03-28,160,50,110,1,49,1,0,-11.536851045674787
2022-03-29,168,63,105,0,63,0,0,0.0
2022-03-30,134,29,105,1,28,1,1,0.9812926376531794
2022-03-31,132,28,104,6,22,1,0,-8.902695791966398
2022-04-01,215,119,96,2,117,0,0,0.0
2022-04-03,14,12,2,0,12,0,0,0.0
2022-04-04,170,126,44,0,126,0,0,0.0
2022-04-05,217,114,103,6,108,0,0,0.0
2022-04-06,222,124,98,0,124,0,0,0.0
2022-04-07,145,38,107,0,38,0,0,0.0
2022-04-08,167,82,85,0,82,0,0,0.0
2022-04-10,27,12,15,0,12,0,0,0.0
2022-04-11,216,104,112,0,104,0,0,0.0
2022-04-12,123,25,98,1,24,1,0,-13.261598419069209
2022-04-13,215,108,107,0,108,0,0,0.0
2022-04-14,243,134,109,0,134,0,0,0.0
2022-04-15,185,89,96,0,89,0,0,0.0
2022-04-17,11,10,1,0,10,0,0,0.0
2022-04-18,174,151,23,0,151,0,0,0.0
2022-04-19,216,119,97,0,119,0,0,0.0
2022-04-20,134,54,80,1,53,1,0,-7.83493227789624
2022-04-21,195,114,81,0,114,0,0,0.0
2022-04-22,230,139,91,0,139,0,0,0.0
2022-04-24,4,3,1,0,3,0,0,0.0
2022-04-25,186,103,83,0,103,0,0,0.0
2022-04-26,146,54,92,1,53,1,0,-8.662147580271839
2022-04-27,225,118,107,0,118,0,0,0.0
2022-04-28,215,113,102,1,112,0,0,0.0
2022-04-29,229,133,96,0,133,0,0,0.0
2022-05-01,14,12,2,0,12,0,0,0.0
2022-05-02,212,149,63,0,149,0,0,0.0
2022-05-03,228,131,97,0,131,0,0,0.0
2022-05-04,157,95,62,2,93,1,1,12.926425367254243
2022-05-05,193,129,64,0,129,0,0,0.0
2022-05-06,185,89,96,0,89,0,0,0.0
2022-05-08,0,0,0,0,0,0,0,0.0
2022-05-09,227,126,101,0,126,0,0,0.0
2022-05-10,211,139,72,0,139,0,0,0.0
2022-05-11,103,53,50,1,52,1,0,-12.710243635869858
2022-05-12,182,85,97,9,76,0,0,0.0
2022-05-13,224,134,90,0,134,0,0,0.0
2022-05-15,23,11,12,0,11,0,0,0.0
2022-05-16,127,30,97,0,30,0,0,0.0
2022-05-17,253,144,109,0,144,0,0,0.0
2022-05-18,161,55,106,1,54,1,0,-6.808921807981313
2022-05-19,244,149,95,0,149,0,0,0.0
2022-05-20,165,87,78,0,87,0,0,0.0
2022-05-22,2,2,0,0,2,0,0,0.0
2022-05-23,189,96,93,0,96,0,0,0.0
2022-05-24,220,117,103,0,117,0,0,0.0
2022-05-25,218,107,111,0,107,0,0,0.0
2022-05-26,206,95,111,0,95,0,0,0.0
2022-05-27,211,117,94,0,117,0,0,0.0
2022-05-29,24,8,16,0,8,0,0,0.0
2022-05-30,243,131,112,0,131,0,0,0.0
2022-05-31,188,74,114,0,74,0,0,0.0
2022-06-01,245,137,108,2,135,0,0,0.0
2022-06-02,154,48,106,1,47,1,0,-8.168980958804944
2022-06-03,204,129,75,0,129,0,0,0.0
2022-06-05,22,12,10,0,12,0,0,0.0
2022-06-06,232,127,105,0,127,0,0,0.0
2022-06-07,223,115,108,0,115,0,0,0.0
2022-06-08,171,56,115,1,55,1,0,-10.72814386904436
2022-06-09,219,133,86,0,133,0,0,0.0
2022-06-10,213,117,96,0,117,0,0,0.0
2022-06-12,21,12,9,0,12,0,0,0.0
2022-06-13,211,109,102,0,109,0,0,0.0
2022-06-14,140,29,111,1,28,1,1,10.010496821644878
2022-06-15,255,138,117,0,138,0,0,0.0
2022-06-16,242,136,106,0,136,0,0,0.0
2022-06-17,236,140,96,0,140,0,0,0.0
2022-06-19,20,12,8,0,12,0,0,0.0
2022-06-20,145,54,91,0,54,0,0,0.0
2022-06-21,206,116,90,0,116,0,0,0.0
2022-06-22,216,107,109,0,107,0,0,0.0
2022-06-23,184,74,110,0,74,0,0,0.0
2022-06-24,216,120,96,0,120,0,0,0.0
2022-06-26,12,1,11,0,1,0,0,0.0
2022-06-27,203,104,99,0,104,0,0,0.0
2022-06-28,171,68,103,0,68,0,0,0.0
2022-06-29,171,72,99,0,72,0,0,0.0
2022-06-30,203,127,76,0,127,0,0,0.0
2022-07-01,170,74,96,0,74,0,0,0.0
2022-07-03,12,0,12,0,0,0,0,0.0
2022-07-04,217,117,100,0,117,0,0,0.0
2022-07-05,178,65,113,0,65,0,0,0.0
2022-07-06,135,24,111,1,23,1,1,0.7195360584827641
2022-07-07,147,42,105,1,41,1,0,-9.039173587177999
2022-07-08,135,46,89,1,45,1,0,-12.011990137261536
2022-07-10,19,0,19,0,0,0,0,0.0
2022-07-11,256,154,102,0,154,0,0,0.0
2022-07-12,226,121,105,0,121,0,0,0.0
2022-07-13,224,112,112,4,108,0,0,0.0
2022-07-14,239,138,101,0,138,0,0,0.0
2022-07-15,188,114,74,0,114,0,0,0.0
2022-07-17,23,10,13,0,10,0,0,0.0
2022-07-18,268,153,115,0,153,0,0,0.0
2022-07-19,231,128,103,0,128,0,0,0.0
2022-07-20,248,136,112,0,136,0,0,0.0
2022-07-21,259,150,109,5,145,0,0,0.0
2022-07-22,221,138,83,2,136,0,0,0.0
2022-07-24,25,12,13,0,12,0,0,0.0
2022-07-25,219,129,90,0,129,0,0,0.0
2022-07-26,234,129,105,0,129,0,0,0.0
2022-07-27,236,133,103,0,133,0,0,0.0
2022-07-28,176,73,103,0,73,0,0,0.0
2022-07-29,208,136,72,0,136,0,0,0.0
2022-07-31,25,12,13,0,12,0,0,0.0
2022-08-01,233,121,112,0,121,0,0,0.0
2022-08-02,120,15,105,1,14,1,0,-9.801551512774317
2022-08-03,217,142,75,0,142,0,0,0.0
2022-08-04,245,135,110,0,135,0,0,0.0
2022-08-05,219,126,93,0,126,0,0,0.0
2022-08-07,16,6,10,0,6,0,0,0.0
2022-08-08,180,121,59,0,121,0,0,0.0
2022-08-09,175,71,104,0,71,0,0,0.0
2022-08-10,124,21,103,1,20,1,1,38.63560936121136
2022-08-11,219,126,93,0,126,0,0,0.0
2022-08-12,199,103,96,0,103,0,0,0.0
2022-08-14,23,11,12,0,11,0,0,0.0
2022-08-15,245,140,105,0,140,0,0,0.0
2022-08-16,253,148,105,0,148,0,0,0.0
2022-08-17,137,34,103,1,33,1,0,-10.968612374461236
2022-08-18,227,130,97,0,130,0,0,0.0
2022-08-19,169,73,96,0,73,0,0,0.0
2022-08-21,10,0,10,0,0,0,0,0.0
2022-08-22,252,143,109,0,143,0,0,0.0
2022-08-23,165,50,115,1,49,1,1,15.718188598226693
2022-08-24,166,62,104,0,62,0,0,0.0
2022-08-25,205,96,109,0,96,0,0,0.0
2022-08-26,145,49,96,1,48,1,0,-10.332314707472223
2022-08-28,13,0,13,0,0,0,0,0.0
2022-08-29,255,155,100,0,155,0,0,0.0
2022-08-30,218,111,107,0,111,0,0,0.0
2022-08-31,202,95,107,0,95,0,0,0.0
2022-09-01,221,112,109,0,112,0,0,0.0
2022-09-02,144,49,95,0,49,0,0,0.0
2022-09-04,17,0,17,0,0,0,0,0.0
2022-09-05,178,96,82,0,96,0,0,0.0
2022-09-06,247,143,104,0,143,0,0,0.0
2022-09-07,255,142,113,0,142,0,0,0.0
2022-09-08,127,42,85,0,42,0,0,0.0
2022-09-09,202,107,95,2,105,0,0,0.0
2022-09-11,18,4,14,0,4,0,0,0.0
2022-09-12,197,106,91,0,106,0,0,0.0
2022-09-13,129,44,85,1,43,1,0,-26.724522779476267
2022-09-14,173,73,100,0,73,0,0,0.0
2022-09-15,159,70,89,0,70,0,0,0.0
2022-09-16,206,133,73,0,133,0,0,0.0
2022-09-18,27,11,16,0,11,0,0,0.0
2022-09-19,205,101,104,0,101,0,0,0.0
2022-09-20,129,22,107,0,22,0,0,0.0
2022-09-21,245,115,130,0,115,0,0,0.0
2022-09-22,231,134,97,5,129,0,0,0.0
2022-09-23,233,141,92,0,141,0,0,0.0
2022-09-25,20,12,8,0,12,0,0,0.0
2022-09-26,257,148,109,0,148,0,0,0.0
2022-09-27,230,126,104,0,126,0,0,0.0
2022-09-28,237,128,109,0,128,0,0,0.0
2022-09-29,184,86,98,0,86,0,0,0.0
2022-09-30,210,124,86,0,124,0,0,0.0
2022-10-02,25,9,16,0,9,0,0,0.0
2022-10-03,259,145,114,0,145,0,0,0.0
2022-10-04,249,141,108,0,141,0,0,0.0
2022-10-05,170,92,78,0,92,0,0,0.0
2022-10-06,214,149,65,0,149,0,0,0.0
2022-10-07,176,113,63,0,113,0,0,0.0
2022-10-09,15,6,9,0,6,0,0,0.0
2022-10-10,223,134,89,0,134,0,0,0.0
2022-10-11,215,117,98,0,117,0,0,0.0
2022-10-12,240,127,113,0,127,0,0,0.0
2022-10-13,101,46,55,0,46,0,0,0.0
2022-10-14,230,140,90,0,140,0,0,0.0
2022-10-16,18,12,6,0,12,0,0,0.0
2022-10-17,176,112,64,0,112,0,0,0.0
2022-10-18,245,138,107,0,138,0,0,0.0
2022-10-19,207,141,66,0,141,0,0,0.0
2022-10-20,231,124,107,0,124,0,0,0.0
2022-10-21,153,57,96,2,55,1,1,31.643322143111693
2022-10-23,14,0,14,0,0,0,0,0.0
2022-10-24,181,150,31,0,150,0,0,0.0
2022-10-25,154,126,28,4,122,0,0,0.0
2022-10-26,161,119,42,0,119,0,0,0.0
2022-10-27,174,84,90,0,84,0,0,0.0
2022-10-28,148,71,77,0,71,0,0,0.0
2022-10-30,9,6,3,0,6,0,0,0.0
2022-10-31,226,113,113,0,113,0,0,0.0
2022-11-01,249,145,104,0,145,0,0,0.0
2022-11-02,147,34,113,1,33,1,1,25.409911780042073
2022-11-03,164,62,102,1,61,1,1,13.131965171514546
2022-11-04,75,19,56,1,18,1,1,10.519583541079204
2022-11-06,0,0,0,0,0,0,0,0.0
2022-11-07,127,60,67,1,59,1,0,-9.895434936328982
2022-11-08,175,64,111,1,63,1,1,9.915206421204212
2022-11-09,155,51,104,1,50,1,0,-10.435180587214203
2022-11-10,165,51,114,1,50,1,1,17.351091616229752
2022-11-11,228,132,96,1,131,0,0,0.0
2022-11-13,0,0,0,0,0,0,0,0.0
2022-11-14,89,55,34,1,54,1,0,-11.95272181521628
2022-11-15,152,43,109,1,42,1,1,20.228197493153818
2022-11-16,149,37,112,1,36,1,1,16.169995828250265
2022-11-17,150,52,98,1,51,1,1,13.577346174421372
2022-11-18,118,22,96,1,21,1,0,-9.813663350678532
2022-11-20,15,0,15,0,0,0,0,0.0
2022-11-21,148,53,95,1,52,1,1,-1.4237768579680923
2022-11-22,165,52,113,3,49,1,0,-10.749152937538932
2022-11-23,148,40,108,1,39,1,0,-10.714553667206722
2022-11-24,244,135,109,0,135,0,0,0.0
2022-11-25,236,145,91,0,145,0,0,0.0
2022-11-27,10,0,10,0,0,0,0,0.0
2022-11-28,220,118,102,0,118,0,0,0.0
2022-11-29,152,44,108,10,34,1,1,8.423019884959553
2022-11-30,137,39,98,1,38,1,0,-11.734854099673234
2022-12-01,239,124,115,0,124,0,0,0.0
2022-12-02,166,63,103,1,62,1,1,23.817018327123527
2022-12-04,2,0,2,0,0,0,0,0.0
2022-12-05,219,157,62,1,156,0,0,0.0
2022-12-06,153,47,106,1,46,1,0,-10.90906080068542
2022-12-07,113,8,105,1,7,1,1,0.6336071762264832
2022-12-08,141,36,105,3,33,1,0,-10.544056632436662
2022-12-09,143,47,96,1,46,1,1,1.2958208649739154
2022-12-11,17,0,17,0,0,0,0,0.0
2022-12-12,201,104,97,1,103,0,0,0.0
2022-12-13,116,23,93,2,21,1,1,19.30781790099236
2022-12-14,163,58,105,4,54,1,0,-10.480057114867938
2022-12-15,171,57,114,1,56,1,0,-12.145833962451222
2022-12-16,132,36,96,2,34,1,0,-12.049114973580407
2022-12-18,12,0,12,0,0,0,0,0.0
2022-12-19,174,142,32,0,142,0,0,0.0
2022-12-20,230,121,109,15,106,0,0,0.0
2022-12-21,237,141,96,0,141,0,0,0.0
2022-12-22,236,126,110,8,118,0,0,0.0
2022-12-23,112,17,95,5,12,1,1,12.306756047011424
2022-12-25,11,0,11,0,0,0,0,0.0
2022-12-26,263,152,111,0,152,0,0,0.0
2022-12-27,208,126,82,0,126,0,0,0.0
2022-12-28,248,133,115,0,133,0,0,0.0
2022-12-29,135,26,109,4,22,1,1,8.985461984426506
2022-12-30,117,21,96,3,18,1,1,6.50301293222908
2023-01-01,8,0,8,0,0,0,0,0.0
2023-01-02,155,116,39,0,116,0,0,0.0
2023-01-03,133,19,114,1,18,1,0,-7.607654969114797
2023-01-04,173,62,111,8,54,1,1,7.158698933575083
2023-01-05,117,14,103,1,13,1,0,-12.692748671357934
2023-01-06,125,29,96,2,27,1,1,1.395120753564668
2023-01-08,17,0,17,0,0,0,0,0.0
2023-01-09,147,47,100,1,46,1,0,-9.060582071243097
2023-01-10,107,35,72,3,32,1,1,8.157788561982752
2023-01-11,213,110,103,10,100,0,0,0.0
2023-01-12,155,48,107,1,47,1,0,-6.561267558459826
2023-01-13,119,37,82,2,35,1,1,9.605136420483083
2023-01-15,15,0,15,0,0,0,0,0.0
2023-01-16,161,47,114,0,47,0,0,0.0
2023-01-17,150,35,115,1,34,1,0,-11.512090130278597
2023-01-18,145,44,101,1,43,1,0,-11.099138327687541
2023-01-19,145,46,99,3,43,1,0,-11.730499622215705
2023-01-20,252,156,96,0,156,0,0,0.0
2023-01-22,16,0,16,0,0,0,0,0.0
2023-01-23,256,148,108,0,148,0,0,0.0
2023-01-24,262,153,109,0,153,0,0,0.0
2023-01-25,253,143,110,0,143,0,0,0.0
2023-01-26,158,48,110,5,43,1,0,-13.14683974324348
2023-01-27,142,46,96,0,46,0,0,0.0
2023-01-29,6,0,6,0,0,0,0,0.0
2023-01-30,249,137,112,0,137,0,0,0.0
2023-01-31,257,144,113,0,144,0,0,0.0
2023-02-01,231,121,110,2,119,1,1,19.708696578129214
2023-02-02,230,120,110,1,119,0,0,0.0
2023-02-03,133,44,89,2,42,1,1,11.572401543645467
2023-02-05,4,0,4,0,0,0,0,0.0
2023-02-06,158,141,17,0,141,0,0,0.0
2023-02-07,151,59,92,1,58,1,1,9.68849198038672
2023-02-08,139,48,91,6,42,1,1,5.928913493376802
2023-02-09,136,37,99,1,36,1,0,-10.67189713061871
2023-02-10,144,50,94,2,48,1,0,-9.74200358883213
2023-02-12,13,0,13,0,0,0,0,0.0
2023-02-13,204,100,104,0,100,0,0,0.0
2023-02-14,144,38,106,1,37,1,0,-7.938207227036345
2023-02-15,148,43,105,1,42,1,1,12.462503841607152
2023-02-16,146,41,105,5,36,1,1,9.344193795890543
2023-02-17,150,54,96,2,52,1,1,9.06066088636501
2023-02-19,15,0,15,0,0,0,0,0.0
2023-02-20,186,86,100,0,86,0,0,0.0
2023-02-21,139,33,106,1,32,1,0,-11.301297650983683
2023-02-22,224,122,102,9,113,1,1,6.7249598385912535
2023-02-23,132,33,99,1,32,1,1,5.357818034281583
2023-02-24,127,53,74,1,52,1,0,-2.792615329893551
2023-02-26,12,0,12,0,0,0,0,0.0
2023-02-27,238,140,98,0,140,0,0,0.0
2023-02-28,126,28,98,4,24,1,1,5.512634785699744
2023-03-01,167,55,112,3,52,1,0,-9.977435647301784
2023-03-02,133,35,98,3,32,1,1,5.945054881243387
2023-03-03,109,52,57,5,47,1,1,3.8890698019323944
2023-03-05,16,0,16,0,0,0,0,0.0
2023-03-06,166,55,111,3,52,1,0,-9.108859423663667
2023-03-07,165,57,108,10,47,1,1,7.3867935011786905
2023-03-08,143,36,107,1,35,1,1,7.30577605660911
2023-03-09,178,67,111,1,66,1,1,9.86942060459644
2023-03-10,151,55,96,1,54,1,0,-8.342512618838168
2023-03-12,4,0,4,0,0,0,0,0.0
2023-03-13,139,112,27,5,107,1,1,21.068055061614135
2023-03-14,110,2,108,2,0,2,2,41.101461273884105
2023-03-15,106,2,104,2,0,2,1,13.195540567226347
2023-03-16,110,2,108,2,0,2,0,-31.499067130315296
2023-03-17,128,32,96,1,31,1,1,13.476979899206134
2023-03-19,18,0,18,0,0,0,0,0.0
2023-03-20,159,78,81,1,77,0,0,0.0
2023-03-21,148,52,96,1,51,1,0,-9.867617906065936
2023-03-22,129,40,89,1,39,1,0,-8.35076429021902
2023-03-23,160,52,108,1,51,1,0,-9.415981605774949
2023-03-24,127,32,95,1,31,1,0,-9.571175138754473
2023-03-26,3,0,3,0,0,0,0,0.0
2023-03-27,185,125,60,0,125,0,0,0.0
2023-03-28,173,62,111,4,58,1,1,7.372700437785407
2023-03-29,170,56,114,5,51,1,1,5.617107665134035
2023-03-30,159,47,112,1,46,1,0,-8.469065283284754
2023-03-31,117,21,96,1,20,1,0,-12.262919900230328
2023-04-02,1,0,1,0,0,0,0,0.0
2023-04-03,247,147,100,0,147,0,0,0.0
2023-04-04,163,58,105,1,57,1,1,9.674125235483732
2023-04-05,149,52,97,1,51,1,0,-9.627524141016425
2023-04-06,136,41,95,1,40,1,0,-11.486358303740268
2023-04-07,119,49,70,1,48,1,0,-9.664628013746224
2023-04-09,5,0,5,0,0,0,0,0.0
2023-04-10,242,142,100,0,142,0,0,0.0
2023-04-11,239,124,115,0,124,0,0,0.0
2023-04-12,154,48,106,1,47,1,1,15.064543556129076
2023-04-13,96,47,49,1,46,1,1,11.999092459230404
2023-04-14,156,63,93,1,62,1,1,9.6603233138383
2023-04-16,17,0,17,0,0,0,0,0.0
2023-04-17,206,124,82,1,123,0,0,0.0
2023-04-18,228,144,84,1,143,0,0,0.0
2023-04-19,230,135,95,0,135,0,0,0.0
2023-04-20,124,45,79,1,44,1,0,-7.941411790633266
2023-04-21,152,57,95,3,54,1,1,7.782221676370163
2023-04-23,17,0,17,0,0,0,0,0.0
2023-04-24,232,141,91,0,141,0,0,0.0
2023-04-25,199,111,88,1,110,0,0,0.0
2023-04-26,143,35,108,1,34,1,0,-8.447715805026208
2023-04-27,118,40,78,1,39,1,0,-13.531198103049867
2023-04-28,219,131,88,8,123,0,0,0.0
2023-04-30,23,12,11,0,12,0,0,0.0
2023-05-01,243,136,107,0,136,0,0,0.0
2023-05-02,154,50,104,3,47,1,1,10.728710497971356
2023-05-03,168,72,96,9,63,1,0,-13.666467019482972
2023-05-04,103,63,40,1,62,1,1,13.657163434313343
2023-05-05,149,53,96,1,52,1,0,-10.576732159716904
2023-05-07,18,0,18,0,0,0,0,0.0
2023-05-08,221,132,89,0,132,0,0,0.0
2023-05-09,178,83,95,0,83,0,0,0.0
2023-05-10,136,35,101,1,34,1,0,-11.430641847159153
2023-05-11,245,144,101,0,144,0,0,0.0
2023-05-12,190,119,71,0,119,0,0,0.0
2023-05-14,18,12,6,0,12,0,0,0.0
2023-05-15,166,69,97,0,69,0,0,0.0
2023-05-16,250,141,109,0,141,0,0,0.0
2023-05-17,225,128,97,0,128,0,0,0.0
2023-05-18,200,116,84,0,116,0,0,0.0
2023-05-19,223,127,96,0,127,0,0,0.0
2023-05-21,31,12,19,0,12,0,0,0.0
2023-05-22,195,124,71,0,124,0,0,0.0
2023-05-23,140,37,103,1,36,0,0,0.0
2023-05-24,248,138,110,0,138,0,0,0.0
2023-05-25,234,133,101,0,133,0,0,0.0
2023-05-26,217,127,90,0,127,0,0,0.0
2023-05-28,14,12,2,0,12,0,0,0.0
2023-05-29,261,155,106,0,155,0,0,0.0
2023-05-30,163,73,90,0,73,0,0,0.0
2023-05-31,146,59,87,4,55,1,1,15.33648076594013
2023-06-01,133,43,90,1,42,1,1,1.5349328129610542
2023-06-02,140,56,84,1,55,1,0,-11.527930772700236
2023-06-04,12,0,12,0,0,0,0,0.0
2023-06-05,110,19,91,1,18,1,1,10.957197651159252
2023-06-06,158,84,74,0,84,0,0,0.0
2023-06-07,172,62,110,3,59,1,0,-9.064080437950507
2023-06-08,247,138,109,0,138,0,0,0.0
2023-06-09,186,90,96,0,90,0,0,0.0
2023-06-11,13,4,9,0,4,0,0,0.0
2023-06-12,241,158,83,0,158,0,0,0.0
2023-06-13,125,19,106,1,18,1,0,-14.521579676878703
2023-06-14,201,91,110,3,88,1,0,-13.504329262014647
2023-06-15,246,133,113,0,133,0,0,0.0
2023-06-16,234,139,95,0,139,0,0,0.0
2023-06-18,20,12,8,0,12,0,0,0.0
2023-06-19,208,143,65,0,143,0,0,0.0
2023-06-20,258,154,104,0,154,0,0,0.0
2023-06-21,246,132,114,0,132,0,0,0.0
2023-06-22,224,140,84,0,140,0,0,0.0
2023-06-23,233,143,90,0,143,0,0,0.0
2023-06-25,24,11,13,0,11,0,0,0.0
2023-06-26,233,126,107,0,126,0,0,0.0
2023-06-27,233,135,98,0,135,0,0,0.0
2023-06-28,181,86,95,0,86,0,0,0.0
2023-06-29,130,48,82,0,48,0,0,0.0
2023-06-30,219,136,83,0,136,0,0,0.0
2023-07-02,24,12,12,0,12,0,0,0.0
2023-07-03,226,126,100,0,126,0,0,0.0
2023-07-04,233,144,89,0,144,0,0,0.0
2023-07-05,237,128,109,0,128,0,0,0.0
2023-07-06,198,88,110,0,88,0,0,0.0
2023-07-07,227,135,92,3,132,0,0,0.0
2023-07-09,10,10,0,0,10,0,0,0.0
2023-07-10,240,142,98,0,142,0,0,0.0
2023-07-11,216,105,111,0,105,0,0,0.0
2023-07-12,238,125,113,2,123,0,0,0.0
2023-07-13,240,137,103,0,137,0,0,0.0
2023-07-14,207,112,95,0,112,0,0,0.0
2023-07-16,14,11,3,0,11,0,0,0.0
2023-07-17,242,137,105,0,137,0,0,0.0
2023-07-18,144,36,108,1,35,1,0,-17.71773673744528
2023-07-19,221,113,108,0,113,0,0,0.0
2023-07-20,258,149,109,0,149,0,0,0.0
2023-07-21,190,97,93,0,97,0,0,0.0
2023-07-23,23,12,11,0,12,0,0,0.0
2023-07-24,266,151,115,0,151,0,0,0.0
2023-07-25,195,113,82,0,113,0,0,0.0
2023-07-26,248,141,107,0,141,0,0,0.0
2023-07-27,238,139,99,0,139,0,0,0.0
2023-07-28,171,122,49,0,122,0,0,0.0
2023-07-30,28,12,16,0,12,0,0,0.0
2023-07-31,199,96,103,0,96,0,0,0.0
2023-08-01,224,125,99,0,125,0,0,0.0
2023-08-02,219,130,89,0,130,0,0,0.0
2023-08-03,199,95,104,0,95,0,0,0.0
2023-08-04,214,123,91,0,123,0,0,0.0
2023-08-06,26,12,14,0,12,0,0,0.0
2023-08-07,228,123,105,0,123,0,0,0.0
2023-08-08,217,104,113,0,104,0,0,0.0
2023-08-09,247,142,105,0,142,0,0,0.0
2023-08-10,230,121,109,0,121,0,0,0.0
2023-08-11,154,96,58,0,96,0,0,0.0
2023-08-13,20,11,9,0,11,0,0,0.0
2023-08-14,185,134,51,0,134,0,0,0.0
2023-08-15,168,75,93,0,75,0,0,0.0
2023-08-16,226,123,103,0,123,0,0,0.0
2023-08-17,246,132,114,0,132,0,0,0.0
2023-08-18,223,127,96,0,127,0,0,0.0
2023-08-20,19,12,7,0,12,0,0,0.0
2023-08-21,176,120,56,0,120,0,0,0.0
2023-08-22,246,143,103,0,143,0,0,0.0
2023-08-23,256,147,109,0,147,0,0,0.0
2023-08-24,193,85,108,0,85,0,0,0.0
2023-08-25,221,126,95,0,126,0,0,0.0
2023-08-27,28,12,16,0,12,0,0,0.0
2023-08-28,159,65,94,0,65,0,0,0.0
2023-08-29,243,155,88,0,155,0,0,0.0
2023-08-30,234,119,115,0,119,0,0,0.0
2023-08-31,220,121,99,0,121,0,0,0.0
2023-09-01,185,112,73,0,112,0,0,0.0
2023-09-03,26,12,14,0,12,0,0,0.0
2023-09-04,183,100,83,0,100,0,0,0.0
2023-09-05,264,153,111,0,153,0,0,0.0
2023-09-06,249,138,111,0,138,0,0,0.0
2023-09-07,157,59,98,0,59,0,0,0.0
2023-09-08,214,123,91,0,123,0,0,0.0
2023-09-10,12,12,0,0,12,0,0,0.0
2023-09-11,168,92,76,0,92,0,0,0.0
2023-09-12,189,82,107,0,82,0,0,0.0
2023-09-13,175,70,105,0,70,0,0,0.0
2023-09-14,197,97,100,0,97,0,0,0.0
2023-09-15,127,54,73,0,54,0,0,0.0
2023-09-17,30,12,18,0,12,0,0,0.0
2023-09-18,236,132,104,0,132,0,0,0.0
2023-09-19,240,132,108,0,132,0,0,0.0
2023-09-20,261,155,106,0,155,0,0,0.0
2023-09-21,241,138,103,0,138,0,0,0.0
2023-09-22,207,111,96,0,111,0,0,0.0
2023-09-24,20,7,13,0,7,0,0,0.0
2023-09-25,202,141,61,0,141,0,0,0.0
2023-09-26,195,95,100,0,95,0,0,0.0
2023-09-27,211,152,59,0,152,0,0,0.0
2023-09-28,191,89,102,0,89,0,0,0.0
2023-09-29,233,137,96,0,137,0,0,0.0
2023-10-01,29,12,17,0,12,0,0,0.0
2023-10-02,240,134,106,0,134,0,0,0.0
2023-10-03,256,133,123,0,133,0,0,0.0
2023-10-04,228,127,101,0,127,0,0,0.0
2023-10-05,246,137,109,0,137,0,0,0.0
2023-10-06,166,70,96,0,70,0,0,0.0
2023-10-08,17,12,5,0,12,0,0,0.0
2023-10-09,152,140,12,0,140,0,0,0.0
2023-10-10,243,140,103,0,140,0,0,0.0
2023-10-11,218,118,100,0,118,0,0,0.0
2023-10-12,219,127,92,0,127,0,0,0.0
2023-10-13,167,77,90,0,77,0,0,0.0
2023-10-15,25,11,14,0,11,0,0,0.0
2023-10-16,155,107,48,0,107,0,0,0.0
2023-10-17,136,77,59,0,77,0,0,0.0
2023-10-18,256,151,105,0,151,0,0,0.0
2023-10-19,174,96,78,0,96,0,0,0.0
2023-10-20,182,86,96,0,86,0,0,0.0
2023-10-22,14,12,2,0,12,0,0,0.0
2023-10-23,232,148,84,0,148,0,0,0.0
2023-10-24,221,132,89,0,132,0,0,0.0
2023-10-25,206,138,68,0,138,0,0,0.0
2023-10-26,229,132,97,0,132,0,0,0.0
2023-10-27,221,129,92,0,129,0,0,0.0
2023-10-29,29,12,17,0,12,0,0,0.0
2023-10-30,214,142,72,0,142,0,0,0.0
2023-10-31,261,147,114,0,147,0,0,0.0
2023-11-01,261,146,115,0,146,0,0,0.0
2023-11-02,252,148,104,0,148,0,0,0.0
2023-11-03,157,67,90,0,67,0,0,0.0
2023-11-05,13,0,13,0,0,0,0,0.0
2023-11-06,181,75,106,0,75,0,0,0.0
2023-11-07,185,96,89,0,96,0,0,0.0
2023-11-08,232,131,101,0,131,0,0,0.0
2023-11-09,175,115,60,0,115,0,0,0.0
2023-11-10,229,151,78,0,151,0,0,0.0
2023-11-12,18,0,18,0,0,0,0,0.0
2023-11-13,216,113,103,0,113,0,0,0.0
2023-11-14,210,120,90,0,120,0,0,0.0
2023-11-15,257,158,99,0,158,0,0,0.0
2023-11-16,210,156,54,0,156,0,0,0.0
2023-11-17,186,157,29,0,157,0,0,0.0
2023-11-19,17,0,17,0,0,0,0,0.0
2023-11-20,187,86,101,0,86,0,0,0.0
2023-11-21,251,142,109,0,142,0,0,0.0
2023-11-22,234,139,95,0,139,0,0,0.0
2023-11-23,210,102,108,0,102,0,0,0.0
2023-11-24,177,103,74,0,103,0,0,0.0
2023-11-26,12,0,12,0,0,0,0,0.0
2023-11-27,209,103,106,0,103,0,0,0.0
2023-11-28,230,122,108,0,122,0,0,0.0
2023-11-29,253,141,112,0,141,0,0,0.0
2023-11-30,239,152,87,0,152,0,0,0.0
2023-12-01,223,127,96,0,127,0,0,0.0
2023-12-03,13,0,13,0,0,0,0,0.0
2023-12-04,249,150,99,0,150,0,0,0.0
2023-12-05,233,151,82,0,151,0,0,0.0
2023-12-06,192,99,93,0,99,0,0,0.0
2023-12-07,269,142,127,0,142,0,0,0.0
2023-12-08,244,138,106,0,138,0,0,0.0
2023-12-10,6,0,6,0,0,0,0,0.0
2023-12-11,186,77,109,0,77,0,0,0.0
2023-12-12,253,143,110,0,143,0,0,0.0
2023-12-13,237,118,119,0,118,0,0,0.0
2023-12-14,188,78,110,0,78,0,0,0.0
2023-12-15,239,146,93,0,146,0,0,0.0
2023-12-17,18,0,18,0,0,0,0,0.0
2023-12-18,249,140,109,0,140,0,0,0.0
2023-12-19,266,151,115,0,151,0,0,0.0
2023-12-20,241,135,106,0,135,0,0,0.0
2023-12-21,247,153,94,0,153,0,0,0.0
2023-12-22,244,154,90,0,154,0,0,0.0
2023-12-24,0,0,0,0,0,0,0,0.0
2023-12-25,91,0,91,0,0,0,0,0.0
2023-12-26,209,137,72,0,137,0,0,0.0
2023-12-27,198,94,104,0,94,0,0,0.0
2023-12-28,231,125,106,0,125,0,0,0.0
2023-12-29,231,149,82,0,149,0,0,0.0
2024-01-01,12,0,12,0,0,0,0,0.0
2024-01-02,236,126,110,0,126,0,0,0.0
2024-01-03,234,149,85,0,149,0,0,0.0
2024-01-04,265,155,110,0,155,0,0,0.0
2024-01-05,248,152,96,0,152,0,0,0.0
2024-01-07,12,0,12,0,0,0,0,0.0
2024-01-08,194,130,64,0,130,0,0,0.0
2024-01-09,247,135,112,0,135,0,0,0.0
2024-01-10,235,133,102,0,133,0,0,0.0
2024-01-11,236,103,133,0,103,0,0,0.0
2024-01-12,231,135,96,0,135,0,0,0.0
2024-01-14,16,0,16,0,0,0,0,0.0
2024-01-15,262,151,111,0,151,0,0,0.0
2024-01-16,266,152,114,0,152,0,0,0.0
2024-01-17,230,134,96,0,134,0,0,0.0
2024-01-18,232,137,95,0,137,0,0,0.0
2024-01-19,221,126,95,0,126,0,0,0.0
2024-01-21,1,0,1,0,0,0,0,0.0
2024-01-22,200,131,69,0,131,0,0,0.0
2024-01-23,235,145,90,0,145,0,0,0.0
2024-01-24,238,131,107,0,131,0,0,0.0
2024-01-25,232,124,108,0,124,0,0,0.0
2024-01-26,212,142,70,0,142,0,0,0.0
2024-01-28,15,0,15,0,0,0,0,0.0
2024-01-29,222,112,110,0,112,0,0,0.0
2024-01-30,204,101,103,0,101,0,0,0.0
2024-01-31,262,156,106,0,156,0,0,0.0
2024-02-01,232,133,99,0,133,0,0,0.0
2024-02-02,179,146,33,0,146,0,0,0.0
2024-02-04,12,0,12,0,0,0,0,0.0
2024-02-05,162,101,61,0,101,0,0,0.0
2024-02-06,250,140,110,0,140,0,0,0.0
2024-02-07,189,90,99,0,90,0,0,0.0
2024-02-08,229,129,100,0,129,0,0,0.0
2024-02-09,210,122,88,0,122,0,0,0.0
2024-02-11,12,0,12,0,0,0,0,0.0
2024-02-12,212,127,85,0,127,0,0,0.0
2024-02-13,245,125,120,0,125,0,0,0.0
2024-02-14,222,111,111,0,111,0,0,0.0
2024-02-15,191,83,108,0,83,0,0,0.0
2024-02-16,211,115,96,0,115,0,0,0.0
2024-02-18,3,0,3,0,0,0,0,0.0
2024-02-19,209,102,107,0,102,0,0,0.0
2024-02-20,258,152,106,0,152,0,0,0.0
2024-02-21,238,147,91,0,147,0,0,0.0
2024-02-22,248,154,94,0,154,0,0,0.0
2024-02-23,179,106,73,0,106,0,0,0.0
2024-02-25,11,0,11,0,0,0,0,0.0
2024-02-26,177,153,24,0,153,0,0,0.0
2024-02-27,243,140,103,0,140,0,0,0.0
2024-02-28,188,82,106,0,82,0,0,0.0
2024-02-29,261,153,108,0,153,0,0,0.0
2024-03-01,234,138,96,0,138,0,0,0.0
2024-03-03,15,0,15,0,0,0,0,0.0
2024-03-04,156,54,102,0,54,0,0,0.0
2024-03-05,180,102,78,0,102,0,0,0.0
2024-03-06,249,147,102,0,147,0,0,0.0
2024-03-07,240,126,114,0,126,0,0,0.0
2024-03-08,164,76,88,0,76,0,0,0.0
2024-03-10,17,5,12,0,5,0,0,0.0
2024-03-11,197,125,72,0,125,0,0,0.0
2024-03-12,132,31,101,0,31,0,0,0.0
2024-03-13,249,152,97,0,152,0,0,0.0
2024-03-14,243,131,112,0,131,0,0,0.0
2024-03-15,201,108,93,0,108,0,0,0.0
2024-03-17,13,12,1,0,12,0,0,0.0
2024-03-18,208,111,97,0,111,0,0,0.0
2024-03-19,250,142,108,0,142,0,0,0.0
2024-03-20,260,133,127,0,133,0,0,0.0
2024-03-21,241,135,106,0,135,0,0,0.0
2024-03-22,223,127,96,0,127,0,0,0.0
2024-03-24,25,11,14,0,11,0,0,0.0
2024-03-25,229,132,97,0,132,0,0,0.0
2024-03-26,221,123,98,0,123,0,0,0.0
2024-03-27,227,125,102,0,125,0,0,0.0
2024-03-28,151,100,51,0,100,0,0,0.0
2024-03-29,177,93,84,0,93,0,0,0.0
2024-03-31,22,5,17,0,5,0,0,0.0
2024-04-01,244,148,96,0,148,0,0,0.0
2024-04-02,196,97,99,0,97,0,0,0.0
2024-04-03,233,152,81,0,152,0,0,0.0
2024-04-04,188,102,86,0,102,0,0,0.0
2024-04-05,159,93,66,0,93,0,0,0.0
2024-04-07,12,12,0,0,12,0,0,0.0
2024-04-08,198,98,100,0,98,0,0,0.0
2024-04-09,234,137,97,0,137,0,0,0.0
2024-04-10,207,135,72,0,135,0,0,0.0
2024-04-11,220,138,82,0,138,0,0,0.0
2024-04-12,204,134,70,0,134,0,0,0.0
2024-04-14,23,12,11,0,12,0,0,0.0
2024-04-15,124,26,98,0,26,0,0,0.0
2024-04-16,205,107,98,0,107,0,0,0.0
2024-04-17,203,117,86,0,117,0,0,0.0
2024-04-18,243,156,87,0,156,0,0,0.0
2024-04-19,164,74,90,0,74,0,0,0.0
2024-04-21,7,7,0,0,7,0,0,0.0
2024-04-22,205,146,59,0,146,0,0,0.0
2024-04-23,206,106,100,0,106,0,0,0.0
2024-04-24,231,136,95,0,136,0,0,0.0
2024-04-25,144,43,101,0,43,0,0,0.0
2024-04-26,204,120,84,0,120,0,0,0.0
2024-04-28,12,12,0,0,12,0,0,0.0
2024-04-29,211,122,89,0,122,0,0,0.0
2024-04-30,205,109,96,0,109,0,0,0.0
2024-05-01,206,88,118,0,88,0,0,0.0
2024-05-02,260,152,108,0,152,0,0,0.0
2024-05-03,235,139,96,0,139,0,0,0.0
2024-05-05,30,12,18,0,12,0,0,0.0
2024-05-06,257,143,114,0,143,0,0,0.0
2024-05-07,259,147,112,0,147,0,0,0.0
2024-05-08,207,94,113,0,94,0,0,0.0
2024-05-09,231,140,91,0,140,0,0,0.0
2024-05-10,172,77,95,0,77,0,0,0.0
2024-05-12,19,1,18,0,1,0,0,0.0
2024-05-13,220,109,111,0,109,0,0,0.0
2024-05-14,133,28,105,0,28,0,0,0.0
2024-05-15,245,148,97,0,148,0,0,0.0
2024-05-16,177,66,111,0,66,0,0,0.0
2024-05-17,204,108,96,0,108,0,0,0.0
2024-05-19,31,12,19,0,12,0,0,0.0
2024-05-20,220,113,107,0,113,0,0,0.0
2024-05-21,187,74,113,0,74,0,0,0.0
2024-05-22,191,92,99,0,92,0,0,0.0
2024-05-23,207,149,58,0,149,0,0,0.0
2024-05-24,229,134,95,0,134,0,0,0.0
2024-05-26,14,12,2,0,12,0,0,0.0
2024-05-27,199,126,73,0,126,0,0,0.0
2024-05-28,247,150,97,0,150,0,0,0.0
2024-05-29,233,137,96,0,137,0,0,0.0
2024-05-30,226,120,106,0,120,0,0,0.0
2024-05-31,196,119,77,0,119,0,0,0.0
2024-06-02,17,12,5,0,12,0,0,0.0
2024-06-03,221,149,72,0,149,0,0,0.0
2024-06-04,250,144,106,0,144,0,0,0.0
2024-06-05,189,79,110,0,79,0,0,0.0
2024-06-06,255,150,105,0,150,0,0,0.0
2024-06-07,165,70,95,0,70,0,0,0.0
2024-06-09,3,2,1,0,2,0,0,0.0
2024-06-10,190,95,95,0,95,0,0,0.0
2024-06-11,255,141,114,0,141,0,0,0.0
2024-06-12,240,119,121,0,119,0,0,0.0
2024-06-13,208,96,112,0,96,0,0,0.0
2024-06-14,167,71,96,0,71,0,0,0.0
2024-06-16,21,5,16,0,5,0,0,0.0
2024-06-17,154,128,26,0,128,0,0,0.0
2024-06-18,130,44,86,0,44,0,0,0.0
2024-06-19,210,141,69,0,141,0,0,0.0
2024-06-20,229,127,102,0,127,0,0,0.0
2024-06-21,221,139,82,0,139,0,0,0.0
2024-06-23,25,12,13,0,12,0,0,0.0
2024-06-24,203,151,52,0,151,0,0,0.0
2024-06-25,193,88,105,0,88,0,0,0.0
2024-06-26,257,150,107,0,150,0,0,0.0
2024-06-27,256,151,105,0,151,0,0,0.0
2024-06-28,231,136,95,0,136,0,0,0.0
2024-06-30,19,12,7,0,12,0,0,0.0
2024-07-01,210,136,74,0,136,0,0,0.0
2024-07-02,227,115,112,0,115,0,0,0.0
2024-07-03,216,110,106,0,110,0,0,0.0
2024-07-04,227,124,103,0,124,0,0,0.0
2024-07-05,195,96,99,0,96,0,0,0.0
2024-07-07,17,10,7,0,10,0,0,0.0
2024-07-08,233,128,105,0,128,0,0,0.0
2024-07-09,265,152,113,0,152,0,0,0.0
2024-07-10,229,127,102,0,127,0,0,0.0
2024-07-11,148,46,102,1,45,1,0,-47.60755472054549
2024-07-12,76,36,40,0,36,0,0,0.0
2024-07-14,16,0,16,0,0,0,0,0.0
2024-07-15,190,134,56,0,134,0,0,0.0
2024-07-16,243,146,97,0,146,0,0,0.0
2024-07-17,224,128,96,0,128,0,0,0.0
2024-07-18,238,148,90,0,148,0,0,0.0
2024-07-19,197,102,95,0,102,0,0,0.0
2024-07-21,28,12,16,0,12,0,0,0.0
2024-07-22,217,139,78,0,139,0,0,0.0
2024-07-23,216,105,111,0,105,0,0,0.0
2024-07-24,221,120,101,0,120,0,0,0.0
2024-07-25,166,55,111,0,55,0,0,0.0
2024-07-26,154,58,96,0,58,0,0,0.0
2024-07-28,20,4,16,0,4,0,0,0.0
2024-07-29,161,52,109,0,52,0,0,0.0
2024-07-30,211,105,106,0,105,0,0,0.0
2024-07-31,212,105,107,0,105,0,0,0.0
2024-08-01,241,139,102,0,139,0,0,0.0
2024-08-02,196,124,72,0,124,0,0,0.0
2024-08-04,21,12,9,0,12,0,0,0.0
2024-08-05,262,149,113,0,149,0,0,0.0
2024-08-06,178,80,98,0,80,0,0,0.0
2024-08-07,253,147,106,0,147,0,0,0.0
2024-08-08,156,68,88,0,68,0,0,0.0
2024-08-09,128,39,89,0,39,0,0,0.0
2024-08-11,20,7,13,0,7,0,0,0.0
2024-08-12,187,122,65,0,122,0,0,0.0
2024-08-13,210,99,111,0,99,0,0,0.0
2024-08-14,215,103,112,0,103,0,0,0.0
2024-08-15,132,44,88,0,44,0,0,0.0
2024-08-16,193,109,84,0,109,0,0,0.0
2024-08-18,24,12,12,0,12,0,0,0.0
2024-08-19,180,80,100,0,80,0,0,0.0
2024-08-20,224,115,109,0,115,0,0,0.0
2024-08-21,233,129,104,0,129,0,0,0.0
2024-08-22,251,148,103,0,148,0,0,0.0
2024-08-23,240,145,95,0,145,0,0,0.0
2024-08-25,28,12,16,0,12,0,0,0.0
2024-08-26,250,147,103,0,147,0,0,0.0
2024-08-27,244,146,98,0,146,0,0,0.0
2024-08-28,243,138,105,0,138,0,0,0.0
2024-08-29,215,121,94,0,121,0,0,0.0
2024-08-30,212,135,77,0,135,0,0,0.0
2024-09-01,30,11,19,0,11,0,0,0.0
2024-09-02,177,115,62,0,115,0,0,0.0
2024-09-03,171,56,115,0,56,0,0,0.0
2024-09-04,215,126,89,0,126,0,0,0.0
2024-09-05,245,144,101,0,144,0,0,0.0
2024-09-06,231,135,96,0,135,0,0,0.0
2024-09-08,22,12,10,0,12,0,0,0.0
2024-09-09,220,112,108,0,112,0,0,0.0
2024-09-10,250,150,100,0,150,0,0,0.0
2024-09-11,184,70,114,0,70,0,0,0.0
2024-09-12,216,108,108,0,108,0,0,0.0
2024-09-13,168,72,96,0,72,0,0,0.0
2024-09-15,21,10,11,0,10,0,0,0.0
2024-09-16,218,138,80,0,138,0,0,0.0
2024-09-17,242,135,107,0,135,0,0,0.0
2024-09-18,234,119,115,0,119,0,0,0.0
2024-09-19,250,137,113,0,137,0,0,0.0
2024-09-20,215,119,96,0,119,0,0,0.0
2024-09-22,12,2,10,0,2,0,0,0.0
2024-09-23,223,120,103,0,120,0,0,0.0
2024-09-24,248,146,102,0,146,0,0,0.0
2024-09-25,243,140,103,0,140,0,0,0.0
2024-09-26,243,136,107,0,136,0,0,0.0
2024-09-27,172,76,96,0,76,0,0,0.0
2024-09-29,28,9,19,0,9,0,0,0.0
2024-09-30,224,147,77,0,147,0,0,0.0
2024-10-01,256,147,109,0,147,0,0,0.0
2024-10-02,259,157,102,0,157,0,0,0.0
2024-10-03,225,130,95,0,130,0,0,0.0
2024-10-04,206,112,94,0,112,0,0,0.0
2024-10-06,1,1,0,0,1,0,0,0.0
2024-10-07,165,50,115,0,50,0,0,0.0
2024-10-08,259,154,105,0,154,0,0,0.0
2024-10-09,232,144,88,0,144,0,0,0.0
2024-10-10,157,81,76,0,81,0,0,0.0
2024-10-11,172,80,92,0,80,0,0,0.0
2024-10-13,26,9,17,0,9,0,0,0.0
2024-10-14,163,100,63,0,100,0,0,0.0
2024-10-15,211,101,110,0,101,0,0,0.0
2024-10-16,233,130,103,0,130,0,0,0.0
2024-10-17,255,149,106,0,149,0,0,0.0
2024-10-18,231,135,96,0,135,0,0,0.0
2024-10-20,18,12,6,0,12,0,0,0.0
2024-10-21,258,153,105,0,153,0,0,0.0
2024-10-22,215,112,103,0,112,0,0,0.0
2024-10-23,226,123,103,0,123,0,0,0.0
2024-10-24,256,148,108,0,148,0,0,0.0
2024-10-25,184,94,90,0,94,0,0,0.0
2024-10-27,12,12,0,0,12,0,0,0.0
2024-10-28,251,151,100,0,151,0,0,0.0
2024-10-29,271,156,115,0,156,0,0,0.0
2024-10-30,155,86,69,0,86,0,0,0.0
2024-10-31,263,152,111,0,152,0,0,0.0
2024-11-01,220,126,94,0,126,0,0,0.0
2024-11-03,4,0,4,0,0,0,0,0.0
2024-11-04,236,127,109,0,127,0,0,0.0
2024-11-05,256,145,111,0,145,0,0,0.0
2024-11-06,215,107,108,0,107,0,0,0.0
2024-11-07,222,117,105,0,117,0,0,0.0
2024-11-08,181,99,82,0,99,0,0,0.0
2024-11-10,18,0,18,0,0,0,0,0.0
2024-11-11,161,47,114,0,47,0,0,0.0
2024-11-12,264,155,109,0,155,0,0,0.0
2024-11-13,252,153,99,0,153,0,0,0.0
2024-11-14,233,120,113,0,120,0,0,0.0
2024-11-15,245,149,96,0,149,0,0,0.0
2024-11-17,16,0,16,0,0,0,0,0.0
2024-11-18,242,146,96,0,146,0,0,0.0
2024-11-19,261,154,107,0,154,0,0,0.0
2024-11-20,246,138,108,0,138,0,0,0.0
2024-11-21,210,102,108,0,102,0,0,0.0
2024-11-22,231,153,78,0,153,0,0,0.0
2024-11-24,4,0,4,0,0,0,0,0.0
2024-11-25,181,97,84,0,97,0,0,0.0
2024-11-26,191,86,105,0,86,0,0,0.0
2024-11-27,243,130,113,0,130,0,0,0.0
2024-11-28,246,137,109,0,137,0,0,0.0
2024-11-29,215,119,96,0,119,0,0,0.0
2024-12-01,16,0,16,0,0,0,0,0.0
2024-12-02,254,143,111,0,143,0,0,0.0
2024-12-03,228,115,113,0,115,0,0,0.0
2024-12-04,258,146,112,0,146,0,0,0.0
2024-12-05,268,153,115,0,153,0,0,0.0
2024-12-06,239,157,82,0,157,0,0,0.0
2024-12-08,0,0,0,0,0,0,0,0.0
2024-12-09,170,118,52,0,118,0,0,0.0
2024-12-10,206,117,89,0,117,0,0,0.0
2024-12-11,245,137,108,0,137,0,0,0.0
2024-12-12,199,116,83,0,116,0,0,0.0
2024-12-13,253,157,96,0,157,0,0,0.0
2024-12-15,15,0,15,0,0,0,0,0.0
2024-12-16,239,146,93,0,146,0,0,0.0
2024-12-17,250,156,94,0,156,0,0,0.0
2024-12-18,208,131,77,0,131,0,0,0.0
2024-12-19,266,153,113,0,153,0,0,0.0
2024-12-20,234,139,95,0,139,0,0,0.0
2024-12-22,13,0,13,0,0,0,0,0.0
2024-12-23,188,92,96,0,92,0,0,0.0
2024-12-24,180,105,75,0,105,0,0,0.0
2024-12-25,119,0,119,0,0,0,0,0.0
2024-12-26,265,156,109,0,156,0,0,0.0
2024-12-27,204,108,96,0,108,0,0,0.0
2024-12-29,12,0,12,0,0,0,0,0.0
2024-12-30,248,140,108,0,140,0,0,0.0
2024-12-31,242,146,96,0,146,0,0,0.0
