date,breakouts,gate_pass,gate_block,ev_pass,ev_reject,fills,wins,pnl_pips
2018-01-01,10,0,10,0,0,0,0,0.0
2018-01-02,132,30,102,7,18,12,11,21.011428571427132
2018-01-03,84,27,57,2,25,2,1,1.3028571428582723
2018-01-04,116,3,113,2,1,2,0,-6.79142857142898
2018-01-05,151,55,96,1,54,1,1,4.454285714285334
2018-01-07,12,0,12,0,0,0,0,0.0
2018-01-08,150,62,88,1,61,1,1,2.517142857142119
2018-01-09,163,55,108,1,54,1,1,2.3199999999998226
2018-01-10,107,2,105,2,0,2,0,-5.454285714287209
2018-01-11,106,2,104,2,0,2,0,-6.522857142858584
2018-01-12,83,26,57,2,24,2,2,10.528571428570444
2018-01-14,17,0,17,0,0,0,0,0.0
2018-01-15,112,5,107,2,3,2,0,-5.394285714286639
2018-01-16,143,26,117,2,24,2,0,-6.379999999999541
2018-01-17,186,81,105,2,79,2,1,3.039999999999111
2018-01-18,109,24,85,2,22,2,1,2.9571428571420597
2018-01-19,111,22,89,1,21,1,0,-3.3771428571431557
2018-01-21,12,0,12,0,0,0,0,0.0
2018-01-22,173,60,113,1,59,1,1,2.722857142857549
2018-01-23,138,35,103,2,33,2,1,3.1685714285719655
2018-01-24,110,3,107,2,1,2,0,-8.542857142857429
2018-01-25,116,5,111,2,3,2,0,-8.597142857143524
2018-01-26,122,42,80,1,41,1,0,-2.728571428571513
2018-01-28,13,0,13,0,0,0,0,0.0
2018-01-29,170,73,97,1,72,1,0,-4.020000000000323
2018-01-30,179,81,98,1,80,1,1,6.982857142856858
2018-01-31,147,50,97,1,49,1,0,-3.7942857142856496
2018-02-01,186,73,113,1,72,1,1,7.034285714285716
2018-02-02,172,78,94,1,77,1,1,6.039999999999679
2018-02-04,20,0,20,0,0,0,0,0.0
2018-02-05,132,20,112,1,19,1,0,-2.785714285714846
2018-02-06,119,6,113,2,4,2,1,2.691428571428901
2018-02-07,174,70,104,1,69,1,0,-4.174285714285475
2018-02-08,137,66,71,1,65,1,1,5.559999999999377
2018-02-09,144,50,94,2,48,2,1,1.3485714285712334
2018-02-11,15,0,15,0,0,0,0,0.0
2018-02-12,137,24,113,2,22,2,1,1.5171428571425736
2018-02-13,136,28,108,2,26,2,1,0.19428571428557007
2018-02-14,154,48,106,1,47,1,0,-5.862857142857536
2018-02-15,123,12,111,2,10,2,1,3.9771428571432352
2018-02-16,131,38,93,1,37,1,0,-3.991428571429367
2018-02-18,20,0,20,0,0,0,0,0.0
2018-02-19,188,82,106,1,81,1,0,-3.7600000000002183
2018-02-20,175,64,111,1,63,1,0,-4.054285714285754
2018-02-21,190,81,109,1,80,1,0,-4.511428571428155
2018-02-22,263,147,116,0,147,0,0,0.0
2018-02-23,239,143,96,0,143,0,0,0.0
2018-02-25,6,0,6,0,0,0,0,0.0
2018-02-26,235,122,113,0,122,0,0,0.0
2018-02-27,151,41,110,1,40,1,1,6.837142857143419
2018-02-28,169,64,105,1,63,1,1,5.56857142857109
2018-03-01,198,87,111,1,86,1,1,7.771428571428885
2018-03-02,168,75,93,1,74,1,1,5.259999999999366
2018-03-04,6,0,6,0,0,0,0,0.0
2018-03-05,99,69,30,1,68,1,1,2.69714285714241
2018-03-06,193,80,113,1,79,1,1,5.9628571428571036
2018-03-07,148,37,111,1,36,1,0,-4.3457142857140525
2018-03-08,183,75,108,1,74,1,0,-4.197142857143376
2018-03-09,156,54,102,1,53,1,1,5.500000000000227
2018-03-11,18,0,18,0,0,0,0,0.0
2018-03-12,161,47,114,1,46,1,0,-4.125714285713855
2018-03-13,167,57,110,1,56,1,0,-5.448571428572279
2018-03-14,141,48,93,1,47,1,0,-3.099999999999625
2018-03-15,176,71,105,1,70,1,1,5.011428571428212
2018-03-16,163,67,96,1,66,1,1,4.300000000000182
2018-03-18,15,0,15,0,0,0,0,0.0
2018-03-19,169,57,112,1,56,1,0,-2.5057142857140775
2018-03-20,131,24,107,2,22,2,1,2.9428571428572923
2018-03-21,215,104,111,1,103,1,1,13.162857142857376
2018-03-22,137,20,117,2,18,2,1,0.3542857142851972
2018-03-23,104,8,96,2,6,2,0,-7.377142857142815
2018-03-25,15,0,15,0,0,0,0,0.0
2018-03-26,136,33,103,1,32,1,0,-2.2857142857138797
2018-03-27,256,147,109,0,147,0,0,0.0
2018-03-28,182,78,104,2,76,2,2,11.205714285714464
2018-03-29,188,83,105,1,82,1,1,4.102857142856465
2018-03-30,165,70,95,0,70,0,0,0.0
2018-04-01,8,6,2,0,6,0,0,0.0
2018-04-02,87,58,29,1,57,1,0,-2.9114285714290418
2018-04-03,181,67,114,1,66,1,1,3.4857142857144368
2018-04-04,138,43,95,2,41,2,1,-1.0057142857144754
2018-04-05,202,88,114,1,87,1,1,2.5942857142846947
2018-04-06,128,33,95,1,32,1,0,-4.119999999999379
2018-04-08,8,0,8,0,0,0,0,0.0
2018-04-09,115,53,62,1,52,1,1,3.5714285714287257
2018-04-10,133,23,110,2,21,2,1,0.9657142857141707
2018-04-11,175,60,115,1,59,1,1,4.557142857143049
2018-04-12,202,87,115,1,86,1,0,-2.2114285714285415
2018-04-13,188,92,96,1,91,1,1,2.1142857142858134
2018-04-15,6,0,6,0,0,0,0,0.0
2018-04-16,143,33,110,1,32,1,0,-2.111428571428064
2018-04-17,195,82,113,1,81,1,1,1.5399999999995089
2018-04-18,261,145,116,0,145,0,0,0.0
2018-04-19,230,125,105,0,125,0,0,0.0
2018-04-20,190,95,95,1,94,1,1,3.2628571428570012
2018-04-22,10,0,10,0,0,0,0,0.0
2018-04-23,159,57,102,1,56,1,0,-2.0314285714282505
2018-04-24,142,42,100,1,41,1,1,5.722857142857663
2018-04-25,150,57,93,1,56,1,0,-2.3942857142860703
2018-04-26,182,76,106,1,75,1,1,2.9114285714281323
2018-04-27,107,12,95,1,11,1,0,-2.88857142857114
2018-04-29,20,0,20,0,0,0,0,0.0
2018-04-30,196,106,90,0,106,0,0,0.0
2018-05-01,262,148,114,0,148,0,0,0.0
2018-05-02,196,84,112,1,83,1,1,3.434285714285579
2018-05-03,175,60,115,2,58,2,2,9.962857142857274
2018-05-04,98,2,96,2,0,2,0,-7.308571428570531
2018-05-06,14,0,14,0,0,0,0,0.0
2018-05-07,187,80,107,1,79,1,1,2.4657142857146823
2018-05-08,163,62,101,1,61,1,0,-3.222857142858004
2018-05-09,189,83,106,1,82,1,0,-3.0771428571431443
2018-05-10,168,56,112,1,55,1,0,-4.045714285714041
2018-05-11,184,89,95,1,88,1,0,-2.1285714285714903
2018-05-13,1,0,1,0,0,0,0,0.0
2018-05-14,196,122,74,0,122,0,0,0.0
2018-05-15,255,140,115,0,140,0,0,0.0
2018-05-16,203,96,107,1,95,1,1,1.642857142857224
2018-05-17,179,77,102,1,76,1,0,-1.9714285714276798
2018-05-18,237,141,96,0,141,0,0,0.0
2018-05-20,15,11,4,1,10,1,1,1.9514285714289485
2018-05-21,166,51,115,1,50,1,0,-3.022857142857049
2018-05-22,205,105,100,0,105,0,0,0.0
2018-05-23,173,74,99,1,73,1,1,4.068571428571033
2018-05-24,177,60,117,1,59,1,1,8.191428571428617
2018-05-25,98,2,96,2,0,2,0,-7.351428571429096
2018-05-27,8,0,8,0,0,0,0,0.0
2018-05-28,163,57,106,1,56,1,0,-2.205714285714066
2018-05-29,167,50,117,1,49,1,0,-3.011428571428098
2018-05-30,114,3,111,2,1,2,0,-8.942857142856496
2018-05-31,190,78,112,1,77,1,0,-5.837142857142396
2018-06-01,173,78,95,1,77,1,1,4.47142857142876
2018-06-03,4,0,4,0,0,0,0,0.0
2018-06-04,167,51,116,1,50,1,1,3.5714285714287257
2018-06-05,190,76,114,1,75,1,1,4.3257142857139
2018-06-06,261,154,107,0,154,0,0,0.0
2018-06-07,197,86,111,1,85,1,1,3.7171428571421643
2018-06-08,154,61,93,1,60,1,1,3.34857142857129
2018-06-10,6,0,6,0,0,0,0,0.0
2018-06-11,147,46,101,1,45,1,0,-3.1885714285711515
2018-06-12,194,77,117,1,76,1,1,1.5399999999995089
2018-06-13,213,114,99,1,113,1,1,7.145714285713723
2018-06-14,113,39,74,1,38,1,0,-2.908571428571804
2018-06-15,139,44,95,1,43,1,0,-4.005714285714134
2018-06-17,11,0,11,0,0,0,0,0.0
2018-06-18,172,62,110,1,61,1,0,-2.602857142855896
2018-06-19,182,74,108,1,73,1,0,-4.020000000000323
2018-06-20,263,147,116,0,147,0,0,0.0
2018-06-21,203,98,105,1,97,1,1,2.268571428570965
2018-06-22,205,110,95,0,110,0,0,0.0
2018-06-24,13,4,9,1,3,1,1,3.4771428571427236
2018-06-25,147,32,115,1,31,1,0,-1.9657142857146255
2018-06-26,184,77,107,1,76,1,1,2.8600000000006958
2018-06-27,183,81,102,1,80,1,0,-3.6742857142859293
2018-06-28,188,83,105,1,82,1,1,4.128571428571604
2018-06-29,163,68,95,1,67,1,1,3.862857142857024
2018-07-01,10,0,10,0,0,0,0,0.0
2018-07-02,134,36,98,1,35,1,0,-3.1400000000009527
2018-07-03,200,86,114,1,85,1,1,2.5514285714289713
2018-07-04,201,101,100,0,101,0,0,0.0
2018-07-05,153,57,96,1,56,1,1,1.822857142857515
2018-07-06,126,58,68,1,57,1,0,-3.0571428571424804
2018-07-08,6,0,6,0,0,0,0,0.0
2018-07-09,149,87,62,1,86,1,1,1.3428571428572127
2018-07-10,269,154,115,1,153,1,1,6.211428571428257
2018-07-11,146,56,90,1,55,1,0,-2.9885714285716176
2018-07-12,179,64,115,1,63,1,0,-3.4657142857146823
2018-07-13,233,137,96,0,137,0,0,0.0
2018-07-15,25,12,13,0,12,0,0,0.0
2018-07-16,146,49,97,1,48,1,0,-2.151428571427971
2018-07-17,198,83,115,1,82,1,1,2.345714285713541
2018-07-18,223,123,100,0,123,0,0,0.0
2018-07-19,169,61,108,1,60,1,0,-3.174285714286384
2018-07-20,146,51,95,1,50,1,0,-5.394285714286184
2018-07-22,19,0,19,0,0,0,0,0.0
2018-07-23,171,57,114,1,56,1,0,-2.151428571427971
2018-07-24,165,75,90,1,74,1,1,3.245714285713575
2018-07-25,169,78,91,1,77,1,0,-5.2085714285714175
2018-07-26,156,53,103,1,52,1,1,3.8971428571424553
2018-07-27,211,115,96,0,115,0,0,0.0
2018-07-29,20,12,8,0,12,0,0,0.0
2018-07-30,227,112,115,0,112,0,0,0.0
2018-07-31,171,59,112,1,58,1,1,7.625714285714025
2018-08-01,171,68,103,1,67,1,1,2.6542857142852654
2018-08-02,259,155,104,0,155,0,0,0.0
2018-08-03,209,122,87,0,122,0,0,0.0
2018-08-05,13,12,1,0,12,0,0,0.0
2018-08-06,232,131,101,0,131,0,0,0.0
2018-08-07,277,161,116,0,161,0,0,0.0
2018-08-08,262,154,108,0,154,0,0,0.0
2018-08-09,192,78,114,1,77,1,1,2.0285714285715244
2018-08-10,154,58,96,1,57,1,0,-3.5685714285709764
2018-08-12,1,0,1,0,0,0,0,0.0
2018-08-13,148,50,98,2,48,2,1,2.614285714286325
2018-08-14,110,11,99,2,9,2,2,6.388571428572277
2018-08-15,162,46,116,1,45,1,1,4.634285714285625
2018-08-16,148,39,109,1,38,1,0,-2.4885714285720724
2018-08-17,146,50,96,1,49,1,1,3.3742857142850085
2018-08-19,7,0,7,0,0,0,0,0.0
2018-08-20,128,30,98,1,29,1,0,-1.7914285714288098
2018-08-21,183,75,108,1,74,1,0,-3.3142857142853472
2018-08-22,153,54,99,1,53,1,0,-1.931428571429194
2018-08-23,172,71,101,1,70,1,1,2.980000000000416
2018-08-24,119,53,66,1,52,1,1,4.822857142857629
2018-08-26,8,0,8,0,0,0,0,0.0
2018-08-27,162,54,108,1,53,1,0,-2.7742857142873163
2018-08-28,251,145,106,0,145,0,0,0.0
2018-08-29,162,60,102,1,59,1,1,4.4371428571433285
2018-08-30,163,61,102,1,60,1,0,-3.811428571429076
2018-08-31,93,27,66,1,26,1,0,-3.354285714286675
2018-09-02,20,0,20,0,0,0,0,0.0
2018-09-03,256,148,108,0,148,0,0,0.0
2018-09-04,173,63,110,1,62,1,0,-4.419999999999391
2018-09-05,132,45,87,1,44,1,0,-2.1542857142852085
2018-09-06,156,43,113,1,42,1,1,5.354285714285368
2018-09-07,144,48,96,2,46,2,1,0.6828571428575856
2018-09-09,17,0,17,0,0,0,0,0.0
2018-09-10,209,112,97,0,112,0,0,0.0
2018-09-11,270,158,112,0,158,0,0,0.0
2018-09-12,155,48,107,1,47,1,1,4.822857142857629
2018-09-13,160,45,115,1,44,1,0,-4.540000000000532
2018-09-14,133,41,92,1,40,1,0,-3.517142857142119
2018-09-16,10,0,10,0,0,0,0,0.0
2018-09-17,190,143,47,0,143,0,0,0.0
2018-09-18,158,54,104,1,53,1,1,3.5457142857135864
2018-09-19,215,120,95,0,120,0,0,0.0
2018-09-20,147,46,101,1,45,1,1,5.294285714286218
2018-09-21,139,46,93,1,45,1,1,4.119999999999891
2018-09-23,9,0,9,0,0,0,0,0.0
2018-09-24,136,40,96,1,39,1,0,-2.2771428571421666
2018-09-25,264,155,109,0,155,0,0,0.0
2018-09-26,215,103,112,1,102,1,1,3.5714285714287257
2018-09-27,178,69,109,1,68,1,1,3.4428571428572923
2018-09-28,133,38,95,1,37,1,0,-3.4142857142858247
2018-09-30,17,0,17,0,0,0,0,0.0
2018-10-01,184,70,114,1,69,1,0,-3.2571428571434353
2018-10-02,177,75,102,1,74,1,1,4.042857142857315
2018-10-03,175,67,108,1,66,1,1,3.168571428570999
2018-10-04,145,34,111,2,32,2,1,2.7800000000004275
2018-10-05,134,56,78,1,55,1,0,-3.7971428571428874
2018-10-07,19,0,19,0,0,0,0,0.0
2018-10-08,169,59,110,1,58,1,0,-3.819999999999368
2018-10-09,135,30,105,1,29,1,0,-3.1714285714291464
2018-10-10,171,69,102,1,68,1,1,6.48571428571455
2018-10-11,86,5,81,2,3,2,0,-9.454285714286414
2018-10-12,148,52,96,1,51,1,1,3.8199999999998795
2018-10-14,8,0,8,0,0,0,0,0.0
2018-10-15,107,5,102,2,3,2,0,-6.640000000001066
2018-10-16,154,42,112,1,41,1,0,-4.162857142856524
2018-10-17,166,51,115,1,50,1,1,4.385714285714471
2018-10-18,169,56,113,1,55,1,0,-3.925714285714321
2018-10-19,146,50,96,1,49,1,1,4.600000000000193
2018-10-21,21,0,21,0,0,0,0,0.0
2018-10-22,164,55,109,1,54,1,0,-3.591428571428878
2018-10-23,170,66,104,1,65,1,0,-4.979999999999507
2018-10-24,169,65,104,1,64,1,1,5.208571428571929
2018-10-25,124,45,79,1,44,1,0,-3.9485714285708013
2018-10-26,144,51,93,1,50,1,0,-2.6485714285716995
2018-10-28,10,0,10,0,0,0,0,0.0
2018-10-29,135,46,89,1,45,1,0,-2.425714285714264
2018-10-30,176,60,116,1,59,1,1,5.619999999999948
2018-10-31,146,38,108,1,37,1,1,3.8971428571424553
2018-11-01,157,49,108,1,48,1,1,3.417142857142153
2018-11-02,150,54,96,1,53,1,0,-4.674285714286441
2018-11-04,17,0,17,0,0,0,0,0.0
2018-11-05,147,81,66,1,80,1,1,3.254285714285288
2018-11-06,262,151,111,0,151,0,0,0.0
2018-11-07,149,56,93,1,55,1,1,2.7399999999995543
2018-11-08,181,77,104,1,76,1,1,2.354285714285254
2018-11-09,128,32,96,1,31,1,0,-2.5171428571430283
2018-11-11,8,0,8,0,0,0,0,0.0
2018-11-12,170,63,107,1,62,1,0,-3.5400000000000205
2018-11-13,156,53,103,1,52,1,0,-2.9542857142861862
2018-11-14,152,47,105,1,46,1,1,3.065714285714705
2018-11-15,134,48,86,1,47,1,0,-3.5771428571426895
2018-11-16,132,48,84,1,47,1,1,3.974285714285031
2018-11-18,16,0,16,0,0,0,0,0.0
2018-11-19,127,36,91,1,35,1,0,-3.5657142857137387
2018-11-20,139,44,95,1,43,1,1,3.2971428571424326
2018-11-21,157,54,103,1,53,1,1,3.0142857142858475
2018-11-22,151,123,28,0,123,0,0,0.0
2018-11-23,140,62,78,1,61,1,1,2.259999999999252
2018-11-25,12,0,12,0,0,0,0,0.0
2018-11-26,169,56,113,1,55,1,1,2.6885714285706968
2018-11-27,124,23,101,2,21,2,1,1.277142857143133
2018-11-28,166,59,107,1,58,1,1,1.5828571428566534
2018-11-29,149,53,96,1,52,1,0,-3.222857142856583
2018-11-30,68,68,0,1,67,1,0,-2.625714285713798
2018-12-02,14,0,14,0,0,0,0,0.0
2018-12-03,165,76,89,1,75,1,1,2.7571428571429806
2018-12-04,180,68,112,1,67,1,1,1.8571428571429465
2018-12-05,184,69,115,1,68,1,1,1.642857142857224
2018-12-06,171,57,114,1,56,1,0,-1.8028571428577607
2018-12-07,147,53,94,1,52,1,0,-3.791428571428412
2018-12-09,14,0,14,0,0,0,0,0.0
2018-12-10,160,46,114,1,45,1,0,-3.6257142857143094
2018-12-11,154,44,110,1,43,1,1,2.0542857142852426
2018-12-12,129,33,96,1,32,1,0,-1.7828571428570967
2018-12-13,139,43,96,1,42,1,0,-3.374285714285918
2018-12-14,130,58,72,1,57,1,1,2.3028571428578175
2018-12-16,18,0,18,0,0,0,0,0.0
2018-12-17,160,57,103,1,56,1,1,2.0285714285715244
2018-12-18,167,56,111,1,55,1,0,-1.8114285714280527
2018-12-19,169,70,99,1,69,1,1,2.182857142856676
2018-12-20,156,57,99,1,56,1,1,2.4657142857146823
2018-12-21,84,7,77,2,5,2,1,1.9571428571429692
2018-12-23,5,0,5,0,0,0,0,0.0
2018-12-24,49,40,9,1,39,1,0,-3.722857142857549
2018-12-25,117,0,117,0,0,0,0,0.0
2018-12-26,139,61,78,1,60,1,1,2.3971428571423985
2018-12-27,114,2,112,2,0,2,0,-5.762857142858934
2018-12-28,145,50,95,1,49,1,1,2.611428571428121
2018-12-30,19,0,19,0,0,0,0,0.0
2018-12-31,142,47,95,1,46,1,0,-2.4885714285720724
2019-01-01,18,0,18,0,0,0,0,0.0
2019-01-02,115,2,113,2,0,2,0,-6.694285714285741
2019-01-03,113,2,111,2,0,2,0,-8.334285714286182
2019-01-04,147,51,96,1,50,1,0,-3.668571428571454
2019-01-06,12,0,12,0,0,0,0,0.0
2019-01-07,144,55,89,1,54,1,0,-3.714285714285836
2019-01-08,159,50,109,1,49,1,0,-2.4314285714287394
2019-01-09,130,27,103,1,26,1,1,3.5542857142852995
2019-01-10,171,64,107,1,63,1,1,3.2114285714281436
2019-01-11,112,27,85,1,26,1,0,-3.7457142857140298
2019-01-13,13,0,13,0,0,0,0,0.0
2019-01-14,154,42,112,1,41,1,1,3.0399999999995657
2019-01-15,154,57,97,1,56,1,0,-2.1342857142859657
2019-01-16,166,64,102,1,63,1,0,-3.545714285714496
2019-01-17,126,21,105,1,20,1,1,3.588571428570731
2019-01-18,143,48,95,1,47,1,0,-2.9342857142855223
2019-01-20,8,0,8,0,0,0,0,0.0
2019-01-21,216,113,103,0,113,0,0,0.0
2019-01-22,168,70,98,1,69,1,0,-3.8799999999999386
2019-01-23,149,50,99,1,49,1,1,4.025714285713889
2019-01-24,156,61,95,1,60,1,1,3.9142857142858816
2019-01-25,160,65,95,1,64,1,1,3.3828571428567216
2019-01-27,18,0,18,0,0,0,0,0.0
2019-01-28,166,58,108,1,57,1,1,3.254285714286709
2019-01-29,170,73,97,1,72,1,1,2.525714285713832
2019-01-30,110,62,48,1,61,1,1,2.5771428571426895
2019-01-31,160,56,104,1,55,1,1,2.3714285714286802
2019-02-01,140,52,88,1,51,1,0,-3.3571428571424917
2019-02-03,20,0,20,0,0,0,0,0.0
2019-02-04,173,60,113,1,59,1,1,1.9600000000006617
2019-02-05,155,61,94,1,60,1,1,1.98571428571438
2019-02-06,167,62,105,1,61,1,0,-2.7228571428570376
2019-02-07,144,53,91,1,52,1,1,2.96285714285699
2019-02-08,126,63,63,1,62,1,1,1.634285714285511
2019-02-10,10,0,10,0,0,0,0,0.0
2019-02-11,150,58,92,1,57,1,0,-3.1628571428574332
2019-02-12,169,67,102,1,66,1,1,2.0371428571432375
2019-02-13,152,41,111,1,40,1,1,3.2199999999998568
2019-02-14,159,51,108,1,50,1,1,3.400000000000148
2019-02-15,143,59,84,1,58,1,1,1.3514285714275047
2019-02-17,13,0,13,0,0,0,0,0.0
2019-02-18,254,146,108,0,146,0,0,0.0
2019-02-19,156,61,95,1,60,1,1,1.094285714286059
2019-02-20,166,58,108,1,57,1,0,-2.1000000000005343
2019-02-21,124,28,96,1,27,1,0,-2.2800000000008254
2019-02-22,150,60,90,1,59,1,1,1.5142857142857906
2019-02-24,17,0,17,0,0,0,0,0.0
2019-02-25,143,73,70,1,72,1,1,1.1628571428569217
2019-02-26,157,58,99,1,57,1,1,1.377142857142644
2019-02-27,148,64,84,1,63,1,1,2.242857142857247
2019-02-28,144,31,113,1,30,1,0,-3.7285714285720246
2019-03-01,123,27,96,1,26,1,0,-1.74285714285719
2019-03-03,21,0,21,0,0,0,0,0.0
2019-03-04,144,46,98,1,45,1,1,1.0342857142854882
2019-03-05,165,59,106,1,58,1,0,-3.659999999999741
2019-03-06,149,50,99,1,49,1,0,-1.734285714286898
2019-03-07,151,62,89,1,61,1,0,-3.6514285714280277
2019-03-08,143,48,95,1,47,1,1,3.4514285714290054
2019-03-10,15,0,15,0,0,0,0,0.0
2019-03-11,132,47,85,1,46,1,0,-2.037142857142726
2019-03-12,158,48,110,1,47,1,0,-2.1171428571425395
2019-03-13,149,36,113,1,35,1,0,-1.7742857142853836
2019-03-14,162,45,117,1,44,1,0,-1.6971428571428078
2019-03-15,130,36,94,1,35,1,0,-1.9171428571430056
2019-03-17,14,0,14,0,0,0,0,0.0
2019-03-18,184,70,114,1,69,1,1,1.908571428571804
2019-03-19,149,34,115,1,33,1,0,-2.2228571428574924
2019-03-20,192,80,112,1,79,1,1,1.908571428570383
2019-03-21,158,57,101,1,56,1,0,-3.628571428571547
2019-03-22,149,57,92,1,56,1,0,-3.665714285714216
2019-03-24,16,0,16,0,0,0,0,0.0
2019-03-25,149,53,96,1,52,1,0,-2.045714285714439
2019-03-26,159,51,108,1,50,1,0,-4.142857142857281
2019-03-27,106,51,55,1,50,1,0,-3.608571428570883
2019-03-28,162,57,105,1,56,1,0,-4.868571428571499
2019-03-29,103,8,95,1,7,1,0,-2.3657142857151143
2019-03-31,7,0,7,0,0,0,0,0.0
2019-04-01,160,52,108,1,51,1,0,-2.614285714286268
2019-04-02,199,123,76,0,123,0,0,0.0
2019-04-03,200,91,109,0,91,0,0,0.0
2019-04-04,243,133,110,0,133,0,0,0.0
2019-04-05,151,54,97,1,53,1,0,-4.785714285714448
2019-04-07,14,0,14,0,0,0,0,0.0
2019-04-08,252,137,115,0,137,0,0,0.0
2019-04-09,254,142,112,0,142,0,0,0.0
2019-04-10,250,154,96,0,154,0,0,0.0
2019-04-11,240,130,110,0,130,0,0,0.0
2019-04-12,221,125,96,0,125,0,0,0.0
2019-04-14,32,12,20,0,12,0,0,0.0
2019-04-15,173,75,98,0,75,0,0,0.0
2019-04-16,152,67,85,0,67,0,0,0.0
2019-04-17,230,123,107,0,123,0,0,0.0
2019-04-18,202,105,97,0,105,0,0,0.0
2019-04-19,173,86,87,0,86,0,0,0.0
2019-04-21,28,12,16,0,12,0,0,0.0
2019-04-22,135,50,85,0,50,0,0,0.0
2019-04-23,249,134,115,0,134,0,0,0.0
2019-04-24,221,115,106,1,114,1,1,4.119999999999891
2019-04-25,168,59,109,1,58,1,1,3.4857142857144368
2019-04-26,147,51,96,1,50,1,0,-3.334285714286011
2019-04-28,12,0,12,0,0,0,0,0.0
2019-04-29,221,119,102,0,119,0,0,0.0
2019-04-30,236,131,105,0,131,0,0,0.0
2019-05-01,228,127,101,1,126,1,1,9.365714285713523
2019-05-02,241,131,110,0,131,0,0,0.0
2019-05-03,226,132,94,0,132,0,0,0.0
2019-05-05,27,12,15,0,12,0,0,0.0
2019-05-06,218,128,90,1,127,1,1,3.1771428571427123
2019-05-07,139,61,78,1,60,1,1,2.6800000000004047
2019-05-08,151,52,99,1,51,1,0,-4.322857142857572
2019-05-09,166,58,108,1,57,1,0,-2.5057142857154986
2019-05-10,161,66,95,1,65,1,1,3.0314285714278526
2019-05-12,17,0,17,0,0,0,0,0.0
2019-05-13,125,44,81,2,42,2,1,2.9685714285710105
2019-05-14,160,49,111,1,48,1,1,2.8257142857138433
2019-05-15,162,54,108,1,53,1,0,-2.585714285713891
2019-05-16,163,57,106,1,56,1,0,-2.1914285714278776
2019-05-17,164,68,96,1,67,1,1,3.142857142857281
2019-05-19,10,0,10,0,0,0,0,0.0
2019-05-20,169,58,111,1,57,1,0,-2.2028571428568284
2019-05-21,168,52,116,1,51,1,0,-3.665714285714216
2019-05-22,263,157,106,0,157,0,0,0.0
2019-05-23,160,56,104,1,55,1,0,-2.262857142857399
2019-05-24,165,70,95,1,69,1,1,3.785714285714448
2019-05-26,21,0,21,0,0,0,0,0.0
2019-05-27,258,143,115,0,143,0,0,0.0
2019-05-28,134,43,91,1,42,1,1,3.519999999999868
2019-05-29,135,38,97,1,37,1,0,-3.1600000000001955
2019-05-30,253,144,109,0,144,0,0,0.0
2019-05-31,136,40,96,1,39,1,0,-3.905714285713657
2019-06-02,12,0,12,0,0,0,0,0.0
2019-06-03,143,53,90,1,52,1,1,3.3057142857141457
2019-06-04,163,54,109,1,53,1,1,4.419999999999902
2019-06-05,152,59,93,1,58,1,1,6.69142857142856
2019-06-06,146,57,89,1,56,1,0,-2.654285714286175
2019-06-07,138,42,96,2,40,2,1,-0.03428571428776195
2019-06-09,6,0,6,0,0,0,0,0.0
2019-06-10,130,48,82,1,47,1,0,-2.1371428571432034
2019-06-11,257,158,99,0,158,0,0,0.0
2019-06-12,142,39,103,1,38,1,0,-2.6485714285716995
2019-06-13,262,154,108,0,154,0,0,0.0
2019-06-14,219,123,96,0,123,0,0,0.0
2019-06-16,13,5,8,0,5,0,0,0.0
2019-06-17,236,126,110,0,126,0,0,0.0
2019-06-18,160,48,112,1,47,1,0,-4.208571428570906
2019-06-19,189,88,101,1,87,1,1,4.4457142857136205
2019-06-20,163,51,112,1,50,1,0,-3.005714285715044
2019-06-21,136,56,80,1,55,1,0,-4.114285714286325
2019-06-23,19,0,19,0,0,0,0,0.0
2019-06-24,253,157,96,0,157,0,0,0.0
2019-06-25,193,88,105,1,87,1,1,4.488571428570765
2019-06-26,206,99,107,1,98,1,1,4.771428571428771
2019-06-27,265,156,109,0,156,0,0,0.0
2019-06-28,221,125,96,0,125,0,0,0.0
2019-06-30,25,5,20,1,4,1,1,4.3599999999993315
2019-07-01,102,42,60,1,41,1,0,-3.5942857142861158
2019-07-02,144,65,79,1,64,1,1,4.034285714285602
2019-07-03,267,152,115,0,152,0,0,0.0
2019-07-04,183,78,105,0,78,0,0,0.0
2019-07-05,131,35,96,1,34,1,0,-3.5228571428565942
2019-07-07,5,0,5,0,0,0,0,0.0
2019-07-08,250,161,89,0,161,0,0,0.0
2019-07-09,217,109,108,0,109,0,0,0.0
2019-07-10,163,50,113,1,49,1,0,-3.2057142857145777
2019-07-11,155,48,107,1,47,1,0,-3.2914285714288667
2019-07-12,216,120,96,0,120,0,0,0.0
2019-07-14,20,12,8,0,12,0,0,0.0
2019-07-15,216,124,92,0,124,0,0,0.0
2019-07-16,170,58,112,1,57,1,0,-4.240000000000521
2019-07-17,232,122,110,0,122,0,0,0.0
2019-07-18,223,106,117,1,105,1,1,5.285714285714505
2019-07-19,152,56,96,1,55,1,1,3.4514285714290054
2019-07-21,20,0,20,0,0,0,0,0.0
2019-07-22,206,99,107,0,99,0,0,0.0
2019-07-23,243,134,109,0,134,0,0,0.0
2019-07-24,246,141,105,0,141,0,0,0.0
2019-07-25,120,35,85,1,34,1,1,4.454285714285334
2019-07-26,133,59,74,1,58,1,0,-3.894285714284706
2019-07-28,6,0,6,0,0,0,0,0.0
2019-07-29,252,160,92,0,160,0,0,0.0
2019-07-30,257,155,102,0,155,0,0,0.0
2019-07-31,168,61,107,1,60,1,0,-4.128571428571092
2019-08-01,178,62,116,1,61,1,0,-2.9228571428579926
2019-08-02,97,2,95,2,0,2,1,9.517142857143824
2019-08-04,14,0,14,0,0,0,0,0.0
2019-08-05,102,2,100,2,0,2,0,-6.822857142858595
2019-08-06,114,3,111,2,1,2,0,-8.620000000000005
2019-08-07,158,54,104,1,53,1,0,-4.32571428571481
2019-08-08,96,46,50,1,45,1,0,-4.78285714285721
2019-08-09,171,78,93,1,77,1,1,7.454285714285447
2019-08-11,15,0,15,0,0,0,0,0.0
2019-08-12,174,64,110,1,63,1,1,4.137142857143317
2019-08-13,168,53,115,1,52,1,1,6.888571428572277
2019-08-14,172,56,116,1,55,1,0,-3.762857142857456
2019-08-15,132,18,114,2,16,2,1,2.94571428571453
2019-08-16,152,58,94,1,57,1,0,-2.49142857142931
2019-08-18,15,0,15,0,0,0,0,0.0
2019-08-19,156,127,29,0,127,0,0,0.0
2019-08-20,136,58,78,1,57,1,1,6.537142857143408
2019-08-21,227,116,111,1,115,1,1,5.0628571428570694
2019-08-22,169,60,109,1,59,1,1,4.659999999999343
2019-08-23,148,52,96,1,51,1,1,6.074285714285111
2019-08-25,17,0,17,0,0,0,0,0.0
2019-08-26,107,2,105,2,0,2,0,-9.91714285714329
2019-08-27,124,17,107,1,16,1,1,3.61428571428587
2019-08-28,151,46,105,1,45,1,0,-3.7085714285699396
2019-08-29,166,58,108,1,57,1,0,-2.565714285713227
2019-08-30,169,74,95,1,73,1,0,-3.694285714285172
2019-09-01,2,0,2,0,0,0,0,0.0
2019-09-02,249,153,96,0,153,0,0,0.0
2019-09-03,149,39,110,1,38,1,0,-4.974285714286452
2019-09-04,209,109,100,0,109,0,0,0.0
2019-09-05,177,60,117,1,59,1,1,4.951428571427641
2019-09-06,134,38,96,1,37,1,1,7.111428571428291
2019-09-08,8,0,8,0,0,0,0,0.0
2019-09-09,181,134,47,0,134,0,0,0.0
2019-09-10,154,48,106,1,47,1,1,3.4514285714290054
2019-09-11,232,124,108,0,124,0,0,0.0
2019-09-12,152,36,116,1,35,1,1,6.48571428571455
2019-09-13,92,18,74,1,17,1,0,-2.0771428571426327
2019-09-15,0,0,0,0,0,0,0,0.0
2019-09-16,97,70,27,1,69,1,1,3.151428571428994
2019-09-17,117,18,99,1,17,1,0,-3.8142857142863136
2019-09-18,175,75,100,1,74,1,1,2.9542857142852768
2019-09-19,210,103,107,1,102,1,1,2.722857142857549
2019-09-20,168,72,96,1,71,1,0,-2.234285714285022
2019-09-22,7,0,7,0,0,0,0,0.0
2019-09-23,81,42,39,1,41,1,0,-3.5657142857137387
2019-09-24,173,63,110,1,62,1,1,2.885714285714414
2019-09-25,135,30,105,1,29,1,0,-3.5371428571427828
2019-09-26,170,55,115,1,54,1,0,-3.7028571428568853
2019-09-27,161,67,94,1,66,1,0,-3.9371428571432716
2019-09-29,19,0,19,0,0,0,0,0.0
2019-09-30,159,63,96,1,62,1,0,-3.8799999999999386
2019-10-01,149,52,97,1,51,1,0,-4.645714285714064
2019-10-02,161,57,104,1,56,1,0,-4.151428571428994
2019-10-03,170,64,106,1,63,1,1,8.337142857142055
2019-10-04,144,47,97,1,46,1,0,-4.577142857143201
2019-10-06,14,0,14,0,0,0,0,0.0
2019-10-07,174,88,86,1,87,1,1,4.728571428571627
2019-10-08,181,66,115,1,65,1,1,4.402857142856476
2019-10-09,268,153,115,0,153,0,0,0.0
2019-10-10,144,41,103,1,40,1,0,-2.7428571428577015
2019-10-11,156,66,90,1,65,1,1,4.257142857143037
2019-10-13,16,0,16,0,0,0,0,0.0
2019-10-14,259,154,105,0,154,0,0,0.0
2019-10-15,167,68,99,1,67,1,1,3.7514285714290168
2019-10-16,166,52,114,1,51,1,1,3.3057142857141457
2019-10-17,187,79,108,1,78,1,1,3.862857142857024
2019-10-18,163,70,93,0,70,0,0,0.0
2019-10-20,2,2,0,1,1,1,0,-3.505714285714589
2019-10-21,237,126,111,0,126,0,0,0.0
2019-10-22,224,111,113,1,110,1,1,2.800000000000125
2019-10-23,258,152,106,0,152,0,0,0.0
2019-10-24,195,97,98,0,97,0,0,0.0
2019-10-25,240,144,96,0,144,0,0,0.0
2019-10-27,14,12,2,0,12,0,0,0.0
2019-10-28,262,157,105,0,157,0,0,0.0
2019-10-29,123,68,55,1,67,1,0,-3.4742857142863954
2019-10-30,191,111,80,1,110,1,0,-4.937142857142362
2019-10-31,132,29,103,2,27,2,2,8.162857142857206
2019-11-01,138,65,73,1,64,1,0,-4.302857142856908
2019-11-03,3,0,3,0,0,0,0,0.0
2019-11-04,158,125,33,0,125,0,0,0.0
2019-11-05,129,32,97,1,31,1,1,3.511428571428155
2019-11-06,149,47,102,1,46,1,0,-3.562857142856501
2019-11-07,135,35,100,2,33,2,1,-0.6228571428588339
2019-11-08,146,58,88,1,57,1,0,-3.534285714285545
2019-11-10,19,0,19,0,0,0,0,0.0
2019-11-11,236,139,97,0,139,0,0,0.0
2019-11-12,241,140,101,0,140,0,0,0.0
2019-11-13,176,82,94,1,81,1,1,3.408571428571861
2019-11-14,177,90,87,1,89,1,1,2.705714285714123
2019-11-15,245,149,96,0,149,0,0,0.0
2019-11-17,15,0,15,0,0,0,0,0.0
2019-11-18,156,52,104,1,51,1,1,2.714285714285836
2019-11-19,188,79,109,1,78,1,1,2.4142857142858247
2019-11-20,157,47,110,1,46,1,1,2.782857142856699
2019-11-21,138,43,95,1,42,1,0,-2.4371428571417937
2019-11-22,159,67,92,1,66,1,1,1.8657142857146596
2019-11-24,13,0,13,0,0,0,0,0.0
2019-11-25,227,112,115,0,112,0,0,0.0
2019-11-26,169,55,114,1,54,1,1,1.8571428571429465
2019-11-27,177,68,109,1,67,1,1,1.5742857142863613
2019-11-28,249,153,96,0,153,0,0,0.0
2019-11-29,177,81,96,1,80,1,1,1.377142857142644
2019-12-01,17,0,17,0,0,0,0,0.0
2019-12-02,172,56,116,1,55,1,0,-1.9942857142855814
2019-12-03,176,59,117,1,58,1,1,1.9342857142855223
2019-12-04,163,52,111,1,51,1,0,-3.3199999999998226
2019-12-05,151,50,101,1,49,1,0,-2.671428571429601
2019-12-06,152,57,95,1,56,1,0,-3.7885714285711742
2019-12-08,15,0,15,0,0,0,0,0.0
2019-12-09,252,154,98,0,154,0,0,0.0
2019-12-10,165,54,111,1,53,1,0,-3.354285714285254
2019-12-11,168,153,15,0,153,0,0,0.0
2019-12-12,130,52,78,1,51,1,0,-2.2771428571421666
2019-12-13,101,42,59,1,41,1,0,-2.0114285714290077
2019-12-15,18,0,18,0,0,0,0,0.0
2019-12-16,227,114,113,0,114,0,0,0.0
2019-12-17,171,136,35,0,136,0,0,0.0
2019-12-18,177,91,86,0,91,0,0,0.0
2019-12-19,198,143,55,0,143,0,0,0.0
2019-12-20,161,141,20,0,141,0,0,0.0
2019-12-22,20,0,20,0,0,0,0,0.0
2019-12-23,184,139,45,0,139,0,0,0.0
2019-12-24,219,138,81,0,138,0,0,0.0
2019-12-25,98,0,98,0,0,0,0,0.0
2019-12-26,252,156,96,0,156,0,0,0.0
2019-12-27,199,107,92,0,107,0,0,0.0
2019-12-29,6,0,6,0,0,0,0,0.0
2019-12-30,175,67,108,1,66,1,1,2.4657142857146823
2019-12-31,170,74,96,1,73,1,1,3.22857142857157
2020-01-01,1,0,1,0,0,0,0,0.0
2020-01-02,71,49,22,1,48,1,1,2.354285714285254
2020-01-03,131,45,86,1,44,1,0,-3.4657142857146823
2020-01-05,14,0,14,0,0,0,0,0.0
2020-01-06,174,65,109,1,64,1,0,-3.422857142857538
2020-01-07,176,69,107,1,68,1,0,-3.4942857142856383
2020-01-08,137,34,103,1,33,1,0,-3.2057142857145777
2020-01-09,163,67,96,1,66,1,1,2.5942857142861158
2020-01-10,104,65,39,1,64,1,1,2.611428571428121
2020-01-12,15,0,15,0,0,0,0,0.0
2020-01-13,185,80,105,1,79,1,0,-2.4657142857141707
2020-01-14,164,58,106,1,57,1,1,2.800000000000125
2020-01-15,177,77,100,1,76,1,1,2.080000000000382
2020-01-16,171,63,108,1,62,1,1,2.277142857142678
2020-01-17,166,77,89,1,76,1,0,-3.2371428571427714
2020-01-19,21,0,21,0,0,0,0,0.0
2020-01-20,250,134,116,0,134,0,0,0.0
2020-01-21,174,67,107,1,66,1,1,2.1228571428575265
2020-01-22,179,68,111,1,67,1,1,1.6857142857143685
2020-01-23,150,34,116,1,33,1,0,-2.2799999999994043
2020-01-24,153,58,95,1,57,1,1,1.8399999999995202
2020-01-26,13,0,13,0,0,0,0,0.0
2020-01-27,119,55,64,1,54,1,0,-2.9714285714281914
2020-01-28,157,53,104,1,52,1,0,-3.4142857142858247
2020-01-29,110,42,68,1,41,1,1,3.065714285713284
2020-01-30,145,37,108,1,36,1,0,-3.3599999999997294
2020-01-31,154,60,94,1,59,1,0,-3.3514285714280163
2020-02-02,6,0,6,0,0,0,0,0.0
2020-02-03,164,57,107,1,56,1,1,3.502857142857863
2020-02-04,165,69,96,1,68,1,1,2.1057142857141002
2020-02-05,142,57,85,1,56,1,0,-1.9457142857139615
2020-02-06,168,62,106,1,61,1,1,2.182857142856676
2020-02-07,151,55,96,1,54,1,1,3.434285714285579
2020-02-09,18,0,18,0,0,0,0,0.0
2020-02-10,238,136,102,0,136,0,0,0.0
2020-02-11,171,72,99,1,71,1,1,1.7800000000003706
2020-02-12,189,90,99,1,89,1,1,1.4800000000003593
2020-02-13,159,52,107,1,51,1,0,-2.520000000000266
2020-02-14,132,74,58,1,73,1,1,1.5914285714283665
2020-02-16,0,0,0,0,0,0,0,0.0
2020-02-17,176,151,25,0,151,0,0,0.0
2020-02-18,138,30,108,1,29,1,1,1.4800000000003593
2020-02-19,176,63,113,1,62,1,1,4.514285714285904
2020-02-20,116,2,114,2,0,2,0,-5.831428571428376
2020-02-21,97,2,95,2,0,2,0,-6.962857142857558
2020-02-23,14,0,14,0,0,0,0,0.0
2020-02-24,160,54,106,1,53,1,0,-1.9257142857147187
2020-02-25,126,11,115,2,9,2,1,2.688571428571663
2020-02-26,117,8,109,2,6,2,1,2.451428571428039
2020-02-27,110,2,108,2,0,2,0,-8.019999999999982
2020-02-28,70,2,68,2,0,2,0,-8.574285714287043
2020-03-01,4,0,4,0,0,0,0,0.0
2020-03-02,99,2,97,2,0,2,0,-7.105714285713759
2020-03-03,112,2,110,2,0,2,0,-8.302857142856567
2020-03-04,132,20,112,1,19,1,0,-4.151428571428994
2020-03-05,167,57,110,1,56,1,0,-2.5142857142857906
2020-03-06,117,26,91,2,24,2,1,6.09428571428532
2020-03-08,15,0,15,0,0,0,0,0.0
2020-03-09,114,2,112,2,0,2,0,-13.059999999999604
2020-03-10,104,2,102,2,0,2,0,-17.425714285715287
2020-03-11,119,5,114,2,3,2,0,-15.134285714284545
2020-03-12,141,32,109,1,31,1,0,-9.382857142857858
2020-03-13,146,50,96,2,48,2,1,13.262857142855978
2020-03-15,15,0,15,0,0,0,0,0.0
2020-03-16,44,2,42,2,0,2,1,5.654285714284924
2020-03-17,126,9,117,2,7,2,0,-12.059999999999093
2020-03-18,190,84,106,1,83,1,1,15.348571428571745
2020-03-19,112,2,110,2,0,2,0,-13.182857142856562
2020-03-20,103,9,94,2,7,2,1,7.031428571428023
2020-03-22,10,0,10,0,0,0,0,0.0
2020-03-23,155,45,110,2,43,2,1,12.082857142858018
2020-03-24,167,52,115,1,51,1,0,-4.768571428571022
2020-03-25,211,98,113,1,97,1,1,6.922857142856287
2020-03-26,166,55,111,1,54,1,0,-7.24571428571511
2020-03-27,130,34,96,1,33,1,1,10.865714285715
2020-03-29,14,0,14,0,0,0,0,0.0
2020-03-30,138,40,98,1,39,1,0,-4.377142857142246
2020-03-31,160,45,115,1,44,1,1,10.111428571428405
2020-04-01,169,55,114,1,54,1,1,7.1200000000000045
2020-04-02,138,23,115,1,22,1,0,-4.994285714285695
2020-04-03,105,53,52,1,52,1,0,-5.14571428571503
2020-04-05,12,0,12,0,0,0,0,0.0
2020-04-06,151,34,117,1,33,1,0,-2.8485714285712334
2020-04-07,157,46,111,1,45,1,0,-4.502857142857863
2020-04-08,156,60,96,1,59,1,1,7.334285714285727
2020-04-09,177,63,114,1,62,1,1,4.180000000000462
2020-04-10,223,134,89,0,134,0,0,0.0
2020-04-12,15,12,3,0,12,0,0,0.0
2020-04-13,149,46,103,1,45,1,1,3.605714285714157
2020-04-14,147,57,90,1,56,1,0,-3.9485714285708013
2020-04-15,138,33,105,1,32,1,0,-3.3228571428570604
2020-04-16,159,56,103,1,55,1,0,-3.5599999999992633
2020-04-17,158,62,96,1,61,1,1,7.565714285714876
2020-04-19,18,0,18,0,0,0,0,0.0
2020-04-20,177,65,112,1,64,1,1,3.9142857142858816
2020-04-21,157,46,111,1,45,1,0,-2.8742857142863727
2020-04-22,159,63,96,1,62,1,0,-3.942857142857747
2020-04-23,90,37,53,1,36,1,0,-4.077142857142235
2020-04-24,239,145,94,0,145,0,0,0.0
2020-04-26,26,10,16,0,10,0,0,0.0
2020-04-27,170,66,104,1,65,1,1,4.814285714285916
2020-04-28,192,78,114,1,77,1,1,5.011428571428212
2020-04-29,149,53,96,1,52,1,1,6.039999999999679
2020-04-30,140,35,105,1,34,1,1,3.974285714285031
2020-05-01,99,51,48,1,50,1,0,-2.2314285714277844
2020-05-03,7,0,7,0,0,0,0,0.0
2020-05-04,160,46,114,1,45,1,1,3.5285714285715812
2020-05-05,155,44,111,1,43,1,1,2.9457142857135636
2020-05-06,168,53,115,1,52,1,0,-3.5114285714290645
2020-05-07,167,57,110,1,56,1,0,-2.197142857142353
2020-05-08,130,35,95,1,34,1,1,3.3571428571430033
2020-05-10,21,0,21,0,0,0,0,0.0
2020-05-11,179,74,105,1,73,1,1,3.8028571428564533
2020-05-12,143,33,110,1,32,1,0,-2.1857142857148233
2020-05-13,151,44,107,1,43,1,0,-2.825714285714753
2020-05-14,162,56,106,1,55,1,0,-2.2285714285719678
2020-05-15,135,56,79,1,55,1,0,-2.5714285714291236
2020-05-17,21,0,21,0,0,0,0,0.0
2020-05-18,124,65,59,1,64,1,0,-3.9571428571425145
2020-05-19,173,57,116,1,56,1,0,-4.077142857142235
2020-05-20,240,136,104,0,136,0,0,0.0
2020-05-21,224,127,97,0,127,0,0,0.0
2020-05-22,178,98,80,0,98,0,0,0.0
2020-05-24,18,7,11,0,7,0,0,0.0
2020-05-25,169,106,63,0,106,0,0,0.0
2020-05-26,227,112,115,0,112,0,0,0.0
2020-05-27,246,158,88,0,158,0,0,0.0
2020-05-28,250,150,100,0,150,0,0,0.0
2020-05-29,149,59,90,1,58,1,1,4.754285714285345
2020-05-31,16,0,16,0,0,0,0,0.0
2020-06-01,254,145,109,0,145,0,0,0.0
2020-06-02,154,55,99,1,54,1,0,-4.062857142858888
2020-06-03,260,148,112,0,148,0,0,0.0
2020-06-04,165,55,110,1,54,1,0,-3.4942857142856383
2020-06-05,142,57,85,1,56,1,0,-4.974285714285031
2020-06-07,3,0,3,0,0,0,0,0.0
2020-06-08,163,53,110,1,52,1,1,6.365714285713409
2020-06-09,164,53,111,1,52,1,0,-2.8485714285712334
2020-06-10,175,67,108,1,66,1,1,5.6028571428565215
2020-06-11,150,41,109,1,40,1,0,-4.177142857142712
2020-06-12,157,62,95,1,61,1,0,-4.4685714285710105
2020-06-14,5,0,5,0,0,0,0,0.0
2020-06-15,222,121,101,0,121,0,0,0.0
2020-06-16,145,57,88,1,56,1,0,-4.78285714285721
2020-06-17,224,118,106,0,118,0,0,0.0
2020-06-18,227,121,106,0,121,0,0,0.0
2020-06-19,172,87,85,0,87,0,0,0.0
2020-06-21,15,12,3,0,12,0,0,0.0
2020-06-22,222,124,98,0,124,0,0,0.0
2020-06-23,152,40,112,1,39,1,0,-3.68571428571488
2020-06-24,207,116,91,0,116,0,0,0.0
2020-06-25,218,158,60,0,158,0,0,0.0
2020-06-26,225,144,81,0,144,0,0,0.0
2020-06-28,14,12,2,0,12,0,0,0.0
2020-06-29,134,64,70,1,63,1,1,7.711428571428314
2020-06-30,162,61,101,1,60,1,0,-4.92857142857207
2020-07-01,187,80,107,0,80,0,0,0.0
2020-07-02,229,147,82,0,147,0,0,0.0
2020-07-03,171,113,58,0,113,0,0,0.0
2020-07-05,19,12,7,0,12,0,0,0.0
2020-07-06,254,144,110,0,144,0,0,0.0
2020-07-07,260,153,107,0,153,0,0,0.0
2020-07-08,261,155,106,0,155,0,0,0.0
2020-07-09,231,128,103,0,128,0,0,0.0
2020-07-10,237,141,96,0,141,0,0,0.0
2020-07-12,26,12,14,0,12,0,0,0.0
2020-07-13,213,128,85,0,128,0,0,0.0
2020-07-14,243,154,89,0,154,0,0,0.0
2020-07-15,218,155,63,0,155,0,0,0.0
2020-07-16,258,158,100,0,158,0,0,0.0
2020-07-17,240,146,94,0,146,0,0,0.0
2020-07-19,15,10,5,0,10,0,0,0.0
2020-07-20,249,143,106,0,143,0,0,0.0
2020-07-21,270,154,116,0,154,0,0,0.0
2020-07-22,231,146,85,0,146,0,0,0.0
2020-07-23,230,150,80,0,150,0,0,0.0
2020-07-24,149,53,96,1,52,1,1,7.3857142857145845
2020-07-26,9,0,9,0,0,0,0,0.0
2020-07-27,230,126,104,0,126,0,0,0.0
2020-07-28,158,59,99,1,58,1,1,6.091428571428537
2020-07-29,163,64,99,1,63,1,0,-4.4314285714283415
2020-07-30,167,54,113,1,53,1,0,-3.5657142857137387
2020-07-31,154,58,96,1,57,1,0,-3.6542857142852654
2020-08-02,5,0,5,0,0,0,0,0.0
2020-08-03,162,75,87,1,74,1,0,-5.15714285714256
2020-08-04,262,148,114,0,148,0,0,0.0
2020-08-05,215,114,101,0,114,0,0,0.0
2020-08-06,192,93,99,0,93,0,0,0.0
2020-08-07,212,118,94,0,118,0,0,0.0
2020-08-09,19,12,7,0,12,0,0,0.0
2020-08-10,221,115,106,0,115,0,0,0.0
2020-08-11,247,139,108,0,139,0,0,0.0
2020-08-12,245,144,101,0,144,0,0,0.0
2020-08-13,234,121,113,0,121,0,0,0.0
2020-08-14,198,119,79,0,119,0,0,0.0
2020-08-16,20,11,9,0,11,0,0,0.0
2020-08-17,244,152,92,0,152,0,0,0.0
2020-08-18,246,129,117,0,129,0,0,0.0
2020-08-19,263,152,111,0,152,0,0,0.0
2020-08-20,235,133,102,0,133,0,0,0.0
2020-08-21,238,142,96,0,142,0,0,0.0
2020-08-23,31,12,19,0,12,0,0,0.0
2020-08-24,201,142,59,0,142,0,0,0.0
2020-08-25,207,104,103,0,104,0,0,0.0
2020-08-26,243,133,110,0,133,0,0,0.0
2020-08-27,143,54,89,1,53,1,0,-6.8971428571434785
2020-08-28,153,57,96,1,56,1,0,-4.54285714285777
2020-08-30,4,0,4,0,0,0,0,0.0
2020-08-31,186,149,37,0,149,0,0,0.0
2020-09-01,272,159,113,0,159,0,0,0.0
2020-09-02,203,90,113,0,90,0,0,0.0
2020-09-03,269,157,112,0,157,0,0,0.0
2020-09-04,213,141,72,0,141,0,0,0.0
2020-09-06,26,12,14,0,12,0,0,0.0
2020-09-07,253,149,104,0,149,0,0,0.0
2020-09-08,235,123,112,0,123,0,0,0.0
2020-09-09,118,85,33,0,85,0,0,0.0
2020-09-10,249,141,108,0,141,0,0,0.0
2020-09-11,216,129,87,0,129,0,0,0.0
2020-09-13,24,12,12,0,12,0,0,0.0
2020-09-14,259,156,103,0,156,0,0,0.0
2020-09-15,235,133,102,0,133,0,0,0.0
2020-09-16,201,85,116,1,84,1,1,11.877142857143042
2020-09-17,271,157,114,0,157,0,0,0.0
2020-09-18,239,146,93,0,146,0,0,0.0
2020-09-20,12,12,0,0,12,0,0,0.0
2020-09-21,124,37,87,1,36,1,1,10.497142857142705
2020-09-22,261,160,101,0,160,0,0,0.0
2020-09-23,243,144,99,0,144,0,0,0.0
2020-09-24,206,100,106,0,100,0,0,0.0
2020-09-25,233,148,85,0,148,0,0,0.0
2020-09-27,32,12,20,0,12,0,0,0.0
2020-09-28,220,106,114,0,106,0,0,0.0
2020-09-29,208,111,97,0,111,0,0,0.0
2020-09-30,258,155,103,0,155,0,0,0.0
2020-10-01,239,145,94,0,145,0,0,0.0
2020-10-02,213,129,84,0,129,0,0,0.0
2020-10-04,24,8,16,0,8,0,0,0.0
2020-10-05,215,113,102,0,113,0,0,0.0
2020-10-06,226,122,104,0,122,0,0,0.0
2020-10-07,253,155,98,0,155,0,0,0.0
2020-10-08,181,100,81,0,100,0,0,0.0
2020-10-09,214,118,96,0,118,0,0,0.0
2020-10-11,32,12,20,0,12,0,0,0.0
2020-10-12,201,94,107,0,94,0,0,0.0
2020-10-13,200,105,95,0,105,0,0,0.0
2020-10-14,241,135,106,0,135,0,0,0.0
2020-10-15,268,154,114,0,154,0,0,0.0
2020-10-16,228,132,96,0,132,0,0,0.0
2020-10-18,11,0,11,0,0,0,0,0.0
2020-10-19,222,156,66,0,156,0,0,0.0
2020-10-20,254,154,100,0,154,0,0,0.0
2020-10-21,261,152,109,0,152,0,0,0.0
2020-10-22,258,151,107,0,151,0,0,0.0
2020-10-23,162,67,95,0,67,0,0,0.0
2020-10-25,30,12,18,0,12,0,0,0.0
2020-10-26,251,144,107,0,144,0,0,0.0
2020-10-27,264,148,116,0,148,0,0,0.0
2020-10-28,244,140,104,0,140,0,0,0.0
2020-10-29,255,151,104,0,151,0,0,0.0
2020-10-30,188,92,96,0,92,0,0,0.0
2020-11-01,8,0,8,0,0,0,0,0.0
2020-11-02,253,157,96,0,157,0,0,0.0
2020-11-03,190,148,42,0,148,0,0,0.0
2020-11-04,156,43,113,1,42,1,0,-4.717142857142164
2020-11-05,202,85,117,0,85,0,0,0.0
2020-11-06,144,56,88,1,55,1,1,9.17714285714294
2020-11-08,21,0,21,0,0,0,0,0.0
2020-11-09,161,56,105,1,55,1,0,-6.17142857142926
2020-11-10,175,79,96,0,79,0,0,0.0
2020-11-11,207,112,95,0,112,0,0,0.0
2020-11-12,252,148,104,0,148,0,0,0.0
2020-11-13,250,154,96,0,154,0,0,0.0
2020-11-15,0,0,0,0,0,0,0,0.0
2020-11-16,236,154,82,0,154,0,0,0.0
2020-11-17,210,93,117,0,93,0,0,0.0
2020-11-18,243,133,110,0,133,0,0,0.0
2020-11-19,226,133,93,0,133,0,0,0.0
2020-11-20,198,109,89,0,109,0,0,0.0
2020-11-22,16,0,16,0,0,0,0,0.0
2020-11-23,111,66,45,1,65,1,1,7.900000000000318
2020-11-24,206,112,94,0,112,0,0,0.0
2020-11-25,198,88,110,0,88,0,0,0.0
2020-11-26,216,104,112,0,104,0,0,0.0
2020-11-27,225,129,96,0,129,0,0,0.0
2020-11-29,16,0,16,0,0,0,0,0.0
2020-11-30,250,139,111,0,139,0,0,0.0
2020-12-01,243,132,111,0,132,0,0,0.0
2020-12-02,256,139,117,0,139,0,0,0.0
2020-12-03,233,128,105,0,128,0,0,0.0
2020-12-04,97,30,67,1,29,1,0,-4.8771428571432125
2020-12-06,17,0,17,0,0,0,0,0.0
2020-12-07,219,149,70,0,149,0,0,0.0
2020-12-08,204,109,95,0,109,0,0,0.0
2020-12-09,269,156,113,0,156,0,0,0.0
2020-12-10,230,130,100,0,130,0,0,0.0
2020-12-11,241,145,96,0,145,0,0,0.0
2020-12-13,6,0,6,0,0,0,0,0.0
2020-12-14,186,150,36,0,150,0,0,0.0
2020-12-15,235,146,89,0,146,0,0,0.0
2020-12-16,245,132,113,1,131,1,1,7.531428571428023
2020-12-17,227,126,101,0,126,0,0,0.0
2020-12-18,168,72,96,0,72,0,0,0.0
2020-12-20,1,0,1,0,0,0,0,0.0
2020-12-21,162,143,19,0,143,0,0,0.0
2020-12-22,258,150,108,0,150,0,0,0.0
2020-12-23,209,95,114,0,95,0,0,0.0
2020-12-24,230,117,113,0,117,0,0,0.0
2020-12-25,60,0,60,0,0,0,0,0.0
2020-12-27,17,0,17,0,0,0,0,0.0
2020-12-28,230,151,79,0,151,0,0,0.0
2020-12-29,223,120,103,0,120,0,0,0.0
2020-12-30,254,151,103,0,151,0,0,0.0
2020-12-31,149,146,3,0,146,0,0,0.0
2021-01-03,13,0,13,0,0,0,0,0.0
2021-01-04,257,155,102,0,155,0,0,0.0
2021-01-05,256,151,105,0,151,0,0,0.0
2021-01-06,226,138,88,0,138,0,0,0.0
2021-01-07,257,147,110,0,147,0,0,0.0
2021-01-08,160,64,96,1,63,1,1,7.102857142856578
2021-01-10,20,0,20,0,0,0,0,0.0
2021-01-11,247,134,113,0,134,0,0,0.0
2021-01-12,217,131,86,0,131,0,0,0.0
2021-01-13,207,97,110,0,97,0,0,0.0
2021-01-14,214,110,104,0,110,0,0,0.0
2021-01-15,160,125,35,0,125,0,0,0.0
2021-01-17,5,0,5,0,0,0,0,0.0
2021-01-18,246,142,104,0,142,0,0,0.0
2021-01-19,208,112,96,0,112,0,0,0.0
2021-01-20,175,75,100,1,74,1,1,5.345714285715076
2021-01-21,264,156,108,0,156,0,0,0.0
2021-01-22,212,116,96,0,116,0,0,0.0
2021-01-24,1,0,1,0,0,0,0,0.0
2021-01-25,195,117,78,0,117,0,0,0.0
2021-01-26,194,123,71,0,123,0,0,0.0
2021-01-27,253,160,93,0,160,0,0,0.0
2021-01-28,132,27,105,1,26,1,0,-4.27714285714319
2021-01-29,215,119,96,0,119,0,0,0.0
2021-01-31,18,0,18,0,0,0,0,0.0
2021-02-01,218,115,103,0,115,0,0,0.0
2021-02-02,227,135,92,0,135,0,0,0.0
2021-02-03,199,88,111,0,88,0,0,0.0
2021-02-04,259,155,104,0,155,0,0,0.0
2021-02-05,118,62,56,1,61,1,0,-3.774285714286407
2021-02-07,21,0,21,0,0,0,0,0.0
2021-02-08,261,156,105,0,156,0,0,0.0
2021-02-09,212,102,110,0,102,0,0,0.0
2021-02-10,258,156,102,0,156,0,0,0.0
2021-02-11,172,138,34,0,138,0,0,0.0
2021-02-12,243,155,88,0,155,0,0,0.0
2021-02-14,18,0,18,0,0,0,0,0.0
2021-02-15,232,128,104,0,128,0,0,0.0
2021-02-16,269,155,114,0,155,0,0,0.0
2021-02-17,150,50,100,1,49,1,0,-4.759999999999309
2021-02-18,201,104,97,0,104,0,0,0.0
2021-02-19,251,162,89,0,162,0,0,0.0
2021-02-21,16,0,16,0,0,0,0,0.0
2021-02-22,174,74,100,1,73,1,1,6.477142857142837
2021-02-23,167,71,96,1,70,1,1,5.465714285714796
2021-02-24,178,65,113,1,64,1,0,-3.742857142858213
2021-02-25,209,97,112,1,96,1,0,-3.3028571428563964
2021-02-26,234,148,86,0,148,0,0,0.0
2021-02-28,7,0,7,0,0,0,0,0.0
2021-03-01,243,151,92,0,151,0,0,0.0
2021-03-02,250,143,107,0,143,0,0,0.0
2021-03-03,268,153,115,0,153,0,0,0.0
2021-03-04,225,116,109,1,115,1,1,5.902857142856533
2021-03-05,144,55,89,1,54,1,1,6.639999999999702
2021-03-07,13,0,13,0,0,0,0,0.0
2021-03-08,241,151,90,0,151,0,0,0.0
2021-03-09,177,63,114,1,62,1,1,4.428571428571615
2021-03-10,142,31,111,1,30,1,0,-5.031428571428364
2021-03-11,169,64,105,1,63,1,1,4.59142857142848
2021-03-12,124,28,96,1,27,1,0,-3.877142857142701
2021-03-14,18,0,18,0,0,0,0,0.0
2021-03-15,216,123,93,0,123,0,0,0.0
2021-03-16,146,46,100,1,45,1,0,-2.957142857143424
2021-03-17,226,111,115,1,110,1,1,5.3285714285716494
2021-03-18,176,67,109,1,66,1,1,4.5314285714279094
2021-03-19,140,44,96,1,43,1,0,-4.322857142857572
2021-03-21,10,0,10,0,0,0,0,0.0
2021-03-22,111,78,33,0,78,0,0,0.0
2021-03-23,235,126,109,0,126,0,0,0.0
2021-03-24,221,114,107,0,114,0,0,0.0
2021-03-25,247,132,115,0,132,0,0,0.0
2021-03-26,233,137,96,0,137,0,0,0.0
2021-03-28,28,12,16,0,12,0,0,0.0
2021-03-29,252,154,98,0,154,0,0,0.0
2021-03-30,226,113,113,0,113,0,0,0.0
2021-03-31,168,52,116,1,51,1,1,4.831428571429342
2021-04-01,151,55,96,1,54,1,0,-3.8828571428571763
2021-04-02,147,56,91,1,55,1,0,-2.614285714286268
2021-04-04,20,0,20,0,0,0,0,0.0
2021-04-05,110,34,76,1,33,1,1,4.539999999999623
2021-04-06,165,58,107,1,57,1,0,-3.705714285714123
2021-04-07,134,28,106,1,27,1,1,4.73714285714334
2021-04-08,172,60,112,1,59,1,1,4.548571428571336
2021-04-09,128,57,71,1,56,1,0,-4.354285714285766
2021-04-11,19,0,19,0,0,0,0,0.0
2021-04-12,263,157,106,0,157,0,0,0.0
2021-04-13,256,141,115,0,141,0,0,0.0
2021-04-14,151,48,103,1,47,1,0,-2.614285714284847
2021-04-15,174,58,116,1,57,1,0,-2.6942857142860817
2021-04-16,234,138,96,0,138,0,0,0.0
2021-04-18,29,12,17,0,12,0,0,0.0
2021-04-19,156,49,107,0,49,0,0,0.0
2021-04-20,261,148,113,0,148,0,0,0.0
2021-04-21,266,150,116,0,150,0,0,0.0
2021-04-22,242,129,113,0,129,0,0,0.0
2021-04-23,111,34,77,1,33,1,0,-2.7800000000003706
2021-04-25,17,0,17,0,0,0,0,0.0
2021-04-26,249,134,115,0,134,0,0,0.0
2021-04-27,264,150,114,0,150,0,0,0.0
2021-04-28,183,66,117,1,65,1,1,5.0628571428570694
2021-04-29,165,52,113,1,51,1,0,-3.125714285714764
2021-04-30,163,67,96,1,66,1,1,4.994285714286207
2021-05-02,1,0,1,0,0,0,0,0.0
2021-05-03,164,55,109,1,54,1,0,-2.6485714285716995
2021-05-04,171,63,108,1,62,1,1,4.968571428571067
2021-05-05,159,50,109,1,49,1,0,-2.8171428571430397
2021-05-06,168,58,110,1,57,1,0,-4.254285714285288
2021-05-07,132,41,91,1,40,1,0,-8.094285714286286
2021-05-09,1,0,1,0,0,0,0,0.0
2021-05-10,236,121,115,0,121,0,0,0.0
2021-05-11,164,56,108,1,55,1,0,-3.3228571428570604
2021-05-12,166,56,110,1,55,1,0,-4.617142857143108
2021-05-13,203,112,91,0,112,0,0,0.0
2021-05-14,174,78,96,0,78,0,0,0.0
2021-05-16,32,12,20,0,12,0,0,0.0
2021-05-17,176,103,73,0,103,0,0,0.0
2021-05-18,209,109,100,0,109,0,0,0.0
2021-05-19,203,89,114,1,88,1,1,7.377142857142871
2021-05-20,258,142,116,0,142,0,0,0.0
2021-05-21,217,122,95,0,122,0,0,0.0
2021-05-23,17,12,5,0,12,0,0,0.0
2021-05-24,242,158,84,0,158,0,0,0.0
2021-05-25,243,138,105,0,138,0,0,0.0
2021-05-26,245,150,95,0,150,0,0,0.0
2021-05-27,272,160,112,0,160,0,0,0.0
2021-05-28,225,130,95,0,130,0,0,0.0
2021-05-30,24,12,12,0,12,0,0,0.0
2021-05-31,255,140,115,0,140,0,0,0.0
2021-06-01,228,126,102,0,126,0,0,0.0
2021-06-02,272,156,116,0,156,0,0,0.0
2021-06-03,269,158,111,0,158,0,0,0.0
2021-06-04,143,47,96,1,46,1,0,-4.268571428571477
2021-06-06,18,0,18,0,0,0,0,0.0
2021-06-07,116,42,74,0,42,0,0,0.0
2021-06-08,255,150,105,0,150,0,0,0.0
2021-06-09,247,147,100,0,147,0,0,0.0
2021-06-10,266,155,111,0,155,0,0,0.0
2021-06-11,235,143,92,0,143,0,0,0.0
2021-06-13,3,0,3,0,0,0,0,0.0
2021-06-14,230,142,88,0,142,0,0,0.0
2021-06-15,181,83,98,0,83,0,0,0.0
2021-06-16,238,139,99,0,139,0,0,0.0
2021-06-17,263,156,107,0,156,0,0,0.0
2021-06-18,174,80,94,1,79,1,0,-5.045714285714553
2021-06-20,2,0,2,0,0,0,0,0.0
2021-06-21,240,133,107,0,133,0,0,0.0
2021-06-22,217,116,101,0,116,0,0,0.0
2021-06-23,243,140,103,0,140,0,0,0.0
2021-06-24,253,152,101,0,152,0,0,0.0
2021-06-25,223,134,89,0,134,0,0,0.0
2021-06-27,12,12,0,0,12,0,0,0.0
2021-06-28,254,160,94,0,160,0,0,0.0
2021-06-29,254,153,101,0,153,0,0,0.0
2021-06-30,257,152,105,0,152,0,0,0.0
2021-07-01,245,151,94,0,151,0,0,0.0
2021-07-02,219,123,96,0,123,0,0,0.0
2021-07-04,33,12,21,0,12,0,0,0.0
2021-07-05,212,121,91,0,121,0,0,0.0
2021-07-06,255,145,110,0,145,0,0,0.0
2021-07-07,196,86,110,0,86,0,0,0.0
2021-07-08,248,134,114,0,134,0,0,0.0
2021-07-09,236,140,96,0,140,0,0,0.0
2021-07-11,28,12,16,0,12,0,0,0.0
2021-07-12,215,159,56,0,159,0,0,0.0
2021-07-13,259,144,115,0,144,0,0,0.0
2021-07-14,255,139,116,0,139,0,0,0.0
2021-07-15,226,114,112,0,114,0,0,0.0
2021-07-16,233,137,96,0,137,0,0,0.0
2021-07-18,26,12,14,0,12,0,0,0.0
2021-07-19,214,101,113,0,101,0,0,0.0
2021-07-20,262,155,107,0,155,0,0,0.0
2021-07-21,161,60,101,0,60,0,0,0.0
2021-07-22,175,71,104,0,71,0,0,0.0
2021-07-23,236,145,91,0,145,0,0,0.0
2021-07-25,13,9,4,0,9,0,0,0.0
2021-07-26,177,69,108,0,69,0,0,0.0
2021-07-27,232,118,114,0,118,0,0,0.0
2021-07-28,207,93,114,1,92,1,1,8.337142857143476
2021-07-29,227,115,112,0,115,0,0,0.0
2021-07-30,201,105,96,0,105,0,0,0.0
2021-08-01,16,12,4,0,12,0,0,0.0
2021-08-02,189,155,34,0,155,0,0,0.0
2021-08-03,261,147,114,0,147,0,0,0.0
2021-08-04,138,56,82,1,55,1,1,9.408571428572088
2021-08-05,261,157,104,0,157,0,0,0.0
2021-08-06,152,58,94,1,57,1,0,-3.1971428571428646
2021-08-08,13,0,13,0,0,0,0,0.0
2021-08-09,233,140,93,0,140,0,0,0.0
2021-08-10,222,151,71,0,151,0,0,0.0
2021-08-11,236,127,109,0,127,0,0,0.0
2021-08-12,247,138,109,0,138,0,0,0.0
2021-08-13,205,122,83,0,122,0,0,0.0
2021-08-15,28,12,16,0,12,0,0,0.0
2021-08-16,181,69,112,0,69,0,0,0.0
2021-08-17,156,55,101,1,54,1,0,-4.785714285714448
2021-08-18,212,122,90,0,122,0,0,0.0
2021-08-19,184,81,103,0,81,0,0,0.0
2021-08-20,155,66,89,0,66,0,0,0.0
2021-08-22,32,12,20,0,12,0,0,0.0
2021-08-23,254,142,112,0,142,0,0,0.0
2021-08-24,273,158,115,0,158,0,0,0.0
2021-08-25,254,140,114,0,140,0,0,0.0
2021-08-26,245,133,112,0,133,0,0,0.0
2021-08-27,137,41,96,1,40,1,1,8.611428571428348
2021-08-29,6,0,6,0,0,0,0,0.0
2021-08-30,204,115,89,0,115,0,0,0.0
2021-08-31,254,151,103,0,151,0,0,0.0
2021-09-01,214,99,115,0,99,0,0,0.0
2021-09-02,252,143,109,0,143,0,0,0.0
2021-09-03,241,145,96,0,145,0,0,0.0
2021-09-05,16,12,4,0,12,0,0,0.0
2021-09-06,181,76,105,0,76,0,0,0.0
2021-09-07,220,109,111,0,109,0,0,0.0
2021-09-08,192,89,103,0,89,0,0,0.0
2021-09-09,220,103,117,0,103,0,0,0.0
2021-09-10,180,99,81,0,99,0,0,0.0
2021-09-12,15,11,4,0,11,0,0,0.0
2021-09-13,258,144,114,0,144,0,0,0.0
2021-09-14,259,145,114,0,145,0,0,0.0
2021-09-15,213,98,115,0,98,0,0,0.0
2021-09-16,197,88,109,0,88,0,0,0.0
2021-09-17,239,143,96,0,143,0,0,0.0
2021-09-19,16,12,4,0,12,0,0,0.0
2021-09-20,252,144,108,0,144,0,0,0.0
2021-09-21,240,124,116,0,124,0,0,0.0
2021-09-22,220,105,115,1,104,1,0,-5.005714285714646
2021-09-23,250,153,97,0,153,0,0,0.0
2021-09-24,212,116,96,0,116,0,0,0.0
2021-09-26,12,12,0,0,12,0,0,0.0
2021-09-27,243,151,92,0,151,0,0,0.0
2021-09-28,181,69,112,1,68,1,1,7.085714285714573
2021-09-29,255,147,108,0,147,0,0,0.0
2021-09-30,201,86,115,1,85,1,1,7.702857142856601
2021-10-01,137,46,91,1,45,1,0,-4.377142857143667
2021-10-03,2,0,2,0,0,0,0,0.0
2021-10-04,150,67,83,1,66,1,1,5.551428571429085
2021-10-05,271,159,112,0,159,0,0,0.0
2021-10-06,164,52,112,1,51,1,0,-2.814285714285802
2021-10-07,239,126,113,0,126,0,0,0.0
2021-10-08,152,56,96,1,55,1,0,-4.314285714285859
2021-10-10,18,0,18,0,0,0,0,0.0
2021-10-11,248,135,113,0,135,0,0,0.0
2021-10-12,155,53,102,1,52,1,0,-5.354285714286277
2021-10-13,134,22,112,1,21,1,0,-3.6742857142859293
2021-10-14,254,139,115,0,139,0,0,0.0
2021-10-15,174,78,96,1,77,1,1,7.600000000000307
2021-10-17,4,0,4,0,0,0,0,0.0
2021-10-18,190,117,73,0,117,0,0,0.0
2021-10-19,233,116,117,0,116,0,0,0.0
2021-10-20,252,136,116,0,136,0,0,0.0
2021-10-21,164,52,112,1,51,1,0,-3.3028571428578175
2021-10-22,163,67,96,1,66,1,0,-5.222857142857606
2021-10-24,20,0,20,0,0,0,0,0.0
2021-10-25,258,147,111,0,147,0,0,0.0
2021-10-26,225,109,116,0,109,0,0,0.0
2021-10-27,173,60,113,1,59,1,0,-5.388571428571709
2021-10-28,239,129,110,0,129,0,0,0.0
2021-10-29,245,149,96,0,149,0,0,0.0
2021-10-31,27,12,15,0,12,0,0,0.0
2021-11-01,240,132,108,0,132,0,0,0.0
2021-11-02,249,137,112,0,137,0,0,0.0
2021-11-03,228,118,110,1,117,1,1,10.462857142857274
2021-11-04,275,158,117,0,158,0,0,0.0
2021-11-05,138,42,96,1,41,1,0,-4.328571428572047
2021-11-07,20,0,20,0,0,0,0,0.0
2021-11-08,274,159,115,0,159,0,0,0.0
2021-11-09,256,143,113,0,143,0,0,0.0
2021-11-10,157,63,94,1,62,1,1,9.142857142857508
2021-11-11,238,132,106,0,132,0,0,0.0
2021-11-12,164,68,96,1,67,1,1,7.19714285714258
2021-11-14,21,0,21,0,0,0,0,0.0
2021-11-15,247,148,99,0,148,0,0,0.0
2021-11-16,258,144,114,0,144,0,0,0.0
2021-11-17,210,105,105,1,104,1,1,6.022857142857674
2021-11-18,144,80,64,1,79,1,0,-4.514285714285393
2021-11-19,161,53,108,1,52,1,0,-3.95142857142946
2021-11-21,21,0,21,0,0,0,0,0.0
2021-11-22,132,31,101,1,30,1,1,6.8457142857151325
2021-11-23,149,48,101,1,47,1,0,-4.51714285714263
2021-11-24,164,71,93,1,70,1,1,6.511428571428269
2021-11-25,167,117,50,0,117,0,0,0.0
2021-11-26,116,20,96,1,19,1,1,6.2285714285716836
2021-11-28,15,0,15,0,0,0,0,0.0
2021-11-29,117,44,73,1,43,1,1,7.522857142857731
2021-11-30,171,56,115,1,55,1,0,-4.717142857143585
2021-12-01,137,28,109,1,27,1,0,-2.8285714285719905
2021-12-02,155,43,112,1,42,1,0,-4.491428571428912
2021-12-03,134,60,74,1,59,1,0,-5.125714285714366
2021-12-05,14,0,14,0,0,0,0,0.0
2021-12-06,255,142,113,0,142,0,0,0.0
2021-12-07,203,91,112,0,91,0,0,0.0
2021-12-08,244,154,90,0,154,0,0,0.0
2021-12-09,247,139,108,0,139,0,0,0.0
2021-12-10,158,63,95,1,62,1,1,7.46285714285716
2021-12-12,17,0,17,0,0,0,0,0.0
2021-12-13,255,141,114,0,141,0,0,0.0
2021-12-14,258,152,106,0,152,0,0,0.0
2021-12-15,210,113,97,1,112,1,1,5.928571428571672
2021-12-16,163,49,114,1,48,1,1,4.780000000000484
2021-12-17,150,57,93,1,56,1,0,-2.822857142857515
2021-12-19,12,0,12,0,0,0,0,0.0
2021-12-20,244,143,101,0,143,0,0,0.0
2021-12-21,263,156,107,0,156,0,0,0.0
2021-12-22,218,139,79,0,139,0,0,0.0
2021-12-23,240,123,117,0,123,0,0,0.0
2021-12-24,220,124,96,0,124,0,0,0.0
2021-12-26,4,0,4,0,0,0,0,0.0
2021-12-27,228,153,75,0,153,0,0,0.0
2021-12-28,245,144,101,0,144,0,0,0.0
2021-12-29,181,65,116,1,64,1,1,4.522857142857617
2021-12-30,218,103,115,0,103,0,0,0.0
2021-12-31,221,125,96,0,125,0,0,0.0
2022-01-02,19,0,19,0,0,0,0,0.0
2022-01-03,192,76,116,1,75,1,1,3.948571428571313
2022-01-04,171,55,116,1,54,1,0,-3.4657142857146823
2022-01-05,176,59,117,1,58,1,0,-4.020000000000323
2022-01-06,166,49,117,1,48,1,0,-4.13142857142833
2022-01-07,158,62,96,1,61,1,0,-4.377142857142246
2022-01-09,6,0,6,0,0,0,0,0.0
2022-01-10,246,139,107,0,139,0,0,0.0
2022-01-11,265,153,112,0,153,0,0,0.0
2022-01-12,172,64,108,1,63,1,1,6.357142857143117
2022-01-13,151,54,97,1,53,1,0,-4.628571428572059
2022-01-14,147,51,96,1,50,1,1,5.379999999999086
2022-01-16,20,0,20,0,0,0,0,0.0
2022-01-17,217,110,107,0,110,0,0,0.0
2022-01-18,173,74,99,1,73,1,1,4.934285714285636
2022-01-19,184,69,115,1,68,1,1,4.239999999999611
2022-01-20,170,61,109,1,60,1,1,3.6314285714278753
2022-01-21,131,35,96,1,34,1,0,-2.1857142857148233
2022-01-23,18,0,18,0,0,0,0,0.0
2022-01-24,164,50,114,1,49,1,0,-3.9285714285715585
2022-01-25,164,57,107,1,56,1,0,-3.925714285714321
2022-01-26,216,115,101,1,114,1,0,-4.074285714284997
2022-01-27,172,61,111,1,60,1,0,-4.257142857142526
2022-01-28,146,52,94,1,51,1,1,5.637142857143374
2022-01-30,18,0,18,0,0,0,0,0.0
2022-01-31,155,43,112,1,42,1,0,-4.331428571429285
2022-02-01,252,136,116,0,136,0,0,0.0
2022-02-02,263,152,111,0,152,0,0,0.0
2022-02-03,151,63,88,1,62,1,1,5.191428571428503
2022-02-04,174,84,90,1,83,1,1,6.194285714284831
2022-02-06,12,0,12,0,0,0,0,0.0
2022-02-07,241,162,79,0,162,0,0,0.0
2022-02-08,269,155,114,0,155,0,0,0.0
2022-02-09,223,112,111,0,112,0,0,0.0
2022-02-10,170,55,115,1,54,1,1,4.14571428571503
2022-02-11,128,40,88,1,39,1,0,-2.3942857142860703
2022-02-13,19,0,19,0,0,0,0,0.0
2022-02-14,128,58,70,1,57,1,0,-4.831428571430251
2022-02-15,226,119,107,0,119,0,0,0.0
2022-02-16,136,28,108,1,27,1,1,4.419999999998481
2022-02-17,178,74,104,1,73,1,1,6.751428571427709
2022-02-18,158,62,96,1,61,1,0,-3.7971428571428874
2022-02-20,18,0,18,0,0,0,0,0.0
2022-02-21,251,140,111,0,140,0,0,0.0
2022-02-22,252,141,111,0,141,0,0,0.0
2022-02-23,164,66,98,1,65,1,1,3.6399999999995885
2022-02-24,145,32,113,1,31,1,0,-4.522857142857106
2022-02-25,149,53,96,1,52,1,0,-2.4771428571431215
2022-02-27,1,0,1,0,0,0,0,0.0
2022-02-28,87,69,18,1,68,1,1,5.208571428571929
2022-03-01,165,56,109,1,55,1,0,-4.005714285714134
2022-03-02,158,48,110,1,47,1,0,-3.222857142858004
2022-03-03,158,45,113,1,44,1,1,4.445714285715042
2022-03-04,163,68,95,1,67,1,1,6.297142857142546
2022-03-06,2,0,2,0,0,0,0,0.0
2022-03-07,121,65,56,1,64,1,0,-3.8600000000006958
2022-03-08,181,75,106,1,74,1,1,3.862857142857024
2022-03-09,156,42,114,1,41,1,0,-3.8457142857145072
2022-03-10,161,52,109,1,51,1,0,-3.91428571428537
2022-03-11,251,155,96,0,155,0,0,0.0
2022-03-13,33,12,21,0,12,0,0,0.0
2022-03-14,220,105,115,0,105,0,0,0.0
2022-03-15,143,32,111,1,31,1,0,-3.0285714285715244
2022-03-16,157,41,116,1,40,1,1,5.037142857143351
2022-03-17,148,63,85,1,62,1,1,4.480000000000473
2022-03-18,146,51,95,1,50,1,0,-4.859999999999786
2022-03-20,12,0,12,0,0,0,0,0.0
2022-03-21,106,75,31,1,74,1,1,3.8885714285721633
2022-03-22,161,50,111,1,49,1,0,-4.211428571428144
2022-03-23,130,33,97,1,32,1,0,-3.6057142857136455
2022-03-24,114,19,95,1,18,1,0,-2.5057142857140775
2022-03-25,119,23,96,1,22,1,1,6.065714285714819
2022-03-27,18,0,18,0,0,0,0,0.0
2022-03-28,140,29,111,2,27,2,0,-17.282857142857665
2022-03-29,142,27,115,2,25,2,1,9.142857142857054
2022-03-30,134,29,105,1,28,1,0,-3.8714285714282255
2022-03-31,130,26,104,1,25,1,0,-5.619999999999436
2022-04-01,153,57,96,1,56,1,0,-4.334285714286523
2022-04-03,2,0,2,0,0,0,0,0.0
2022-04-04,97,53,44,1,52,1,0,-4.779999999999973
2022-04-05,153,45,108,1,44,1,1,7.814285714286029
2022-04-06,156,55,101,1,54,1,1,5.671428571428805
2022-04-07,146,38,108,0,38,0,0,0.0
2022-04-08,117,32,85,1,31,1,1,5.174285714285077
2022-04-10,16,0,16,0,0,0,0,0.0
2022-04-11,172,59,113,1,58,1,0,-4.457142857143481
2022-04-12,129,26,103,1,25,1,0,-7.022857142857674
2022-04-13,136,28,108,1,27,1,0,-3.8428571428572695
2022-04-14,159,43,116,1,42,1,0,-5.571428571429237
2022-04-15,186,90,96,0,90,0,0,0.0
2022-04-17,29,10,19,0,10,0,0,0.0
2022-04-18,242,152,90,0,152,0,0,0.0
2022-04-19,160,56,104,1,55,1,0,-5.105714285713702
2022-04-20,147,58,89,1,57,1,0,-6.559999999999377
2022-04-21,115,25,90,1,24,1,0,-4.028571428572036
2022-04-22,155,61,94,1,60,1,0,-5.848571428569926
2022-04-24,2,0,2,0,0,0,0,0.0
2022-04-25,239,155,84,0,155,0,0,0.0
2022-04-26,158,55,103,1,54,1,0,-4.922857142857595
2022-04-27,248,141,107,0,141,0,0,0.0
2022-04-28,149,46,103,1,45,1,0,-7.154285714284924
2022-04-29,161,65,96,1,64,1,1,15.220000000001733
2022-05-01,3,0,3,0,0,0,0,0.0
2022-05-02,220,150,70,0,150,0,0,0.0
2022-05-03,231,134,97,0,134,0,0,0.0
2022-05-04,152,95,57,1,94,1,0,-6.171428571426418
2022-05-05,214,140,74,0,140,0,0,0.0
2022-05-06,203,107,96,0,107,0,0,0.0
2022-05-08,7,6,1,0,6,0,0,0.0
2022-05-09,238,136,102,0,136,0,0,0.0
2022-05-10,229,156,73,0,156,0,0,0.0
2022-05-11,107,54,53,1,53,1,0,-9.785714285712743
2022-05-12,103,6,97,1,5,1,0,-9.382857142856437
2022-05-13,226,136,90,0,136,0,0,0.0
2022-05-15,23,11,12,0,11,0,0,0.0
2022-05-16,146,49,97,0,49,0,0,0.0
2022-05-17,261,152,109,0,152,0,0,0.0
2022-05-18,269,160,109,0,160,0,0,0.0
2022-05-19,162,60,102,1,59,1,0,-8.448571428570972
2022-05-20,180,102,78,0,102,0,0,0.0
2022-05-22,2,2,0,0,2,0,0,0.0
2022-05-23,208,115,93,0,115,0,0,0.0
2022-05-24,233,130,103,0,130,0,0,0.0
2022-05-25,221,108,113,0,108,0,0,0.0
2022-05-26,219,105,114,0,105,0,0,0.0
2022-05-27,213,119,94,0,119,0,0,0.0
2022-05-29,27,8,19,0,8,0,0,0.0
2022-05-30,244,131,113,0,131,0,0,0.0
2022-05-31,220,103,117,0,103,0,0,0.0
2022-06-01,248,139,109,0,139,0,0,0.0
2022-06-02,260,153,107,0,153,0,0,0.0
2022-06-03,208,133,75,0,133,0,0,0.0
2022-06-05,23,12,11,0,12,0,0,0.0
2022-06-06,270,158,112,0,158,0,0,0.0
2022-06-07,246,129,117,0,129,0,0,0.0
2022-06-08,241,126,115,0,126,0,0,0.0
2022-06-09,251,153,98,0,153,0,0,0.0
2022-06-10,151,55,96,1,54,1,0,-9.837142857143022
2022-06-12,9,0,9,0,0,0,0,0.0
2022-06-13,223,120,103,0,120,0,0,0.0
2022-06-14,261,148,113,0,148,0,0,0.0
2022-06-15,270,142,128,0,142,0,0,0.0
2022-06-16,215,106,109,1,105,1,1,28.197142857143376
2022-06-17,189,93,96,1,92,1,0,-7.814285714286939
2022-06-19,20,12,8,0,12,0,0,0.0
2022-06-20,148,57,91,0,57,0,0,0.0
2022-06-21,211,121,90,0,121,0,0,0.0
2022-06-22,237,123,114,0,123,0,0,0.0
2022-06-23,194,79,115,0,79,0,0,0.0
2022-06-24,221,125,96,0,125,0,0,0.0
2022-06-26,13,1,12,0,1,0,0,0.0
2022-06-27,217,107,110,0,107,0,0,0.0
2022-06-28,182,71,111,0,71,0,0,0.0
2022-06-29,177,74,103,0,74,0,0,0.0
2022-06-30,223,147,76,0,147,0,0,0.0
2022-07-01,178,82,96,0,82,0,0,0.0
2022-07-03,18,0,18,0,0,0,0,0.0
2022-07-04,236,134,102,0,134,0,0,0.0
2022-07-05,197,80,117,0,80,0,0,0.0
2022-07-06,241,128,113,0,128,0,0,0.0
2022-07-07,249,138,111,0,138,0,0,0.0
2022-07-08,226,136,90,0,136,0,0,0.0
2022-07-10,33,12,21,0,12,0,0,0.0
2022-07-11,264,154,110,0,154,0,0,0.0
2022-07-12,231,122,109,0,122,0,0,0.0
2022-07-13,251,138,113,0,138,0,0,0.0
2022-07-14,258,147,111,0,147,0,0,0.0
2022-07-15,204,121,83,0,121,0,0,0.0
2022-07-17,25,10,15,0,10,0,0,0.0
2022-07-18,271,156,115,0,156,0,0,0.0
2022-07-19,244,136,108,0,136,0,0,0.0
2022-07-20,252,137,115,0,137,0,0,0.0
2022-07-21,263,153,110,0,153,0,0,0.0
2022-07-22,155,70,85,1,69,1,1,26.22571428571473
2022-07-24,20,0,20,0,0,0,0,0.0
2022-07-25,231,132,99,0,132,0,0,0.0
2022-07-26,244,138,106,0,138,0,0,0.0
2022-07-27,218,115,103,1,114,1,1,22.471428571429442
2022-07-28,151,48,103,1,47,1,0,-8.120000000000005
2022-07-29,125,53,72,1,52,1,0,-7.6457142857127565
2022-07-31,15,0,15,0,0,0,0,0.0
2022-08-01,245,131,114,0,131,0,0,0.0
2022-08-02,143,37,106,1,36,1,1,18.88857142857273
2022-08-03,125,50,75,1,49,1,0,-7.579999999999131
2022-08-04,258,147,111,0,147,0,0,0.0
2022-08-05,144,51,93,2,49,2,1,8.020000000001005
2022-08-07,10,0,10,0,0,0,0,0.0
2022-08-08,194,135,59,0,135,0,0,0.0
2022-08-09,178,73,105,0,73,0,0,0.0
2022-08-10,127,26,101,1,25,1,0,-17.502857142855987
2022-08-11,147,53,94,1,52,1,0,-9.239999999997394
2022-08-12,225,129,96,0,129,0,0,0.0
2022-08-14,27,11,16,0,11,0,0,0.0
2022-08-15,257,144,113,0,144,0,0,0.0
2022-08-16,256,149,107,0,149,0,0,0.0
2022-08-17,216,112,104,0,112,0,0,0.0
2022-08-18,233,132,101,0,132,0,0,0.0
2022-08-19,186,90,96,0,90,0,0,0.0
2022-08-21,11,0,11,0,0,0,0,0.0
2022-08-22,261,149,112,0,149,0,0,0.0
2022-08-23,263,148,115,0,148,0,0,0.0
2022-08-24,183,68,115,0,68,0,0,0.0
2022-08-25,213,99,114,0,99,0,0,0.0
2022-08-26,234,138,96,0,138,0,0,0.0
2022-08-28,26,12,14,0,12,0,0,0.0
2022-08-29,259,158,101,0,158,0,0,0.0
2022-08-30,222,112,110,0,112,0,0,0.0
2022-08-31,262,155,107,0,155,0,0,0.0
2022-09-01,252,143,109,0,143,0,0,0.0
2022-09-02,229,137,92,0,137,0,0,0.0
2022-09-04,30,12,18,0,12,0,0,0.0
2022-09-05,198,114,84,0,114,0,0,0.0
2022-09-06,260,149,111,0,149,0,0,0.0
2022-09-07,271,154,117,0,154,0,0,0.0
2022-09-08,124,13,111,2,11,2,1,5.048571428573268
2022-09-09,186,90,96,1,89,1,0,-6.291428571427559
2022-09-11,18,4,14,0,4,0,0,0.0
2022-09-12,212,118,94,1,117,1,1,12.93142857143107
2022-09-13,144,50,94,1,49,1,1,47.285714285714675
2022-09-14,153,53,100,1,52,1,0,-8.911428571426427
2022-09-15,192,93,99,0,93,0,0,0.0
2022-09-16,240,149,91,0,149,0,0,0.0
2022-09-18,29,11,18,0,11,0,0,0.0
2022-09-19,234,126,108,0,126,0,0,0.0
2022-09-20,168,58,110,0,58,0,0,0.0
2022-09-21,223,107,116,1,106,1,0,-10.219999999998663
2022-09-22,100,3,97,2,1,2,1,33.757142857145595
2022-09-23,180,88,92,1,87,1,0,-5.622857142856674
2022-09-25,20,12,8,0,12,0,0,0.0
2022-09-26,217,107,110,1,106,1,0,-6.897142857142057
2022-09-27,243,131,112,0,131,0,0,0.0
2022-09-28,263,153,110,0,153,0,0,0.0
2022-09-29,186,87,99,0,87,0,0,0.0
2022-09-30,214,128,86,0,128,0,0,0.0
2022-10-02,27,11,16,0,11,0,0,0.0
2022-10-03,263,149,114,0,149,0,0,0.0
2022-10-04,266,157,109,0,157,0,0,0.0
2022-10-05,174,95,79,0,95,0,0,0.0
2022-10-06,219,154,65,0,154,0,0,0.0
2022-10-07,180,117,63,0,117,0,0,0.0
2022-10-09,15,6,9,0,6,0,0,0.0
2022-10-10,235,142,93,0,142,0,0,0.0
2022-10-11,220,122,98,0,122,0,0,0.0
2022-10-12,243,128,115,0,128,0,0,0.0
2022-10-13,204,146,58,0,146,0,0,0.0
2022-10-14,238,147,91,0,147,0,0,0.0
2022-10-16,25,12,13,0,12,0,0,0.0
2022-10-17,251,153,98,0,153,0,0,0.0
2022-10-18,256,149,107,0,149,0,0,0.0
2022-10-19,213,147,66,0,147,0,0,0.0
2022-10-20,236,127,109,0,127,0,0,0.0
2022-10-21,158,62,96,1,61,1,1,46.00000000000034
2022-10-23,14,0,14,0,0,0,0,0.0
2022-10-24,183,141,42,1,140,1,0,-6.771428571426441
2022-10-25,121,41,80,1,40,1,1,22.222857142858288
2022-10-26,53,10,43,2,8,2,1,8.614285714286552
2022-10-27,146,55,91,1,54,1,0,-8.057142857143617
2022-10-28,129,52,77,1,51,1,0,-7.248571428570926
2022-10-30,4,0,4,0,0,0,0,0.0
2022-10-31,230,116,114,0,116,0,0,0.0
2022-11-01,260,151,109,0,151,0,0,0.0
2022-11-02,193,77,116,1,76,1,1,15.202857142858306
2022-11-03,162,60,102,1,59,1,1,11.491428571428742
2022-11-04,62,6,56,2,4,2,0,-16.514285714286302
2022-11-06,0,0,0,0,0,0,0,0.0
2022-11-07,126,58,68,1,57,1,0,-5.091428571427514
2022-11-08,182,71,111,1,70,1,1,12.78571428571479
2022-11-09,168,59,109,1,58,1,0,-7.542857142855041
2022-11-10,169,53,116,1,52,1,1,25.788571428571572
2022-11-11,110,14,96,2,12,2,1,11.197142857144172
2022-11-13,0,0,0,0,0,0,0,0.0
2022-11-14,38,4,34,2,2,2,0,-15.782857142853345
2022-11-15,114,5,109,2,3,2,0,-21.008571428570576
2022-11-16,149,35,114,1,34,1,0,-8.682857142855937
2022-11-17,245,136,109,0,136,0,0,0.0
2022-11-18,213,117,96,0,117,0,0,0.0
2022-11-20,19,0,19,0,0,0,0,0.0
2022-11-21,242,142,100,0,142,0,0,0.0
2022-11-22,263,147,116,0,147,0,0,0.0
2022-11-23,184,76,108,1,75,1,1,23.11428571428803
2022-11-24,263,152,111,0,152,0,0,0.0
2022-11-25,242,149,93,0,149,0,0,0.0
2022-11-27,10,0,10,0,0,0,0,0.0
2022-11-28,232,128,104,0,128,0,0,0.0
2022-11-29,237,126,111,0,126,0,0,0.0
2022-11-30,164,54,110,1,53,1,0,-7.845714285713711
2022-12-01,166,50,116,1,49,1,0,-9.059999999999945
2022-12-02,154,58,96,1,57,1,0,-11.471428571426145
2022-12-04,2,0,2,0,0,0,0,0.0
2022-12-05,223,158,65,0,158,0,0,0.0
2022-12-06,252,146,106,0,146,0,0,0.0
2022-12-07,218,113,105,0,113,0,0,0.0
2022-12-08,210,102,108,0,102,0,0,0.0
2022-12-09,247,151,96,0,151,0,0,0.0
2022-12-11,17,0,17,0,0,0,0,0.0
2022-12-12,222,110,112,0,110,0,0,0.0
2022-12-13,172,58,114,1,57,1,1,28.06000000000165
2022-12-14,207,100,107,1,99,1,1,18.717142857144154
2022-12-15,179,64,115,1,63,1,0,-7.677142857142371
2022-12-16,136,40,96,1,39,1,0,-7.794285714283433
2022-12-18,15,0,15,0,0,0,0,0.0
2022-12-19,195,159,36,0,159,0,0,0.0
2022-12-20,213,102,111,1,101,1,0,-10.628571428572286
2022-12-21,254,154,100,0,154,0,0,0.0
2022-12-22,244,130,114,0,130,0,0,0.0
2022-12-23,224,128,96,0,128,0,0,0.0
2022-12-25,11,0,11,0,0,0,0,0.0
2022-12-26,271,159,112,0,159,0,0,0.0
2022-12-27,240,147,93,0,147,0,0,0.0
2022-12-28,259,142,117,0,142,0,0,0.0
2022-12-29,229,120,109,0,120,0,0,0.0
2022-12-30,231,135,96,0,135,0,0,0.0
2023-01-01,8,0,8,0,0,0,0,0.0
2023-01-02,167,127,40,0,127,0,0,0.0
2023-01-03,214,100,114,0,100,0,0,0.0
2023-01-04,268,157,111,0,157,0,0,0.0
2023-01-05,163,58,105,0,58,0,0,0.0
2023-01-06,129,33,96,1,32,1,1,20.740000000000236
2023-01-08,19,0,19,0,0,0,0,0.0
2023-01-09,255,153,102,0,153,0,0,0.0
2023-01-10,124,50,74,1,49,1,1,14.208571428573691
2023-01-11,247,143,104,0,143,0,0,0.0
2023-01-12,165,50,115,1,49,1,0,-9.811428571427882
2023-01-13,125,40,85,1,39,1,1,13.73714285714368
2023-01-15,20,0,20,0,0,0,0,0.0
2023-01-16,194,78,116,0,78,0,0,0.0
2023-01-17,152,35,117,1,34,1,0,-4.700000000000159
2023-01-18,168,54,114,1,53,1,0,-8.337142857141544
2023-01-19,161,51,110,1,50,1,0,-7.254285714285402
2023-01-20,253,157,96,0,157,0,0,0.0
2023-01-22,19,0,19,0,0,0,0,0.0
2023-01-23,259,150,109,0,150,0,0,0.0
2023-01-24,265,156,109,0,156,0,0,0.0
2023-01-25,267,156,111,0,156,0,0,0.0
2023-01-26,158,46,112,1,45,1,1,16.33428571428749
2023-01-27,120,24,96,1,23,1,0,-6.679999999997676
2023-01-29,8,0,8,0,0,0,0,0.0
2023-01-30,271,157,114,0,157,0,0,0.0
2023-01-31,185,70,115,1,69,1,1,14.371428571427714
2023-02-01,170,59,111,1,58,1,1,11.07142857142901
2023-02-02,175,65,110,1,64,1,1,13.351428571430802
2023-02-03,142,52,90,1,51,1,1,13.651428571429392
2023-02-05,7,0,7,0,0,0,0,0.0
2023-02-06,92,50,42,1,49,1,0,-5.07142857142685
2023-02-07,150,52,98,1,51,1,0,-3.6542857142852654
2023-02-08,144,51,93,1,50,1,1,8.028571428573173
2023-02-09,149,49,100,1,48,1,0,-3.9828571428562327
2023-02-10,96,2,94,2,0,2,0,-17.042857142858225
2023-02-12,20,0,20,0,0,0,0,0.0
2023-02-13,164,60,104,1,59,1,0,-5.551428571428573
2023-02-14,147,36,111,1,35,1,0,-9.128571428570808
2023-02-15,144,36,108,1,35,1,1,10.780000000002133
2023-02-16,141,36,105,1,35,1,1,9.151428571430642
2023-02-17,130,34,96,1,33,1,0,-3.7171428571416527
2023-02-19,19,0,19,0,0,0,0,0.0
2023-02-20,217,115,102,0,115,0,0,0.0
2023-02-21,150,43,107,1,42,1,0,-5.720000000002756
2023-02-22,157,55,102,1,54,1,0,-5.908571428569076
2023-02-23,146,44,102,1,43,1,1,10.608571428573555
2023-02-24,138,54,84,1,53,1,0,-7.211428571426836
2023-02-26,19,0,19,0,0,0,0,0.0
2023-02-27,266,160,106,0,160,0,0,0.0
2023-02-28,154,56,98,1,55,1,1,9.785714285714675
2023-03-01,171,55,116,1,54,1,1,7.942857142858884
2023-03-02,150,48,102,1,47,1,0,-3.8057142857131794
2023-03-03,114,57,57,1,56,1,1,7.797142857142603
2023-03-05,18,0,18,0,0,0,0,0.0
2023-03-06,168,57,111,1,56,1,0,-4.802857142855032
2023-03-07,163,55,108,1,54,1,1,7.334285714287148
2023-03-08,158,51,107,1,50,1,0,-3.4342857142864887
2023-03-09,186,75,111,1,74,1,1,12.245714285716758
2023-03-10,152,56,96,1,55,1,0,-3.5200000000007776
2023-03-12,21,0,21,0,0,0,0,0.0
2023-03-13,100,23,77,2,21,2,1,15.448571428571768
2023-03-14,117,2,115,2,0,2,0,-21.75999999999567
2023-03-15,163,56,107,1,55,1,0,-13.031428571426773
2023-03-16,129,17,112,1,16,1,0,-9.734285714285306
2023-03-17,136,40,96,1,39,1,1,16.57428571428693
2023-03-19,18,0,18,0,0,0,0,0.0
2023-03-20,164,81,83,0,81,0,0,0.0
2023-03-21,151,55,96,1,54,1,0,-6.2599999999979445
2023-03-22,196,105,91,1,104,1,1,29.791428571430856
2023-03-23,169,58,111,1,57,1,0,-5.0771428571441675
2023-03-24,138,43,95,1,42,1,0,-5.131428571428842
2023-03-26,4,0,4,0,0,0,0,0.0
2023-03-27,206,145,61,0,145,0,0,0.0
2023-03-28,179,66,113,1,65,1,1,10.822857142857856
2023-03-29,171,57,114,1,56,1,1,8.688571428572345
2023-03-30,165,49,116,1,48,1,0,-6.311428571428223
2023-03-31,139,43,96,1,42,1,0,-6.191428571429924
2023-04-02,3,0,3,0,0,0,0,0.0
2023-04-03,254,152,102,0,152,0,0,0.0
2023-04-04,172,67,105,1,66,1,1,13.368571428571386
2023-04-05,156,59,97,1,58,1,0,-5.974285714285543
2023-04-06,141,42,99,1,41,1,0,-7.619999999997617
2023-04-07,125,50,75,1,49,1,0,-5.9571428571421166
2023-04-09,8,0,8,0,0,0,0,0.0
2023-04-10,243,143,100,0,143,0,0,0.0
2023-04-11,267,152,115,0,152,0,0,0.0
2023-04-12,157,51,106,1,50,1,0,-8.900000000000318
2023-04-13,101,47,54,1,46,1,1,14.302857142859693
2023-04-14,152,57,95,1,56,1,0,-7.071428571427873
2023-04-16,21,0,21,0,0,0,0,0.0
2023-04-17,216,130,86,0,130,0,0,0.0
2023-04-18,238,149,89,0,149,0,0,0.0
2023-04-19,236,140,96,0,140,0,0,0.0
2023-04-20,132,50,82,1,49,1,0,-5.960000000002196
2023-04-21,165,69,96,1,68,1,1,14.62000000000171
2023-04-23,17,0,17,0,0,0,0,0.0
2023-04-24,246,154,92,0,154,0,0,0.0
2023-04-25,199,111,88,0,111,0,0,0.0
2023-04-26,168,53,115,1,52,1,1,11.191428571430151
2023-04-27,140,44,96,1,43,1,0,-6.885714285713107
2023-04-28,142,54,88,1,53,1,0,-6.142857142856883
2023-04-30,11,0,11,0,0,0,0,0.0
2023-05-01,247,139,108,0,139,0,0,0.0
2023-05-02,170,64,106,1,63,1,1,12.802857142858215
2023-05-03,124,26,98,1,25,1,0,-6.282857142855846
2023-05-04,110,66,44,1,65,1,1,17.85142857142955
2023-05-05,150,54,96,1,53,1,0,-7.857142857142662
2023-05-07,18,0,18,0,0,0,0,0.0
2023-05-08,223,133,90,0,133,0,0,0.0
2023-05-09,198,99,99,0,99,0,0,0.0
2023-05-10,138,36,102,1,35,1,0,-7.054285714284447
2023-05-11,155,48,107,1,47,1,0,-7.211428571429678
2023-05-12,206,120,86,0,120,0,0,0.0
2023-05-14,18,12,6,0,12,0,0,0.0
2023-05-15,207,102,105,0,102,0,0,0.0
2023-05-16,256,143,113,0,143,0,0,0.0
2023-05-17,226,129,97,0,129,0,0,0.0
2023-05-18,106,22,84,1,21,1,0,-7.394285714284365
2023-05-19,227,131,96,0,131,0,0,0.0
2023-05-21,33,12,21,0,12,0,0,0.0
2023-05-22,236,145,91,0,145,0,0,0.0
2023-05-23,151,48,103,0,48,0,0,0.0
2023-05-24,266,156,110,0,156,0,0,0.0
2023-05-25,248,140,108,0,140,0,0,0.0
2023-05-26,239,145,94,0,145,0,0,0.0
2023-05-28,14,12,2,0,12,0,0,0.0
2023-05-29,265,158,107,0,158,0,0,0.0
2023-05-30,217,122,95,0,122,0,0,0.0
2023-05-31,153,61,92,1,60,1,0,-8.408571428569644
2023-06-01,251,145,106,0,145,0,0,0.0
2023-06-02,153,60,93,1,59,1,0,-9.877142857141507
2023-06-04,12,0,12,0,0,0,0,0.0
2023-06-05,212,120,92,0,120,0,0,0.0
2023-06-06,160,86,74,0,86,0,0,0.0
2023-06-07,271,157,114,0,157,0,0,0.0
2023-06-08,257,148,109,0,148,0,0,0.0
2023-06-09,220,124,96,0,124,0,0,0.0
2023-06-11,15,6,9,0,6,0,0,0.0
2023-06-12,248,161,87,0,161,0,0,0.0
2023-06-13,236,128,108,0,128,0,0,0.0
2023-06-14,242,130,112,0,130,0,0,0.0
2023-06-15,248,135,113,0,135,0,0,0.0
2023-06-16,238,143,95,0,143,0,0,0.0
2023-06-18,24,12,12,0,12,0,0,0.0
2023-06-19,225,154,71,0,154,0,0,0.0
2023-06-20,266,158,108,0,158,0,0,0.0
2023-06-21,249,133,116,0,133,0,0,0.0
2023-06-22,241,157,84,0,157,0,0,0.0
2023-06-23,235,145,90,0,145,0,0,0.0
2023-06-25,24,11,13,0,11,0,0,0.0
2023-06-26,240,131,109,0,131,0,0,0.0
2023-06-27,247,148,99,0,148,0,0,0.0
2023-06-28,200,103,97,0,103,0,0,0.0
2023-06-29,132,50,82,0,50,0,0,0.0
2023-06-30,225,142,83,0,142,0,0,0.0
2023-07-02,24,12,12,0,12,0,0,0.0
2023-07-03,230,130,100,0,130,0,0,0.0
2023-07-04,243,154,89,0,154,0,0,0.0
2023-07-05,240,130,110,0,130,0,0,0.0
2023-07-06,203,89,114,0,89,0,0,0.0
2023-07-07,231,137,94,0,137,0,0,0.0
2023-07-09,10,10,0,0,10,0,0,0.0
2023-07-10,245,145,100,0,145,0,0,0.0
2023-07-11,226,115,111,0,115,0,0,0.0
2023-07-12,251,137,114,0,137,0,0,0.0
2023-07-13,265,159,106,0,159,0,0,0.0
2023-07-14,217,122,95,0,122,0,0,0.0
2023-07-16,14,11,3,0,11,0,0,0.0
2023-07-17,247,142,105,0,142,0,0,0.0
2023-07-18,147,38,109,1,37,1,0,-12.111428571427496
2023-07-19,223,115,108,0,115,0,0,0.0
2023-07-20,260,151,109,0,151,0,0,0.0
2023-07-21,201,108,93,0,108,0,0,0.0
2023-07-23,23,12,11,0,12,0,0,0.0
2023-07-24,270,155,115,0,155,0,0,0.0
2023-07-25,209,121,88,0,121,0,0,0.0
2023-07-26,254,147,107,0,147,0,0,0.0
2023-07-27,243,149,94,0,149,0,0,0.0
2023-07-28,172,123,49,0,123,0,0,0.0
2023-07-30,33,12,21,0,12,0,0,0.0
2023-07-31,235,129,106,0,129,0,0,0.0
2023-08-01,241,139,102,0,139,0,0,0.0
2023-08-02,247,145,102,0,145,0,0,0.0
2023-08-03,205,99,106,0,99,0,0,0.0
2023-08-04,215,124,91,0,124,0,0,0.0
2023-08-06,26,12,14,0,12,0,0,0.0
2023-08-07,236,130,106,0,130,0,0,0.0
2023-08-08,223,110,113,0,110,0,0,0.0
2023-08-09,260,153,107,0,153,0,0,0.0
2023-08-10,249,135,114,0,135,0,0,0.0
2023-08-11,162,103,59,0,103,0,0,0.0
2023-08-13,25,11,14,0,11,0,0,0.0
2023-08-14,215,143,72,0,143,0,0,0.0
2023-08-15,191,79,112,0,79,0,0,0.0
2023-08-16,234,131,103,0,131,0,0,0.0
2023-08-17,258,142,116,0,142,0,0,0.0
2023-08-18,242,146,96,0,146,0,0,0.0
2023-08-20,30,12,18,0,12,0,0,0.0
2023-08-21,185,121,64,0,121,0,0,0.0
2023-08-22,256,144,112,0,144,0,0,0.0
2023-08-23,258,149,109,0,149,0,0,0.0
2023-08-24,200,91,109,0,91,0,0,0.0
2023-08-25,225,130,95,0,130,0,0,0.0
2023-08-27,32,12,20,0,12,0,0,0.0
2023-08-28,212,103,109,0,103,0,0,0.0
2023-08-29,249,156,93,0,156,0,0,0.0
2023-08-30,245,128,117,0,128,0,0,0.0
2023-08-31,228,128,100,0,128,0,0,0.0
2023-09-01,193,120,73,0,120,0,0,0.0
2023-09-03,27,12,15,0,12,0,0,0.0
2023-09-04,207,124,83,0,124,0,0,0.0
2023-09-05,272,155,117,0,155,0,0,0.0
2023-09-06,254,138,116,0,138,0,0,0.0
2023-09-07,182,68,114,0,68,0,0,0.0
2023-09-08,229,133,96,0,133,0,0,0.0
2023-09-10,21,12,9,0,12,0,0,0.0
2023-09-11,198,118,80,0,118,0,0,0.0
2023-09-12,214,103,111,0,103,0,0,0.0
2023-09-13,184,79,105,0,79,0,0,0.0
2023-09-14,218,117,101,0,117,0,0,0.0
2023-09-15,128,55,73,0,55,0,0,0.0
2023-09-17,33,12,21,0,12,0,0,0.0
2023-09-18,248,143,105,0,143,0,0,0.0
2023-09-19,248,140,108,0,140,0,0,0.0
2023-09-20,265,156,109,0,156,0,0,0.0
2023-09-21,262,154,108,0,154,0,0,0.0
2023-09-22,222,126,96,0,126,0,0,0.0
2023-09-24,28,12,16,0,12,0,0,0.0
2023-09-25,219,156,63,0,156,0,0,0.0
2023-09-26,209,96,113,0,96,0,0,0.0
2023-09-27,230,155,75,0,155,0,0,0.0
2023-09-28,200,97,103,0,97,0,0,0.0
2023-09-29,237,141,96,0,141,0,0,0.0
2023-10-01,29,12,17,0,12,0,0,0.0
2023-10-02,243,135,108,0,135,0,0,0.0
2023-10-03,259,138,121,0,138,0,0,0.0
2023-10-04,255,140,115,0,140,0,0,0.0
2023-10-05,265,152,113,0,152,0,0,0.0
2023-10-06,189,93,96,0,93,0,0,0.0
2023-10-08,18,12,6,0,12,0,0,0.0
2023-10-09,165,151,14,0,151,0,0,0.0
2023-10-10,246,143,103,0,143,0,0,0.0
2023-10-11,224,124,100,0,124,0,0,0.0
2023-10-12,228,136,92,0,136,0,0,0.0
2023-10-13,190,100,90,0,100,0,0,0.0
2023-10-15,25,11,14,0,11,0,0,0.0
2023-10-16,197,144,53,0,144,0,0,0.0
2023-10-17,145,83,62,0,83,0,0,0.0
2023-10-18,260,152,108,0,152,0,0,0.0
2023-10-19,216,141,75,0,141,0,0,0.0
2023-10-20,245,149,96,0,149,0,0,0.0
2023-10-22,14,12,2,0,12,0,0,0.0
2023-10-23,233,149,84,0,149,0,0,0.0
2023-10-24,240,146,94,0,146,0,0,0.0
2023-10-25,220,150,70,0,150,0,0,0.0
2023-10-26,236,135,101,0,135,0,0,0.0
2023-10-27,239,147,92,0,147,0,0,0.0
2023-10-29,30,12,18,0,12,0,0,0.0
2023-10-30,231,155,76,0,155,0,0,0.0
2023-10-31,263,148,115,0,148,0,0,0.0
2023-11-01,267,150,117,0,150,0,0,0.0
2023-11-02,260,149,111,0,149,0,0,0.0
2023-11-03,172,82,90,0,82,0,0,0.0
2023-11-05,16,0,16,0,0,0,0,0.0
2023-11-06,189,83,106,0,83,0,0,0.0
2023-11-07,232,132,100,0,132,0,0,0.0
2023-11-08,253,151,102,0,151,0,0,0.0
2023-11-09,217,157,60,0,157,0,0,0.0
2023-11-10,248,158,90,0,158,0,0,0.0
2023-11-12,20,0,20,0,0,0,0,0.0
2023-11-13,220,123,97,0,123,0,0,0.0
2023-11-14,218,139,79,0,139,0,0,0.0
2023-11-15,275,160,115,0,160,0,0,0.0
2023-11-16,243,161,82,0,161,0,0,0.0
2023-11-17,187,158,29,0,158,0,0,0.0
2023-11-19,17,0,17,0,0,0,0,0.0
2023-11-20,198,94,104,0,94,0,0,0.0
2023-11-21,266,150,116,0,150,0,0,0.0
2023-11-22,267,159,108,0,159,0,0,0.0
2023-11-23,213,103,110,0,103,0,0,0.0
2023-11-24,181,107,74,0,107,0,0,0.0
2023-11-26,12,0,12,0,0,0,0,0.0
2023-11-27,209,103,106,0,103,0,0,0.0
2023-11-28,236,128,108,0,128,0,0,0.0
2023-11-29,264,147,117,0,147,0,0,0.0
2023-11-30,267,159,108,0,159,0,0,0.0
2023-12-01,240,144,96,0,144,0,0,0.0
2023-12-03,13,0,13,0,0,0,0,0.0
2023-12-04,252,153,99,0,153,0,0,0.0
2023-12-05,238,155,83,0,155,0,0,0.0
2023-12-06,194,101,93,0,101,0,0,0.0
2023-12-07,277,152,125,0,152,0,0,0.0
2023-12-08,248,147,101,0,147,0,0,0.0
2023-12-10,6,0,6,0,0,0,0,0.0
2023-12-11,240,129,111,0,129,0,0,0.0
2023-12-12,264,148,116,0,148,0,0,0.0
2023-12-13,254,121,133,0,121,0,0,0.0
2023-12-14,206,91,115,0,91,0,0,0.0
2023-12-15,243,150,93,0,150,0,0,0.0
2023-12-17,18,0,18,0,0,0,0,0.0
2023-12-18,253,144,109,0,144,0,0,0.0
2023-12-19,269,154,115,0,154,0,0,0.0
2023-12-20,259,153,106,0,153,0,0,0.0
2023-12-21,250,155,95,0,155,0,0,0.0
2023-12-22,246,156,90,0,156,0,0,0.0
2023-12-24,0,0,0,0,0,0,0,0.0
2023-12-25,91,0,91,0,0,0,0,0.0
2023-12-26,222,150,72,0,150,0,0,0.0
2023-12-27,211,95,116,0,95,0,0,0.0
2023-12-28,240,134,106,0,134,0,0,0.0
2023-12-29,240,158,82,0,158,0,0,0.0
2024-01-01,15,0,15,0,0,0,0,0.0
2024-01-02,247,137,110,0,137,0,0,0.0
2024-01-03,249,160,89,0,160,0,0,0.0
2024-01-04,270,160,110,0,160,0,0,0.0
2024-01-05,251,155,96,0,155,0,0,0.0
2024-01-07,15,0,15,0,0,0,0,0.0
2024-01-08,201,135,66,0,135,0,0,0.0
2024-01-09,254,139,115,0,139,0,0,0.0
2024-01-10,236,134,102,0,134,0,0,0.0
2024-01-11,239,113,126,0,113,0,0,0.0
2024-01-12,233,137,96,0,137,0,0,0.0
2024-01-14,16,0,16,0,0,0,0,0.0
2024-01-15,270,153,117,0,153,0,0,0.0
2024-01-16,272,157,115,0,157,0,0,0.0
2024-01-17,242,145,97,0,145,0,0,0.0
2024-01-18,236,140,96,0,140,0,0,0.0
2024-01-19,223,128,95,0,128,0,0,0.0
2024-01-21,1,0,1,0,0,0,0,0.0
2024-01-22,208,139,69,0,139,0,0,0.0
2024-01-23,237,147,90,0,147,0,0,0.0
2024-01-24,254,147,107,0,147,0,0,0.0
2024-01-25,235,127,108,0,127,0,0,0.0
2024-01-26,220,150,70,0,150,0,0,0.0
2024-01-28,15,0,15,0,0,0,0,0.0
2024-01-29,238,128,110,0,128,0,0,0.0
2024-01-30,213,104,109,0,104,0,0,0.0
2024-01-31,268,160,108,0,160,0,0,0.0
2024-02-01,239,139,100,0,139,0,0,0.0
2024-02-02,186,153,33,0,153,0,0,0.0
2024-02-04,18,0,18,0,0,0,0,0.0
2024-02-05,200,114,86,0,114,0,0,0.0
2024-02-06,257,144,113,0,144,0,0,0.0
2024-02-07,238,133,105,0,133,0,0,0.0
2024-02-08,243,134,109,0,134,0,0,0.0
2024-02-09,217,127,90,0,127,0,0,0.0
2024-02-11,13,0,13,0,0,0,0,0.0
2024-02-12,216,131,85,0,131,0,0,0.0
2024-02-13,248,139,109,0,139,0,0,0.0
2024-02-14,240,127,113,0,127,0,0,0.0
2024-02-15,260,149,111,0,149,0,0,0.0
2024-02-16,237,141,96,0,141,0,0,0.0
2024-02-18,3,0,3,0,0,0,0,0.0
2024-02-19,211,103,108,0,103,0,0,0.0
2024-02-20,268,156,112,0,156,0,0,0.0
2024-02-21,259,158,101,0,158,0,0,0.0
2024-02-22,254,158,96,0,158,0,0,0.0
2024-02-23,185,112,73,0,112,0,0,0.0
2024-02-25,11,0,11,0,0,0,0,0.0
2024-02-26,182,158,24,0,158,0,0,0.0
2024-02-27,260,157,103,0,157,0,0,0.0
2024-02-28,191,85,106,0,85,0,0,0.0
2024-02-29,266,158,108,0,158,0,0,0.0
2024-03-01,248,152,96,0,152,0,0,0.0
2024-03-03,15,0,15,0,0,0,0,0.0
2024-03-04,204,102,102,0,102,0,0,0.0
2024-03-05,196,114,82,0,114,0,0,0.0
2024-03-06,263,154,109,0,154,0,0,0.0
2024-03-07,262,148,114,0,148,0,0,0.0
2024-03-08,242,154,88,0,154,0,0,0.0
2024-03-10,28,12,16,0,12,0,0,0.0
2024-03-11,217,145,72,0,145,0,0,0.0
2024-03-12,144,43,101,0,43,0,0,0.0
2024-03-13,258,160,98,0,160,0,0,0.0
2024-03-14,258,146,112,0,146,0,0,0.0
2024-03-15,206,113,93,0,113,0,0,0.0
2024-03-17,13,12,1,0,12,0,0,0.0
2024-03-18,212,114,98,0,114,0,0,0.0
2024-03-19,257,144,113,0,144,0,0,0.0
2024-03-20,271,151,120,0,151,0,0,0.0
2024-03-21,265,152,113,0,152,0,0,0.0
2024-03-22,228,132,96,0,132,0,0,0.0
2024-03-24,26,11,15,0,11,0,0,0.0
2024-03-25,241,137,104,0,137,0,0,0.0
2024-03-26,222,124,98,0,124,0,0,0.0
2024-03-27,233,131,102,0,131,0,0,0.0
2024-03-28,179,112,67,0,112,0,0,0.0
2024-03-29,202,109,93,0,109,0,0,0.0
2024-03-31,29,12,17,0,12,0,0,0.0
2024-04-01,250,154,96,0,154,0,0,0.0
2024-04-02,225,126,99,0,126,0,0,0.0
2024-04-03,235,153,82,0,153,0,0,0.0
2024-04-04,206,111,95,0,111,0,0,0.0
2024-04-05,179,102,77,0,102,0,0,0.0
2024-04-07,12,12,0,0,12,0,0,0.0
2024-04-08,210,110,100,0,110,0,0,0.0
2024-04-09,246,149,97,0,149,0,0,0.0
2024-04-10,217,147,70,0,147,0,0,0.0
2024-04-11,221,139,82,0,139,0,0,0.0
2024-04-12,211,141,70,0,141,0,0,0.0
2024-04-14,32,12,20,0,12,0,0,0.0
2024-04-15,134,36,98,0,36,0,0,0.0
2024-04-16,215,117,98,0,117,0,0,0.0
2024-04-17,225,129,96,0,129,0,0,0.0
2024-04-18,273,159,114,0,159,0,0,0.0
2024-04-19,167,76,91,0,76,0,0,0.0
2024-04-21,7,7,0,0,7,0,0,0.0
2024-04-22,213,153,60,0,153,0,0,0.0
2024-04-23,212,116,96,0,116,0,0,0.0
2024-04-24,242,145,97,0,145,0,0,0.0
2024-04-25,148,47,101,0,47,0,0,0.0
2024-04-26,205,121,84,0,121,0,0,0.0
2024-04-28,13,12,1,0,12,0,0,0.0
2024-04-29,227,138,89,0,138,0,0,0.0
2024-04-30,207,111,96,0,111,0,0,0.0
2024-05-01,229,108,121,0,108,0,0,0.0
2024-05-02,265,157,108,0,157,0,0,0.0
2024-05-03,241,145,96,0,145,0,0,0.0
2024-05-05,32,12,20,0,12,0,0,0.0
2024-05-06,269,155,114,0,155,0,0,0.0
2024-05-07,262,149,113,0,149,0,0,0.0
2024-05-08,229,114,115,0,114,0,0,0.0
2024-05-09,238,141,97,0,141,0,0,0.0
2024-05-10,173,78,95,0,78,0,0,0.0
2024-05-12,21,1,20,0,1,0,0,0.0
2024-05-13,227,115,112,0,115,0,0,0.0
2024-05-14,138,32,106,0,32,0,0,0.0
2024-05-15,259,160,99,0,160,0,0,0.0
2024-05-16,220,109,111,0,109,0,0,0.0
2024-05-17,205,109,96,0,109,0,0,0.0
2024-05-19,33,12,21,0,12,0,0,0.0
2024-05-20,227,115,112,0,115,0,0,0.0
2024-05-21,189,75,114,0,75,0,0,0.0
2024-05-22,264,158,106,0,158,0,0,0.0
2024-05-23,230,152,78,0,152,0,0,0.0
2024-05-24,241,146,95,0,146,0,0,0.0
2024-05-26,14,12,2,0,12,0,0,0.0
2024-05-27,230,144,86,0,144,0,0,0.0
2024-05-28,268,158,110,0,158,0,0,0.0
2024-05-29,246,150,96,0,150,0,0,0.0
2024-05-30,226,120,106,0,120,0,0,0.0
2024-05-31,202,125,77,0,125,0,0,0.0
2024-06-02,18,12,6,0,12,0,0,0.0
2024-06-03,226,154,72,0,154,0,0,0.0
2024-06-04,262,156,106,0,156,0,0,0.0
2024-06-05,198,86,112,0,86,0,0,0.0
2024-06-06,266,159,107,0,159,0,0,0.0
2024-06-07,199,103,96,0,103,0,0,0.0
2024-06-09,16,2,14,0,2,0,0,0.0
2024-06-10,202,96,106,0,96,0,0,0.0
2024-06-11,262,148,114,0,148,0,0,0.0
2024-06-12,269,149,120,0,149,0,0,0.0
2024-06-13,241,129,112,0,129,0,0,0.0
2024-06-14,167,71,96,0,71,0,0,0.0
2024-06-16,24,5,19,0,5,0,0,0.0
2024-06-17,180,129,51,0,129,0,0,0.0
2024-06-18,181,93,88,0,93,0,0,0.0
2024-06-19,215,143,72,0,143,0,0,0.0
2024-06-20,239,133,106,0,133,0,0,0.0
2024-06-21,222,140,82,0,140,0,0,0.0
2024-06-23,29,12,17,0,12,0,0,0.0
2024-06-24,219,154,65,0,154,0,0,0.0
2024-06-25,240,131,109,0,131,0,0,0.0
2024-06-26,266,159,107,0,159,0,0,0.0
2024-06-27,260,155,105,0,155,0,0,0.0
2024-06-28,236,141,95,0,141,0,0,0.0
2024-06-30,19,12,7,0,12,0,0,0.0
2024-07-01,220,139,81,0,139,0,0,0.0
2024-07-02,246,134,112,0,134,0,0,0.0
2024-07-03,229,123,106,0,123,0,0,0.0
2024-07-04,229,126,103,0,126,0,0,0.0
2024-07-05,197,101,96,0,101,0,0,0.0
2024-07-07,17,10,7,0,10,0,0,0.0
2024-07-08,259,154,105,0,154,0,0,0.0
2024-07-09,276,161,115,0,161,0,0,0.0
2024-07-10,246,144,102,0,144,0,0,0.0
2024-07-11,149,47,102,1,46,1,0,-32.2314285714275
2024-07-12,77,37,40,0,37,0,0,0.0
2024-07-14,16,0,16,0,0,0,0,0.0
2024-07-15,204,147,57,0,147,0,0,0.0
2024-07-16,257,157,100,0,157,0,0,0.0
2024-07-17,233,128,105,0,128,0,0,0.0
2024-07-18,251,161,90,0,161,0,0,0.0
2024-07-19,229,134,95,0,134,0,0,0.0
2024-07-21,30,12,18,0,12,0,0,0.0
2024-07-22,233,149,84,0,149,0,0,0.0
2024-07-23,229,118,111,0,118,0,0,0.0
2024-07-24,224,122,102,0,122,0,0,0.0
2024-07-25,175,61,114,0,61,0,0,0.0
2024-07-26,166,70,96,0,70,0,0,0.0
2024-07-28,20,4,16,0,4,0,0,0.0
2024-07-29,214,105,109,0,105,0,0,0.0
2024-07-30,216,109,107,0,109,0,0,0.0
2024-07-31,213,106,107,0,106,0,0,0.0
2024-08-01,247,145,102,0,145,0,0,0.0
2024-08-02,202,126,76,0,126,0,0,0.0
2024-08-04,21,12,9,0,12,0,0,0.0
2024-08-05,268,155,113,0,155,0,0,0.0
2024-08-06,204,105,99,0,105,0,0,0.0
2024-08-07,254,148,106,0,148,0,0,0.0
2024-08-08,158,70,88,0,70,0,0,0.0
2024-08-09,160,71,89,0,71,0,0,0.0
2024-08-11,28,8,20,0,8,0,0,0.0
2024-08-12,217,135,82,0,135,0,0,0.0
2024-08-13,220,104,116,0,104,0,0,0.0
2024-08-14,218,106,112,0,106,0,0,0.0
2024-08-15,162,71,91,0,71,0,0,0.0
2024-08-16,204,115,89,0,115,0,0,0.0
2024-08-18,33,12,21,0,12,0,0,0.0
2024-08-19,187,81,106,0,81,0,0,0.0
2024-08-20,236,124,112,0,124,0,0,0.0
2024-08-21,241,136,105,0,136,0,0,0.0
2024-08-22,255,149,106,0,149,0,0,0.0
2024-08-23,244,149,95,0,149,0,0,0.0
2024-08-25,30,12,18,0,12,0,0,0.0
2024-08-26,258,150,108,0,150,0,0,0.0
2024-08-27,254,150,104,0,150,0,0,0.0
2024-08-28,247,140,107,0,140,0,0,0.0
2024-08-29,222,127,95,0,127,0,0,0.0
2024-08-30,218,141,77,0,141,0,0,0.0
2024-09-01,31,11,20,0,11,0,0,0.0
2024-09-02,211,141,70,0,141,0,0,0.0
2024-09-03,173,57,116,0,57,0,0,0.0
2024-09-04,235,141,94,0,141,0,0,0.0
2024-09-05,248,147,101,0,147,0,0,0.0
2024-09-06,234,138,96,0,138,0,0,0.0
2024-09-08,22,12,10,0,12,0,0,0.0
2024-09-09,242,132,110,0,132,0,0,0.0
2024-09-10,261,158,103,0,158,0,0,0.0
2024-09-11,200,85,115,0,85,0,0,0.0
2024-09-12,231,123,108,0,123,0,0,0.0
2024-09-13,176,80,96,0,80,0,0,0.0
2024-09-15,25,10,15,0,10,0,0,0.0
2024-09-16,257,145,112,0,145,0,0,0.0
2024-09-17,255,148,107,0,148,0,0,0.0
2024-09-18,239,124,115,0,124,0,0,0.0
2024-09-19,257,140,117,0,140,0,0,0.0
2024-09-20,240,144,96,0,144,0,0,0.0
2024-09-22,21,11,10,0,11,0,0,0.0
2024-09-23,251,147,104,0,147,0,0,0.0
2024-09-24,253,150,103,0,150,0,0,0.0
2024-09-25,249,146,103,0,146,0,0,0.0
2024-09-26,262,146,116,0,146,0,0,0.0
2024-09-27,194,98,96,0,98,0,0,0.0
2024-09-29,28,9,19,0,9,0,0,0.0
2024-09-30,230,152,78,0,152,0,0,0.0
2024-10-01,267,156,111,0,156,0,0,0.0
2024-10-02,274,159,115,0,159,0,0,0.0
2024-10-03,245,132,113,0,132,0,0,0.0
2024-10-04,213,117,96,0,117,0,0,0.0
2024-10-06,1,1,0,0,1,0,0,0.0
2024-10-07,169,54,115,0,54,0,0,0.0
2024-10-08,263,157,106,0,157,0,0,0.0
2024-10-09,236,148,88,0,148,0,0,0.0
2024-10-10,162,82,80,0,82,0,0,0.0
2024-10-11,180,88,92,0,88,0,0,0.0
2024-10-13,26,9,17,0,9,0,0,0.0
2024-10-14,172,108,64,0,108,0,0,0.0
2024-10-15,223,113,110,0,113,0,0,0.0
2024-10-16,252,144,108,0,144,0,0,0.0
2024-10-17,266,158,108,0,158,0,0,0.0
2024-10-18,244,148,96,0,148,0,0,0.0
2024-10-20,27,12,15,0,12,0,0,0.0
2024-10-21,264,156,108,0,156,0,0,0.0
2024-10-22,220,117,103,0,117,0,0,0.0
2024-10-23,239,136,103,0,136,0,0,0.0
2024-10-24,267,158,109,0,158,0,0,0.0
2024-10-25,187,97,90,0,97,0,0,0.0
2024-10-27,27,12,15,0,12,0,0,0.0
2024-10-28,258,153,105,0,153,0,0,0.0
2024-10-29,276,160,116,0,160,0,0,0.0
2024-10-30,235,125,110,0,125,0,0,0.0
2024-10-31,270,155,115,0,155,0,0,0.0
2024-11-01,227,131,96,0,131,0,0,0.0
2024-11-03,6,0,6,0,0,0,0,0.0
2024-11-04,264,154,110,0,154,0,0,0.0
2024-11-05,266,154,112,0,154,0,0,0.0
2024-11-06,217,109,108,0,109,0,0,0.0
2024-11-07,234,128,106,0,128,0,0,0.0
2024-11-08,231,143,88,0,143,0,0,0.0
2024-11-10,20,0,20,0,0,0,0,0.0
2024-11-11,169,55,114,0,55,0,0,0.0
2024-11-12,270,160,110,0,160,0,0,0.0
2024-11-13,257,155,102,0,155,0,0,0.0
2024-11-14,241,126,115,0,126,0,0,0.0
2024-11-15,246,150,96,0,150,0,0,0.0
2024-11-17,16,0,16,0,0,0,0,0.0
2024-11-18,248,146,102,0,146,0,0,0.0
2024-11-19,267,159,108,0,159,0,0,0.0
2024-11-20,261,153,108,0,153,0,0,0.0
2024-11-21,242,134,108,0,134,0,0,0.0
2024-11-22,238,160,78,0,160,0,0,0.0
2024-11-24,4,0,4,0,0,0,0,0.0
2024-11-25,195,111,84,0,111,0,0,0.0
2024-11-26,219,114,105,0,114,0,0,0.0
2024-11-27,251,136,115,0,136,0,0,0.0
2024-11-28,249,137,112,0,137,0,0,0.0
2024-11-29,219,123,96,0,123,0,0,0.0
2024-12-01,19,0,19,0,0,0,0,0.0
2024-12-02,258,147,111,0,147,0,0,0.0
2024-12-03,257,143,114,0,143,0,0,0.0
2024-12-04,266,153,113,0,153,0,0,0.0
2024-12-05,274,159,115,0,159,0,0,0.0
2024-12-06,248,160,88,0,160,0,0,0.0
2024-12-08,0,0,0,0,0,0,0,0.0
2024-12-09,197,138,59,0,138,0,0,0.0
2024-12-10,242,129,113,0,129,0,0,0.0
2024-12-11,247,143,104,0,143,0,0,0.0
2024-12-12,209,125,84,0,125,0,0,0.0
2024-12-13,256,160,96,0,160,0,0,0.0
2024-12-15,15,0,15,0,0,0,0,0.0
2024-12-16,240,147,93,0,147,0,0,0.0
2024-12-17,254,156,98,0,156,0,0,0.0
2024-12-18,222,137,85,0,137,0,0,0.0
2024-12-19,272,159,113,0,159,0,0,0.0
2024-12-20,238,143,95,0,143,0,0,0.0
2024-12-22,14,0,14,0,0,0,0,0.0
2024-12-23,200,96,104,0,96,0,0,0.0
2024-12-24,219,130,89,0,130,0,0,0.0
2024-12-25,119,0,119,0,0,0,0,0.0
2024-12-26,268,159,109,0,159,0,0,0.0
2024-12-27,227,131,96,0,131,0,0,0.0
2024-12-29,15,0,15,0,0,0,0,0.0
2024-12-30,270,157,113,0,157,0,0,0.0
2024-12-31,246,150,96,0,150,0,0,0.0
