date,breakouts,gate_pass,gate_block,ev_pass,ev_reject,fills,wins,pnl_pips
2018-01-01,9,0,9,0,0,0,0,0.0
2018-01-02,150,52,98,47,0,52,50,44.15999999999991
2018-01-03,41,2,39,2,0,2,0,-3.1199999999993224
2018-01-04,115,2,113,2,0,2,1,-4.598902666266213
2018-01-05,98,2,96,2,0,2,0,-3.0799999999994156
2018-01-07,12,0,12,0,0,0,0,0.0
2018-01-08,90,2,88,2,0,2,0,-3.540000000000475
2018-01-09,118,10,108,2,8,2,0,-4.694285714284717
2018-01-10,112,13,99,2,11,2,1,0.8499999999988859
2018-01-11,104,2,102,2,0,2,1,0.8514285714275047
2018-01-12,59,2,57,2,0,2,1,-1.208571428571247
2018-01-14,16,0,16,0,0,0,0,0.0
2018-01-15,111,5,106,2,3,2,1,-2.487142857142487
2018-01-16,111,2,109,2,0,2,0,-7.457142857142628
2018-01-17,103,2,101,2,0,2,0,-5.122857142857583
2018-01-18,108,24,84,2,22,2,1,2.63142857142833
2018-01-19,93,5,88,2,3,2,0,-7.494285714285297
2018-01-21,12,0,12,0,0,0,0,0.0
2018-01-22,143,33,110,2,31,2,1,1.2557142857138501
2018-01-23,129,34,95,2,32,2,1,1.8614285714283483
2018-01-24,120,15,105,2,13,2,2,4.850963697533018
2018-01-25,109,6,103,2,4,2,1,1.3957142857142344
2018-01-26,79,2,77,2,0,2,0,-7.002857142857465
2018-01-28,10,0,10,0,0,0,0,0.0
2018-01-29,96,2,94,2,0,2,0,-4.951428571429005
2018-01-30,147,49,98,2,47,2,2,7.978571428571058
2018-01-31,98,3,95,2,1,2,0,-8.15428571428589
2018-02-01,136,27,109,2,25,2,1,1.7485714285717222
2018-02-02,97,3,94,2,1,2,1,1.5914285714293328
2018-02-04,12,0,12,0,0,0,0,0.0
2018-02-05,113,2,111,2,0,2,0,-7.145714285713666
2018-02-06,114,4,110,2,2,2,0,-11.365714285714489
2018-02-07,118,15,103,2,13,2,0,-9.162857142858115
2018-02-08,173,103,70,1,102,1,0,-2.834285714285045
2018-02-09,184,90,94,1,89,1,0,-2.5514285714284597
2018-02-11,14,0,14,0,0,0,0,0.0
2018-02-12,184,71,113,1,70,1,1,-0.11957792599918093
2018-02-13,187,81,106,1,80,1,0,-4.379999999999484
2018-02-14,113,7,106,2,5,2,1,-6.771823900813899
2018-02-15,206,95,111,1,94,1,0,-3.5885714285716404
2018-02-16,175,82,93,1,81,1,0,-3.505714285714589
2018-02-18,17,0,17,0,0,0,0,0.0
2018-02-19,133,33,100,1,32,1,0,-3.6371428571432602
2018-02-20,242,133,109,0,133,0,0,0.0
2018-02-21,208,100,108,1,99,1,0,-4.254285714285288
2018-02-22,211,97,114,1,96,1,1,3.178571428571331
2018-02-23,191,95,96,1,94,1,0,-3.897142857143365
2018-02-25,5,0,5,0,0,0,0,0.0
2018-02-26,207,101,106,1,100,1,0,-2.245714285713973
2018-02-27,184,111,73,0,111,0,0,0.0
2018-02-28,191,86,105,1,85,1,0,-2.6028571428573173
2018-03-01,210,103,107,1,102,1,0,-3.4057142857141116
2018-03-02,179,88,91,1,87,1,0,-4.425714285713866
2018-03-04,6,0,6,0,0,0,0,0.0
2018-03-05,132,102,30,1,101,1,1,-0.06062598537300801
2018-03-06,235,124,111,0,124,0,0,0.0
2018-03-07,189,78,111,0,78,0,0,0.0
2018-03-08,194,88,106,0,88,0,0,0.0
2018-03-09,206,110,96,0,110,0,0,0.0
2018-03-11,26,12,14,0,12,0,0,0.0
2018-03-12,195,85,110,0,85,0,0,0.0
2018-03-13,217,109,108,1,108,1,1,2.771428571429169
2018-03-14,242,149,93,0,149,0,0,0.0
2018-03-15,207,102,105,1,101,1,1,2.3285714285715358
2018-03-16,190,94,96,1,93,1,1,2.56428571428512
2018-03-18,20,12,8,0,12,0,0,0.0
2018-03-19,205,95,110,1,94,1,0,-2.385714285714357
2018-03-20,152,46,106,1,45,1,0,-4.379999999999484
2018-03-21,248,137,111,0,137,0,0,0.0
2018-03-22,197,83,114,1,82,1,0,-2.642857142857224
2018-03-23,167,71,96,1,70,1,0,-2.98571428571438
2018-03-25,20,12,8,0,12,0,0,0.0
2018-03-26,207,106,101,0,106,0,0,0.0
2018-03-27,247,143,104,0,143,0,0,0.0
2018-03-28,199,95,104,1,94,1,0,-3.2657142857137273
2018-03-29,246,141,105,0,141,0,0,0.0
2018-03-30,164,69,95,0,69,0,0,0.0
2018-04-01,8,6,2,0,6,0,0,0.0
2018-04-02,163,136,27,0,136,0,0,0.0
2018-04-03,198,94,104,0,94,0,0,0.0
2018-04-04,196,118,78,0,118,0,0,0.0
2018-04-05,261,151,110,0,151,0,0,0.0
2018-04-06,176,81,95,0,81,0,0,0.0
2018-04-08,19,12,7,0,12,0,0,0.0
2018-04-09,182,121,61,0,121,0,0,0.0
2018-04-10,204,97,107,1,96,1,0,-3.0457142857149506
2018-04-11,190,77,113,0,77,0,0,0.0
2018-04-12,192,78,114,0,78,0,0,0.0
2018-04-13,240,144,96,0,144,0,0,0.0
2018-04-15,12,12,0,0,12,0,0,0.0
2018-04-16,231,127,104,0,127,0,0,0.0
2018-04-17,251,144,107,0,144,0,0,0.0
2018-04-18,227,116,111,0,116,0,0,0.0
2018-04-19,228,123,105,0,123,0,0,0.0
2018-04-20,228,133,95,0,133,0,0,0.0
2018-04-22,22,12,10,0,12,0,0,0.0
2018-04-23,257,155,102,0,155,0,0,0.0
2018-04-24,223,124,99,0,124,0,0,0.0
2018-04-25,242,149,93,0,149,0,0,0.0
2018-04-26,248,143,105,0,143,0,0,0.0
2018-04-27,195,101,94,0,101,0,0,0.0
2018-04-29,28,12,16,0,12,0,0,0.0
2018-04-30,182,104,78,0,104,0,0,0.0
2018-05-01,258,145,113,0,145,0,0,0.0
2018-05-02,240,129,111,0,129,0,0,0.0
2018-05-03,263,150,113,0,150,0,0,0.0
2018-05-04,212,118,94,0,118,0,0,0.0
2018-05-06,25,12,13,0,12,0,0,0.0
2018-05-07,256,149,107,0,149,0,0,0.0
2018-05-08,212,111,101,0,111,0,0,0.0
2018-05-09,163,57,106,0,57,0,0,0.0
2018-05-10,204,93,111,0,93,0,0,0.0
2018-05-11,224,129,95,0,129,0,0,0.0
2018-05-13,13,12,1,0,12,0,0,0.0
2018-05-14,184,111,73,0,111,0,0,0.0
2018-05-15,246,131,115,0,131,0,0,0.0
2018-05-16,249,144,105,0,144,0,0,0.0
2018-05-17,182,89,93,0,89,0,0,0.0
2018-05-18,215,129,86,0,129,0,0,0.0
2018-05-20,15,12,3,0,12,0,0,0.0
2018-05-21,252,137,115,0,137,0,0,0.0
2018-05-22,184,85,99,0,85,0,0,0.0
2018-05-23,204,105,99,0,105,0,0,0.0
2018-05-24,231,120,111,0,120,0,0,0.0
2018-05-25,182,86,96,0,86,0,0,0.0
2018-05-27,19,12,7,0,12,0,0,0.0
2018-05-28,247,142,105,0,142,0,0,0.0
2018-05-29,246,135,111,0,135,0,0,0.0
2018-05-30,194,86,108,0,86,0,0,0.0
2018-05-31,198,90,108,0,90,0,0,0.0
2018-06-01,230,137,93,0,137,0,0,0.0
2018-06-03,15,12,3,0,12,0,0,0.0
2018-06-04,236,121,115,0,121,0,0,0.0
2018-06-05,212,118,94,0,118,0,0,0.0
2018-06-06,229,135,94,0,135,0,0,0.0
2018-06-07,252,150,102,0,150,0,0,0.0
2018-06-08,209,123,86,0,123,0,0,0.0
2018-06-10,13,12,1,0,12,0,0,0.0
2018-06-11,230,137,93,0,137,0,0,0.0
2018-06-12,219,118,101,0,118,0,0,0.0
2018-06-13,235,150,85,0,150,0,0,0.0
2018-06-14,181,114,67,0,114,0,0,0.0
2018-06-15,203,108,95,0,108,0,0,0.0
2018-06-17,23,12,11,0,12,0,0,0.0
2018-06-18,206,99,107,0,99,0,0,0.0
2018-06-19,253,145,108,0,145,0,0,0.0
2018-06-20,253,140,113,0,140,0,0,0.0
2018-06-21,255,151,104,0,151,0,0,0.0
2018-06-22,199,104,95,0,104,0,0,0.0
2018-06-24,20,12,8,0,12,0,0,0.0
2018-06-25,244,129,115,0,129,0,0,0.0
2018-06-26,230,124,106,0,124,0,0,0.0
2018-06-27,223,121,102,0,121,0,0,0.0
2018-06-28,259,156,103,0,156,0,0,0.0
2018-06-29,207,112,95,0,112,0,0,0.0
2018-07-01,17,8,9,0,8,0,0,0.0
2018-07-02,177,86,91,0,86,0,0,0.0
2018-07-03,249,136,113,0,136,0,0,0.0
2018-07-04,185,85,100,0,85,0,0,0.0
2018-07-05,219,123,96,0,123,0,0,0.0
2018-07-06,170,102,68,0,102,0,0,0.0
2018-07-08,17,12,5,0,12,0,0,0.0
2018-07-09,196,138,58,0,138,0,0,0.0
2018-07-10,244,148,96,0,148,0,0,0.0
2018-07-11,232,156,76,0,156,0,0,0.0
2018-07-12,204,90,114,0,90,0,0,0.0
2018-07-13,230,134,96,0,134,0,0,0.0
2018-07-15,25,12,13,0,12,0,0,0.0
2018-07-16,235,139,96,0,139,0,0,0.0
2018-07-17,258,149,109,0,149,0,0,0.0
2018-07-18,205,122,83,0,122,0,0,0.0
2018-07-19,231,128,103,0,128,0,0,0.0
2018-07-20,210,117,93,0,117,0,0,0.0
2018-07-22,30,12,18,0,12,0,0,0.0
2018-07-23,259,145,114,0,145,0,0,0.0
2018-07-24,229,139,90,0,139,0,0,0.0
2018-07-25,208,117,91,0,117,0,0,0.0
2018-07-26,253,150,103,0,150,0,0,0.0
2018-07-27,178,82,96,0,82,0,0,0.0
2018-07-29,12,8,4,0,8,0,0,0.0
2018-07-30,210,105,105,0,105,0,0,0.0
2018-07-31,184,74,110,0,74,0,0,0.0
2018-08-01,244,142,102,0,142,0,0,0.0
2018-08-02,253,150,103,0,150,0,0,0.0
2018-08-03,209,122,87,0,122,0,0,0.0
2018-08-05,13,12,1,0,12,0,0,0.0
2018-08-06,227,126,101,0,126,0,0,0.0
2018-08-07,271,157,114,0,157,0,0,0.0
2018-08-08,211,106,105,0,106,0,0,0.0
2018-08-09,258,144,114,0,144,0,0,0.0
2018-08-10,206,110,96,0,110,0,0,0.0
2018-08-12,12,12,0,0,12,0,0,0.0
2018-08-13,230,132,98,1,131,1,1,5.985714285713584
2018-08-14,194,97,97,1,96,1,0,-4.339999999999577
2018-08-15,249,139,110,0,139,0,0,0.0
2018-08-16,246,138,108,0,138,0,0,0.0
2018-08-17,203,107,96,0,107,0,0,0.0
2018-08-19,19,12,7,0,12,0,0,0.0
2018-08-20,203,105,98,0,105,0,0,0.0
2018-08-21,253,146,107,0,146,0,0,0.0
2018-08-22,249,155,94,0,155,0,0,0.0
2018-08-23,241,143,98,0,143,0,0,0.0
2018-08-24,180,125,55,0,125,0,0,0.0
2018-08-26,19,12,7,0,12,0,0,0.0
2018-08-27,242,135,107,0,135,0,0,0.0
2018-08-28,242,136,106,0,136,0,0,0.0
2018-08-29,252,151,101,0,151,0,0,0.0
2018-08-30,249,150,99,0,150,0,0,0.0
2018-08-31,177,115,62,0,115,0,0,0.0
2018-09-02,22,12,10,0,12,0,0,0.0
2018-09-03,221,115,106,0,115,0,0,0.0
2018-09-04,231,133,98,0,133,0,0,0.0
2018-09-05,133,58,75,0,58,0,0,0.0
2018-09-06,240,128,112,0,128,0,0,0.0
2018-09-07,214,119,95,0,119,0,0,0.0
2018-09-09,19,2,17,0,2,0,0,0.0
2018-09-10,208,111,97,0,111,0,0,0.0
2018-09-11,258,153,105,0,153,0,0,0.0
2018-09-12,207,107,100,0,107,0,0,0.0
2018-09-13,260,145,115,0,145,0,0,0.0
2018-09-14,166,74,92,0,74,0,0,0.0
2018-09-16,2,0,2,0,0,0,0,0.0
2018-09-17,177,139,38,0,139,0,0,0.0
2018-09-18,240,139,101,0,139,0,0,0.0
2018-09-19,134,43,91,0,43,0,0,0.0
2018-09-20,222,123,99,0,123,0,0,0.0
2018-09-21,207,114,93,0,114,0,0,0.0
2018-09-23,18,12,6,0,12,0,0,0.0
2018-09-24,223,127,96,0,127,0,0,0.0
2018-09-25,254,152,102,0,152,0,0,0.0
2018-09-26,255,146,109,0,146,0,0,0.0
2018-09-27,261,154,107,0,154,0,0,0.0
2018-09-28,213,118,95,0,118,0,0,0.0
2018-09-30,27,12,15,0,12,0,0,0.0
2018-10-01,248,134,114,0,134,0,0,0.0
2018-10-02,238,136,102,0,136,0,0,0.0
2018-10-03,256,150,106,0,150,0,0,0.0
2018-10-04,233,123,110,0,123,0,0,0.0
2018-10-05,202,136,66,0,136,0,0,0.0
2018-10-07,18,12,6,0,12,0,0,0.0
2018-10-08,229,121,108,0,121,0,0,0.0
2018-10-09,227,125,102,0,125,0,0,0.0
2018-10-10,256,156,100,0,156,0,0,0.0
2018-10-11,180,111,69,1,110,1,0,-4.888571428572163
2018-10-12,229,134,95,0,134,0,0,0.0
2018-10-14,19,12,7,0,12,0,0,0.0
2018-10-15,225,125,100,0,125,0,0,0.0
2018-10-16,221,109,112,0,109,0,0,0.0
2018-10-17,225,126,99,0,126,0,0,0.0
2018-10-18,252,149,103,0,149,0,0,0.0
2018-10-19,223,127,96,0,127,0,0,0.0
2018-10-21,28,12,16,0,12,0,0,0.0
2018-10-22,220,113,107,0,113,0,0,0.0
2018-10-23,241,137,104,0,137,0,0,0.0
2018-10-24,251,147,104,0,147,0,0,0.0
2018-10-25,225,146,79,0,146,0,0,0.0
2018-10-26,227,134,93,0,134,0,0,0.0
2018-10-28,21,12,9,0,12,0,0,0.0
2018-10-29,195,108,87,0,108,0,0,0.0
2018-10-30,234,121,113,0,121,0,0,0.0
2018-10-31,215,107,108,0,107,0,0,0.0
2018-11-01,248,144,104,0,144,0,0,0.0
2018-11-02,220,124,96,0,124,0,0,0.0
2018-11-04,15,0,15,0,0,0,0,0.0
2018-11-05,214,152,62,0,152,0,0,0.0
2018-11-06,250,146,104,0,146,0,0,0.0
2018-11-07,223,131,92,0,131,0,0,0.0
2018-11-08,239,136,103,0,136,0,0,0.0
2018-11-09,209,113,96,0,113,0,0,0.0
2018-11-11,8,0,8,0,0,0,0,0.0
2018-11-12,227,120,107,0,120,0,0,0.0
2018-11-13,234,131,103,0,131,0,0,0.0
2018-11-14,239,134,105,0,134,0,0,0.0
2018-11-15,226,140,86,0,140,0,0,0.0
2018-11-16,230,146,84,0,146,0,0,0.0
2018-11-18,14,0,14,0,0,0,0,0.0
2018-11-19,204,119,85,0,119,0,0,0.0
2018-11-20,208,132,76,0,132,0,0,0.0
2018-11-21,198,95,103,0,95,0,0,0.0
2018-11-22,144,117,27,0,117,0,0,0.0
2018-11-23,212,134,78,0,134,0,0,0.0
2018-11-25,11,0,11,0,0,0,0,0.0
2018-11-26,245,138,107,0,138,0,0,0.0
2018-11-27,234,133,101,0,133,0,0,0.0
2018-11-28,250,143,107,0,143,0,0,0.0
2018-11-29,246,150,96,0,150,0,0,0.0
2018-11-30,112,112,0,0,112,0,0,0.0
2018-12-02,14,0,14,0,0,0,0,0.0
2018-12-03,218,129,89,0,129,0,0,0.0
2018-12-04,255,149,106,0,149,0,0,0.0
2018-12-05,266,153,113,0,153,0,0,0.0
2018-12-06,266,154,112,0,154,0,0,0.0
2018-12-07,217,123,94,0,123,0,0,0.0
2018-12-09,14,0,14,0,0,0,0,0.0
2018-12-10,244,138,106,0,138,0,0,0.0
2018-12-11,249,139,110,0,139,0,0,0.0
2018-12-12,220,124,96,0,124,0,0,0.0
2018-12-13,209,113,96,0,113,0,0,0.0
2018-12-14,220,148,72,0,148,0,0,0.0
2018-12-16,18,0,18,0,0,0,0,0.0
2018-12-17,252,150,102,0,150,0,0,0.0
2018-12-18,263,152,111,0,152,0,0,0.0
2018-12-19,249,134,115,0,134,0,0,0.0
2018-12-20,246,152,94,0,152,0,0,0.0
2018-12-21,179,102,77,0,102,0,0,0.0
2018-12-23,5,0,5,0,0,0,0,0.0
2018-12-24,133,124,9,0,124,0,0,0.0
2018-12-25,117,0,117,0,0,0,0,0.0
2018-12-26,226,149,77,0,149,0,0,0.0
2018-12-27,231,119,112,0,119,0,0,0.0
2018-12-28,167,72,95,0,72,0,0,0.0
2018-12-30,13,0,13,0,0,0,0,0.0
2018-12-31,224,132,92,0,132,0,0,0.0
2019-01-01,16,0,16,0,0,0,0,0.0
2019-01-02,226,116,110,0,116,0,0,0.0
2019-01-03,158,47,111,1,46,1,0,-5.6457142857145755
2019-01-04,246,150,96,0,150,0,0,0.0
2019-01-06,11,0,11,0,0,0,0,0.0
2019-01-07,235,147,88,0,147,0,0,0.0
2019-01-08,232,124,108,0,124,0,0,0.0
2019-01-09,223,120,103,0,120,0,0,0.0
2019-01-10,258,153,105,0,153,0,0,0.0
2019-01-11,211,126,85,0,126,0,0,0.0
2019-01-13,13,0,13,0,0,0,0,0.0
2019-01-14,241,129,112,0,129,0,0,0.0
2019-01-15,236,139,97,0,139,0,0,0.0
2019-01-16,218,116,102,0,116,0,0,0.0
2019-01-17,223,118,105,0,118,0,0,0.0
2019-01-18,236,141,95,0,141,0,0,0.0
2019-01-20,8,0,8,0,0,0,0,0.0
2019-01-21,182,80,102,0,80,0,0,0.0
2019-01-22,228,140,88,0,140,0,0,0.0
2019-01-23,237,138,99,0,138,0,0,0.0
2019-01-24,231,144,87,0,144,0,0,0.0
2019-01-25,241,146,95,0,146,0,0,0.0
2019-01-27,17,0,17,0,0,0,0,0.0
2019-01-28,240,137,103,0,137,0,0,0.0
2019-01-29,246,157,89,0,157,0,0,0.0
2019-01-30,180,132,48,0,132,0,0,0.0
2019-01-31,251,151,100,0,151,0,0,0.0
2019-02-01,238,151,87,0,151,0,0,0.0
2019-02-03,18,0,18,0,0,0,0,0.0
2019-02-04,200,95,105,0,95,0,0,0.0
2019-02-05,195,114,81,0,114,0,0,0.0
2019-02-06,244,140,104,0,140,0,0,0.0
2019-02-07,220,132,88,0,132,0,0,0.0
2019-02-08,174,120,54,0,120,0,0,0.0
2019-02-10,8,0,8,0,0,0,0,0.0
2019-02-11,239,154,85,0,154,0,0,0.0
2019-02-12,233,133,100,0,133,0,0,0.0
2019-02-13,245,135,110,0,135,0,0,0.0
2019-02-14,249,150,99,0,150,0,0,0.0
2019-02-15,215,131,84,0,131,0,0,0.0
2019-02-17,13,0,13,0,0,0,0,0.0
2019-02-18,236,135,101,0,135,0,0,0.0
2019-02-19,248,153,95,0,153,0,0,0.0
2019-02-20,258,151,107,0,151,0,0,0.0
2019-02-21,193,98,95,0,98,0,0,0.0
2019-02-22,246,156,90,0,156,0,0,0.0
2019-02-24,17,0,17,0,0,0,0,0.0
2019-02-25,206,137,69,0,137,0,0,0.0
2019-02-26,253,156,97,0,156,0,0,0.0
2019-02-27,231,150,81,0,150,0,0,0.0
2019-02-28,245,132,113,0,132,0,0,0.0
2019-03-01,213,117,96,0,117,0,0,0.0
2019-03-03,19,0,19,0,0,0,0,0.0
2019-03-04,227,131,96,0,131,0,0,0.0
2019-03-05,241,135,106,0,135,0,0,0.0
2019-03-06,228,129,99,0,129,0,0,0.0
2019-03-07,247,158,89,0,158,0,0,0.0
2019-03-08,220,125,95,0,125,0,0,0.0
2019-03-10,20,7,13,0,7,0,0,0.0
2019-03-11,205,143,62,0,143,0,0,0.0
2019-03-12,227,135,92,0,135,0,0,0.0
2019-03-13,241,130,111,0,130,0,0,0.0
2019-03-14,214,100,114,0,100,0,0,0.0
2019-03-15,183,94,89,0,94,0,0,0.0
2019-03-17,23,12,11,0,12,0,0,0.0
2019-03-18,251,138,113,0,138,0,0,0.0
2019-03-19,237,122,115,0,122,0,0,0.0
2019-03-20,245,134,111,0,134,0,0,0.0
2019-03-21,254,154,100,0,154,0,0,0.0
2019-03-22,236,144,92,0,144,0,0,0.0
2019-03-24,25,12,13,0,12,0,0,0.0
2019-03-25,214,130,84,0,130,0,0,0.0
2019-03-26,213,123,90,0,123,0,0,0.0
2019-03-27,119,104,15,0,104,0,0,0.0
2019-03-28,176,71,105,0,71,0,0,0.0
2019-03-29,132,37,95,0,37,0,0,0.0
2019-03-31,18,12,6,0,12,0,0,0.0
2019-04-01,248,141,107,0,141,0,0,0.0
2019-04-02,188,116,72,0,116,0,0,0.0
2019-04-03,196,87,109,0,87,0,0,0.0
2019-04-04,237,128,109,0,128,0,0,0.0
2019-04-05,150,54,96,0,54,0,0,0.0
2019-04-07,14,2,12,0,2,0,0,0.0
2019-04-08,247,132,115,0,132,0,0,0.0
2019-04-09,251,141,110,0,141,0,0,0.0
2019-04-10,238,144,94,0,144,0,0,0.0
2019-04-11,237,128,109,0,128,0,0,0.0
2019-04-12,216,120,96,0,120,0,0,0.0
2019-04-14,31,12,19,0,12,0,0,0.0
2019-04-15,162,64,98,0,64,0,0,0.0
2019-04-16,148,64,84,0,64,0,0,0.0
2019-04-17,225,119,106,0,119,0,0,0.0
2019-04-18,196,99,97,0,99,0,0,0.0
2019-04-19,136,49,87,0,49,0,0,0.0
2019-04-21,27,12,15,0,12,0,0,0.0
2019-04-22,134,50,84,0,50,0,0,0.0
2019-04-23,242,133,109,0,133,0,0,0.0
2019-04-24,255,153,102,0,153,0,0,0.0
2019-04-25,249,141,108,0,141,0,0,0.0
2019-04-26,233,137,96,0,137,0,0,0.0
2019-04-28,23,12,11,0,12,0,0,0.0
2019-04-29,220,118,102,0,118,0,0,0.0
2019-04-30,211,106,105,0,106,0,0,0.0
2019-05-01,243,142,101,0,142,0,0,0.0
2019-05-02,230,124,106,0,124,0,0,0.0
2019-05-03,214,123,91,0,123,0,0,0.0
2019-05-05,27,12,15,0,12,0,0,0.0
2019-05-06,202,112,90,0,112,0,0,0.0
2019-05-07,223,148,75,0,148,0,0,0.0
2019-05-08,205,106,99,0,106,0,0,0.0
2019-05-09,248,140,108,0,140,0,0,0.0
2019-05-10,215,120,95,0,120,0,0,0.0
2019-05-12,17,12,5,0,12,0,0,0.0
2019-05-13,178,125,53,0,125,0,0,0.0
2019-05-14,256,145,111,0,145,0,0,0.0
2019-05-15,260,153,107,0,153,0,0,0.0
2019-05-16,263,157,106,0,157,0,0,0.0
2019-05-17,229,133,96,0,133,0,0,0.0
2019-05-19,22,12,10,0,12,0,0,0.0
2019-05-20,268,157,111,0,157,0,0,0.0
2019-05-21,233,123,110,0,123,0,0,0.0
2019-05-22,230,137,93,0,137,0,0,0.0
2019-05-23,258,156,102,0,156,0,0,0.0
2019-05-24,224,129,95,0,129,0,0,0.0
2019-05-26,31,12,19,0,12,0,0,0.0
2019-05-27,255,140,115,0,140,0,0,0.0
2019-05-28,207,117,90,0,117,0,0,0.0
2019-05-29,227,130,97,0,130,0,0,0.0
2019-05-30,228,120,108,0,120,0,0,0.0
2019-05-31,215,119,96,0,119,0,0,0.0
2019-06-02,18,12,6,0,12,0,0,0.0
2019-06-03,219,142,77,0,142,0,0,0.0
2019-06-04,212,127,85,0,127,0,0,0.0
2019-06-05,227,138,89,0,138,0,0,0.0
2019-06-06,199,115,84,0,115,0,0,0.0
2019-06-07,214,118,96,0,118,0,0,0.0
2019-06-09,15,12,3,0,12,0,0,0.0
2019-06-10,204,133,71,0,133,0,0,0.0
2019-06-11,253,154,99,0,154,0,0,0.0
2019-06-12,143,40,103,0,40,0,0,0.0
2019-06-13,259,152,107,0,152,0,0,0.0
2019-06-14,218,122,96,0,122,0,0,0.0
2019-06-16,11,5,6,0,5,0,0,0.0
2019-06-17,229,123,106,0,123,0,0,0.0
2019-06-18,219,110,109,0,110,0,0,0.0
2019-06-19,235,132,103,0,132,0,0,0.0
2019-06-20,248,146,102,0,146,0,0,0.0
2019-06-21,205,127,78,0,127,0,0,0.0
2019-06-23,30,12,18,0,12,0,0,0.0
2019-06-24,242,146,96,0,146,0,0,0.0
2019-06-25,242,149,93,0,149,0,0,0.0
2019-06-26,231,128,103,0,128,0,0,0.0
2019-06-27,263,154,109,0,154,0,0,0.0
2019-06-28,219,123,96,0,123,0,0,0.0
2019-06-30,29,12,17,0,12,0,0,0.0
2019-07-01,157,117,40,0,117,0,0,0.0
2019-07-02,163,133,30,0,133,0,0,0.0
2019-07-03,263,149,114,0,149,0,0,0.0
2019-07-04,164,68,96,0,68,0,0,0.0
2019-07-05,197,101,96,0,101,0,0,0.0
2019-07-07,0,0,0,0,0,0,0,0.0
2019-07-08,243,156,87,0,156,0,0,0.0
2019-07-09,198,90,108,0,90,0,0,0.0
2019-07-10,250,138,112,0,138,0,0,0.0
2019-07-11,246,139,107,0,139,0,0,0.0
2019-07-12,215,119,96,0,119,0,0,0.0
2019-07-14,19,12,7,0,12,0,0,0.0
2019-07-15,194,103,91,0,103,0,0,0.0
2019-07-16,228,123,105,0,123,0,0,0.0
2019-07-17,215,120,95,0,120,0,0,0.0
2019-07-18,236,140,96,0,140,0,0,0.0
2019-07-19,121,91,30,0,91,0,0,0.0
2019-07-21,21,5,16,0,5,0,0,0.0
2019-07-22,195,91,104,0,91,0,0,0.0
2019-07-23,241,132,109,0,132,0,0,0.0
2019-07-24,239,134,105,0,134,0,0,0.0
2019-07-25,198,117,81,0,117,0,0,0.0
2019-07-26,130,56,74,0,56,0,0,0.0
2019-07-28,6,0,6,0,0,0,0,0.0
2019-07-29,232,140,92,0,140,0,0,0.0
2019-07-30,236,135,101,0,135,0,0,0.0
2019-07-31,214,108,106,0,108,0,0,0.0
2019-08-01,261,150,111,0,150,0,0,0.0
2019-08-02,230,135,95,0,135,0,0,0.0
2019-08-04,19,12,7,0,12,0,0,0.0
2019-08-05,218,118,100,0,118,0,0,0.0
2019-08-06,151,46,105,0,46,0,0,0.0
2019-08-07,215,111,104,0,111,0,0,0.0
2019-08-08,153,104,49,0,104,0,0,0.0
2019-08-09,234,141,93,0,141,0,0,0.0
2019-08-11,27,12,15,0,12,0,0,0.0
2019-08-12,256,148,108,0,148,0,0,0.0
2019-08-13,260,139,121,0,139,0,0,0.0
2019-08-14,229,116,113,0,116,0,0,0.0
2019-08-15,180,76,104,1,75,1,1,1.623486484742898
2019-08-16,154,73,81,0,73,0,0,0.0
2019-08-18,16,1,15,0,1,0,0,0.0
2019-08-19,99,71,28,0,71,0,0,0.0
2019-08-20,177,101,76,0,101,0,0,0.0
2019-08-21,252,145,107,0,145,0,0,0.0
2019-08-22,253,148,105,0,148,0,0,0.0
2019-08-23,225,129,96,0,129,0,0,0.0
2019-08-25,22,12,10,0,12,0,0,0.0
2019-08-26,181,77,104,0,77,0,0,0.0
2019-08-27,206,101,105,0,101,0,0,0.0
2019-08-28,235,130,105,0,130,0,0,0.0
2019-08-29,263,156,107,0,156,0,0,0.0
2019-08-30,226,131,95,0,131,0,0,0.0
2019-09-01,13,12,1,0,12,0,0,0.0
2019-09-02,236,150,86,0,150,0,0,0.0
2019-09-03,240,131,109,0,131,0,0,0.0
2019-09-04,189,95,94,0,95,0,0,0.0
2019-09-05,263,152,111,0,152,0,0,0.0
2019-09-06,172,93,79,0,93,0,0,0.0
2019-09-08,7,0,7,0,0,0,0,0.0
2019-09-09,174,129,45,0,129,0,0,0.0
2019-09-10,238,134,104,0,134,0,0,0.0
2019-09-11,220,115,105,0,115,0,0,0.0
2019-09-12,240,131,109,0,131,0,0,0.0
2019-09-13,98,49,49,0,49,0,0,0.0
2019-09-15,12,12,0,0,12,0,0,0.0
2019-09-16,176,150,26,0,150,0,0,0.0
2019-09-17,132,34,98,0,34,0,0,0.0
2019-09-18,220,120,100,0,120,0,0,0.0
2019-09-19,245,143,102,0,143,0,0,0.0
2019-09-20,218,122,96,0,122,0,0,0.0
2019-09-22,18,12,6,0,12,0,0,0.0
2019-09-23,117,85,32,0,85,0,0,0.0
2019-09-24,256,148,108,0,148,0,0,0.0
2019-09-25,225,121,104,0,121,0,0,0.0
2019-09-26,244,137,107,0,137,0,0,0.0
2019-09-27,224,131,93,0,131,0,0,0.0
2019-09-29,29,12,17,0,12,0,0,0.0
2019-09-30,218,145,73,0,145,0,0,0.0
2019-10-01,229,134,95,0,134,0,0,0.0
2019-10-02,244,144,100,0,144,0,0,0.0
2019-10-03,256,155,101,0,155,0,0,0.0
2019-10-04,221,126,95,0,126,0,0,0.0
2019-10-06,26,12,14,0,12,0,0,0.0
2019-10-07,217,131,86,0,131,0,0,0.0
2019-10-08,255,141,114,0,141,0,0,0.0
2019-10-09,244,139,105,0,139,0,0,0.0
2019-10-10,202,117,85,0,117,0,0,0.0
2019-10-11,229,139,90,0,139,0,0,0.0
2019-10-13,25,9,16,0,9,0,0,0.0
2019-10-14,239,134,105,0,134,0,0,0.0
2019-10-15,250,152,98,0,152,0,0,0.0
2019-10-16,245,131,114,0,131,0,0,0.0
2019-10-17,232,127,105,0,127,0,0,0.0
2019-10-18,162,69,93,0,69,0,0,0.0
2019-10-20,4,4,0,0,4,0,0,0.0
2019-10-21,229,120,109,0,120,0,0,0.0
2019-10-22,255,143,112,0,143,0,0,0.0
2019-10-23,240,134,106,0,134,0,0,0.0
2019-10-24,186,91,95,0,91,0,0,0.0
2019-10-25,232,138,94,0,138,0,0,0.0
2019-10-27,14,12,2,0,12,0,0,0.0
2019-10-28,258,154,104,0,154,0,0,0.0
2019-10-29,172,117,55,0,117,0,0,0.0
2019-10-30,218,140,78,0,140,0,0,0.0
2019-10-31,248,151,97,0,151,0,0,0.0
2019-11-01,205,132,73,0,132,0,0,0.0
2019-11-03,2,0,2,0,0,0,0,0.0
2019-11-04,155,123,32,0,123,0,0,0.0
2019-11-05,205,109,96,0,109,0,0,0.0
2019-11-06,186,92,94,0,92,0,0,0.0
2019-11-07,241,145,96,0,145,0,0,0.0
2019-11-08,245,157,88,0,157,0,0,0.0
2019-11-10,17,0,17,0,0,0,0,0.0
2019-11-11,215,123,92,0,123,0,0,0.0
2019-11-12,238,139,99,0,139,0,0,0.0
2019-11-13,240,146,94,0,146,0,0,0.0
2019-11-14,235,148,87,0,148,0,0,0.0
2019-11-15,238,142,96,0,142,0,0,0.0
2019-11-17,13,0,13,0,0,0,0,0.0
2019-11-18,244,142,102,0,142,0,0,0.0
2019-11-19,265,158,107,0,158,0,0,0.0
2019-11-20,231,125,106,0,125,0,0,0.0
2019-11-21,111,53,58,0,53,0,0,0.0
2019-11-22,220,150,70,0,150,0,0,0.0
2019-11-24,13,0,13,0,0,0,0,0.0
2019-11-25,204,91,113,0,91,0,0,0.0
2019-11-26,218,116,102,0,116,0,0,0.0
2019-11-27,257,149,108,0,149,0,0,0.0
2019-11-28,240,145,95,0,145,0,0,0.0
2019-11-29,236,140,96,0,140,0,0,0.0
2019-12-01,11,0,11,0,0,0,0,0.0
2019-12-02,231,132,99,0,132,0,0,0.0
2019-12-03,248,151,97,0,151,0,0,0.0
2019-12-04,235,135,100,0,135,0,0,0.0
2019-12-05,205,131,74,0,131,0,0,0.0
2019-12-06,235,146,89,0,146,0,0,0.0
2019-12-08,14,0,14,0,0,0,0,0.0
2019-12-09,231,134,97,0,134,0,0,0.0
2019-12-10,257,147,110,0,147,0,0,0.0
2019-12-11,159,148,11,0,148,0,0,0.0
2019-12-12,215,138,77,0,138,0,0,0.0
2019-12-13,194,135,59,0,135,0,0,0.0
2019-12-15,17,0,17,0,0,0,0,0.0
2019-12-16,221,108,113,0,108,0,0,0.0
2019-12-17,154,119,35,0,119,0,0,0.0
2019-12-18,154,69,85,0,69,0,0,0.0
2019-12-19,195,140,55,0,140,0,0,0.0
2019-12-20,157,137,20,0,137,0,0,0.0
2019-12-22,19,0,19,0,0,0,0,0.0
2019-12-23,178,135,43,0,135,0,0,0.0
2019-12-24,211,132,79,0,132,0,0,0.0
2019-12-25,98,0,98,0,0,0,0,0.0
2019-12-26,240,144,96,0,144,0,0,0.0
2019-12-27,196,104,92,0,104,0,0,0.0
2019-12-29,4,0,4,0,0,0,0,0.0
2019-12-30,227,132,95,0,132,0,0,0.0
2019-12-31,228,141,87,0,141,0,0,0.0
2020-01-01,0,0,0,0,0,0,0,0.0
2020-01-02,141,121,20,0,121,0,0,0.0
2020-01-03,208,122,86,0,122,0,0,0.0
2020-01-05,14,0,14,0,0,0,0,0.0
2020-01-06,236,127,109,0,127,0,0,0.0
2020-01-07,220,115,105,0,115,0,0,0.0
2020-01-08,229,126,103,0,126,0,0,0.0
2020-01-09,241,145,96,0,145,0,0,0.0
2020-01-10,191,152,39,0,152,0,0,0.0
2020-01-12,15,0,15,0,0,0,0,0.0
2020-01-13,244,140,104,0,140,0,0,0.0
2020-01-14,206,102,104,0,102,0,0,0.0
2020-01-15,208,109,99,0,109,0,0,0.0
2020-01-16,255,147,108,0,147,0,0,0.0
2020-01-17,188,99,89,0,99,0,0,0.0
2020-01-19,5,0,5,0,0,0,0,0.0
2020-01-20,204,133,71,0,133,0,0,0.0
2020-01-21,239,132,107,0,132,0,0,0.0
2020-01-22,251,140,111,0,140,0,0,0.0
2020-01-23,233,120,113,0,120,0,0,0.0
2020-01-24,234,143,91,0,143,0,0,0.0
2020-01-26,13,0,13,0,0,0,0,0.0
2020-01-27,188,124,64,0,124,0,0,0.0
2020-01-28,256,152,104,0,152,0,0,0.0
2020-01-29,165,98,67,0,98,0,0,0.0
2020-01-30,240,132,108,0,132,0,0,0.0
2020-01-31,245,152,93,0,152,0,0,0.0
2020-02-02,0,0,0,0,0,0,0,0.0
2020-02-03,203,97,106,0,97,0,0,0.0
2020-02-04,214,118,96,0,118,0,0,0.0
2020-02-05,162,94,68,0,94,0,0,0.0
2020-02-06,238,134,104,0,134,0,0,0.0
2020-02-07,248,152,96,0,152,0,0,0.0
2020-02-09,18,0,18,0,0,0,0,0.0
2020-02-10,181,85,96,0,85,0,0,0.0
2020-02-11,193,96,97,0,96,0,0,0.0
2020-02-12,257,158,99,0,158,0,0,0.0
2020-02-13,246,139,107,0,139,0,0,0.0
2020-02-14,214,156,58,0,156,0,0,0.0
2020-02-16,0,0,0,0,0,0,0,0.0
2020-02-17,173,149,24,0,149,0,0,0.0
2020-02-18,214,112,102,0,112,0,0,0.0
2020-02-19,267,154,113,0,154,0,0,0.0
2020-02-20,224,120,104,0,120,0,0,0.0
2020-02-21,238,144,94,0,144,0,0,0.0
2020-02-23,13,0,13,0,0,0,0,0.0
2020-02-24,261,155,106,0,155,0,0,0.0
2020-02-25,262,147,115,0,147,0,0,0.0
2020-02-26,198,92,106,1,91,1,1,5.742857142856906
2020-02-27,197,91,106,1,90,1,0,0.15799107638042642
2020-02-28,169,101,68,1,100,1,0,-5.14571428571503
2020-03-01,3,0,3,0,0,0,0,0.0
2020-03-02,183,86,97,1,85,1,1,7.300000000000296
2020-03-03,199,89,110,1,88,1,0,-5.03714285714284
2020-03-04,205,100,105,0,100,0,0,0.0
2020-03-05,239,133,106,0,133,0,0,0.0
2020-03-06,199,108,91,1,107,1,1,6.8071428571424235
2020-03-08,27,12,15,0,12,0,0,0.0
2020-03-09,176,64,112,1,63,1,0,-8.891428571428605
2020-03-10,190,89,101,1,88,1,0,-7.802857142856567
2020-03-11,178,65,113,1,64,1,0,-5.48285714285629
2020-03-12,233,129,104,1,128,1,1,11.442857142857122
2020-03-13,176,81,95,1,80,1,0,-6.580000000000041
2020-03-15,18,12,6,0,12,0,0,0.0
2020-03-16,140,101,39,1,100,1,0,-6.4514285714286075
2020-03-17,228,113,115,1,112,1,1,13.507142857143151
2020-03-18,206,104,102,1,103,1,1,8.292857142857713
2020-03-19,191,82,109,1,81,1,0,-6.114285714285927
2020-03-20,170,77,93,1,76,1,0,-6.680000000000518
2020-03-22,6,0,6,0,0,0,0,0.0
2020-03-23,240,132,108,1,131,1,1,10.307142857142082
2020-03-24,217,103,114,1,102,1,0,-4.379999999999484
2020-03-25,253,146,107,0,146,0,0,0.0
2020-03-26,160,49,111,1,48,1,1,9.135714285714414
2020-03-27,183,87,96,1,86,1,0,-5.751428571428107
2020-03-29,24,12,12,0,12,0,0,0.0
2020-03-30,144,52,92,1,51,1,1,8.107142857142946
2020-03-31,219,105,114,1,104,1,0,-5.077142857142746
2020-04-01,211,100,111,1,99,1,1,7.350000000000534
2020-04-02,236,125,111,0,125,0,0,0.0
2020-04-03,129,97,32,0,97,0,0,0.0
2020-04-05,23,12,11,0,12,0,0,0.0
2020-04-06,182,69,113,1,68,1,0,-3.5114285714290645
2020-04-07,243,132,111,0,132,0,0,0.0
2020-04-08,238,142,96,0,142,0,0,0.0
2020-04-09,271,157,114,0,157,0,0,0.0
2020-04-10,204,115,89,0,115,0,0,0.0
2020-04-12,11,10,1,0,10,0,0,0.0
2020-04-13,216,115,101,0,115,0,0,0.0
2020-04-14,240,150,90,0,150,0,0,0.0
2020-04-15,229,124,105,0,124,0,0,0.0
2020-04-16,246,146,100,0,146,0,0,0.0
2020-04-17,219,123,96,0,123,0,0,0.0
2020-04-19,21,3,18,0,3,0,0,0.0
2020-04-20,244,135,109,0,135,0,0,0.0
2020-04-21,167,59,108,0,59,0,0,0.0
2020-04-22,165,73,92,0,73,0,0,0.0
2020-04-23,189,136,53,0,136,0,0,0.0
2020-04-24,230,136,94,0,136,0,0,0.0
2020-04-26,23,10,13,0,10,0,0,0.0
2020-04-27,249,149,100,0,149,0,0,0.0
2020-04-28,263,150,113,0,150,0,0,0.0
2020-04-29,204,108,96,0,108,0,0,0.0
2020-04-30,231,128,103,0,128,0,0,0.0
2020-05-01,181,141,40,0,141,0,0,0.0
2020-05-03,17,11,6,0,11,0,0,0.0
2020-05-04,238,126,112,0,126,0,0,0.0
2020-05-05,242,132,110,0,132,0,0,0.0
2020-05-06,252,138,114,0,138,0,0,0.0
2020-05-07,258,148,110,0,148,0,0,0.0
2020-05-08,189,94,95,0,94,0,0,0.0
2020-05-10,29,12,17,0,12,0,0,0.0
2020-05-11,230,143,87,0,143,0,0,0.0
2020-05-12,229,119,110,0,119,0,0,0.0
2020-05-13,232,131,101,0,131,0,0,0.0
2020-05-14,241,138,103,0,138,0,0,0.0
2020-05-15,208,134,74,0,134,0,0,0.0
2020-05-17,28,12,16,0,12,0,0,0.0
2020-05-18,162,130,32,0,130,0,0,0.0
2020-05-19,263,148,115,0,148,0,0,0.0
2020-05-20,191,118,73,0,118,0,0,0.0
2020-05-21,200,103,97,0,103,0,0,0.0
2020-05-22,170,90,80,0,90,0,0,0.0
2020-05-24,16,6,10,0,6,0,0,0.0
2020-05-25,165,103,62,0,103,0,0,0.0
2020-05-26,201,98,103,0,98,0,0,0.0
2020-05-27,216,140,76,0,140,0,0,0.0
2020-05-28,244,145,99,0,145,0,0,0.0
2020-05-29,209,119,90,0,119,0,0,0.0
2020-05-31,24,12,12,0,12,0,0,0.0
2020-06-01,245,142,103,0,142,0,0,0.0
2020-06-02,234,136,98,0,136,0,0,0.0
2020-06-03,248,138,110,0,138,0,0,0.0
2020-06-04,254,146,108,0,146,0,0,0.0
2020-06-05,186,101,85,0,101,0,0,0.0
2020-06-07,7,4,3,0,4,0,0,0.0
2020-06-08,255,145,110,0,145,0,0,0.0
2020-06-09,265,154,111,0,154,0,0,0.0
2020-06-10,252,145,107,0,145,0,0,0.0
2020-06-11,190,101,89,0,101,0,0,0.0
2020-06-12,194,114,80,0,114,0,0,0.0
2020-06-14,13,9,4,0,9,0,0,0.0
2020-06-15,221,120,101,0,120,0,0,0.0
2020-06-16,222,136,86,0,136,0,0,0.0
2020-06-17,199,99,100,0,99,0,0,0.0
2020-06-18,224,118,106,0,118,0,0,0.0
2020-06-19,146,61,85,0,61,0,0,0.0
2020-06-21,14,12,2,0,12,0,0,0.0
2020-06-22,212,114,98,0,114,0,0,0.0
2020-06-23,168,57,111,0,57,0,0,0.0
2020-06-24,205,115,90,0,115,0,0,0.0
2020-06-25,208,148,60,0,148,0,0,0.0
2020-06-26,224,143,81,0,143,0,0,0.0
2020-06-28,14,12,2,0,12,0,0,0.0
2020-06-29,196,133,63,0,133,0,0,0.0
2020-06-30,244,143,101,0,143,0,0,0.0
2020-07-01,157,53,104,0,53,0,0,0.0
2020-07-02,213,131,82,0,131,0,0,0.0
2020-07-03,164,106,58,0,106,0,0,0.0
2020-07-05,19,12,7,0,12,0,0,0.0
2020-07-06,231,125,106,0,125,0,0,0.0
2020-07-07,248,148,100,0,148,0,0,0.0
2020-07-08,259,153,106,0,153,0,0,0.0
2020-07-09,225,125,100,0,125,0,0,0.0
2020-07-10,229,133,96,0,133,0,0,0.0
2020-07-12,25,12,13,0,12,0,0,0.0
2020-07-13,179,95,84,0,95,0,0,0.0
2020-07-14,240,151,89,0,151,0,0,0.0
2020-07-15,204,143,61,0,143,0,0,0.0
2020-07-16,244,148,96,0,148,0,0,0.0
2020-07-17,206,113,93,0,113,0,0,0.0
2020-07-19,11,10,1,0,10,0,0,0.0
2020-07-20,248,142,106,0,142,0,0,0.0
2020-07-21,259,146,113,0,146,0,0,0.0
2020-07-22,221,143,78,0,143,0,0,0.0
2020-07-23,198,118,80,0,118,0,0,0.0
2020-07-24,220,124,96,0,124,0,0,0.0
2020-07-26,7,0,7,0,0,0,0,0.0
2020-07-27,208,113,95,0,113,0,0,0.0
2020-07-28,209,113,96,0,113,0,0,0.0
2020-07-29,213,116,97,0,116,0,0,0.0
2020-07-30,222,110,112,0,110,0,0,0.0
2020-07-31,235,139,96,0,139,0,0,0.0
2020-08-02,16,12,4,0,12,0,0,0.0
2020-08-03,236,150,86,0,150,0,0,0.0
2020-08-04,255,144,111,0,144,0,0,0.0
2020-08-05,193,93,100,0,93,0,0,0.0
2020-08-06,188,90,98,0,90,0,0,0.0
2020-08-07,207,113,94,0,113,0,0,0.0
2020-08-09,18,12,6,0,12,0,0,0.0
2020-08-10,207,105,102,0,105,0,0,0.0
2020-08-11,244,136,108,0,136,0,0,0.0
2020-08-12,239,139,100,0,139,0,0,0.0
2020-08-13,220,109,111,0,109,0,0,0.0
2020-08-14,193,116,77,0,116,0,0,0.0
2020-08-16,20,11,9,0,11,0,0,0.0
2020-08-17,243,151,92,0,151,0,0,0.0
2020-08-18,186,77,109,0,77,0,0,0.0
2020-08-19,253,148,105,0,148,0,0,0.0
2020-08-20,229,130,99,0,130,0,0,0.0
2020-08-21,237,141,96,0,141,0,0,0.0
2020-08-23,30,12,18,0,12,0,0,0.0
2020-08-24,199,141,58,0,141,0,0,0.0
2020-08-25,202,102,100,0,102,0,0,0.0
2020-08-26,234,129,105,0,129,0,0,0.0
2020-08-27,187,102,85,0,102,0,0,0.0
2020-08-28,229,133,96,0,133,0,0,0.0
2020-08-30,11,9,2,0,9,0,0,0.0
2020-08-31,174,147,27,0,147,0,0,0.0
2020-09-01,266,157,109,0,157,0,0,0.0
2020-09-02,152,41,111,0,41,0,0,0.0
2020-09-03,257,147,110,0,147,0,0,0.0
2020-09-04,190,122,68,0,122,0,0,0.0
2020-09-06,26,12,14,0,12,0,0,0.0
2020-09-07,246,142,104,0,142,0,0,0.0
2020-09-08,227,120,107,0,120,0,0,0.0
2020-09-09,110,81,29,0,81,0,0,0.0
2020-09-10,232,128,104,0,128,0,0,0.0
2020-09-11,199,112,87,0,112,0,0,0.0
2020-09-13,24,12,12,0,12,0,0,0.0
2020-09-14,253,153,100,0,153,0,0,0.0
2020-09-15,230,130,100,0,130,0,0,0.0
2020-09-16,215,101,114,0,101,0,0,0.0
2020-09-17,268,155,113,0,155,0,0,0.0
2020-09-18,197,104,93,0,104,0,0,0.0
2020-09-20,12,12,0,0,12,0,0,0.0
2020-09-21,198,111,87,0,111,0,0,0.0
2020-09-22,259,158,101,0,158,0,0,0.0
2020-09-23,231,133,98,0,133,0,0,0.0
2020-09-24,199,93,106,0,93,0,0,0.0
2020-09-25,227,142,85,0,142,0,0,0.0
2020-09-27,22,12,10,0,12,0,0,0.0
2020-09-28,211,102,109,0,102,0,0,0.0
2020-09-29,181,86,95,0,86,0,0,0.0
2020-09-30,254,154,100,0,154,0,0,0.0
2020-10-01,221,130,91,0,130,0,0,0.0
2020-10-02,201,117,84,0,117,0,0,0.0
2020-10-04,20,8,12,0,8,0,0,0.0
2020-10-05,211,109,102,0,109,0,0,0.0
2020-10-06,210,107,103,0,107,0,0,0.0
2020-10-07,246,155,91,0,155,0,0,0.0
2020-10-08,176,95,81,0,95,0,0,0.0
2020-10-09,213,117,96,0,117,0,0,0.0
2020-10-11,31,12,19,0,12,0,0,0.0
2020-10-12,188,82,106,0,82,0,0,0.0
2020-10-13,186,91,95,0,91,0,0,0.0
2020-10-14,240,135,105,0,135,0,0,0.0
2020-10-15,256,142,114,0,142,0,0,0.0
2020-10-16,208,112,96,0,112,0,0,0.0
2020-10-18,11,0,11,0,0,0,0,0.0
2020-10-19,214,148,66,0,148,0,0,0.0
2020-10-20,252,152,100,0,152,0,0,0.0
2020-10-21,241,133,108,0,133,0,0,0.0
2020-10-22,256,150,106,0,150,0,0,0.0
2020-10-23,160,65,95,0,65,0,0,0.0
2020-10-25,29,12,17,0,12,0,0,0.0
2020-10-26,246,139,107,0,139,0,0,0.0
2020-10-27,246,146,100,0,146,0,0,0.0
2020-10-28,219,120,99,0,120,0,0,0.0
2020-10-29,251,150,101,0,150,0,0,0.0
2020-10-30,188,92,96,0,92,0,0,0.0
2020-11-01,8,0,8,0,0,0,0,0.0
2020-11-02,244,148,96,0,148,0,0,0.0
2020-11-03,188,147,41,0,147,0,0,0.0
2020-11-04,248,136,112,0,136,0,0,0.0
2020-11-05,198,83,115,0,83,0,0,0.0
2020-11-06,185,97,88,0,97,0,0,0.0
2020-11-08,10,0,10,0,0,0,0,0.0
2020-11-09,240,147,93,0,147,0,0,0.0
2020-11-10,162,66,96,0,66,0,0,0.0
2020-11-11,176,81,95,0,81,0,0,0.0
2020-11-12,248,144,104,0,144,0,0,0.0
2020-11-13,240,144,96,0,144,0,0,0.0
2020-11-15,0,0,0,0,0,0,0,0.0
2020-11-16,233,151,82,0,151,0,0,0.0
2020-11-17,205,91,114,0,91,0,0,0.0
2020-11-18,231,123,108,0,123,0,0,0.0
2020-11-19,216,131,85,0,131,0,0,0.0
2020-11-20,160,71,89,0,71,0,0,0.0
2020-11-22,16,0,16,0,0,0,0,0.0
2020-11-23,174,129,45,0,129,0,0,0.0
2020-11-24,198,107,91,0,107,0,0,0.0
2020-11-25,191,87,104,0,87,0,0,0.0
2020-11-26,207,95,112,0,95,0,0,0.0
2020-11-27,224,128,96,0,128,0,0,0.0
2020-11-29,11,0,11,0,0,0,0,0.0
2020-11-30,232,128,104,0,128,0,0,0.0
2020-12-01,220,110,110,0,110,0,0,0.0
2020-12-02,250,135,115,0,135,0,0,0.0
2020-12-03,211,111,100,0,111,0,0,0.0
2020-12-04,175,121,54,0,121,0,0,0.0
2020-12-06,17,0,17,0,0,0,0,0.0
2020-12-07,211,142,69,0,142,0,0,0.0
2020-12-08,152,60,92,0,60,0,0,0.0
2020-12-09,261,152,109,0,152,0,0,0.0
2020-12-10,228,128,100,0,128,0,0,0.0
2020-12-11,219,123,96,0,123,0,0,0.0
2020-12-13,0,0,0,0,0,0,0,0.0
2020-12-14,182,148,34,0,148,0,0,0.0
2020-12-15,229,143,86,0,143,0,0,0.0
2020-12-16,257,151,106,0,151,0,0,0.0
2020-12-17,189,88,101,0,88,0,0,0.0
2020-12-18,168,72,96,0,72,0,0,0.0
2020-12-20,0,0,0,0,0,0,0,0.0
2020-12-21,148,130,18,0,130,0,0,0.0
2020-12-22,224,116,108,0,116,0,0,0.0
2020-12-23,168,57,111,0,57,0,0,0.0
2020-12-24,224,115,109,0,115,0,0,0.0
2020-12-25,58,0,58,0,0,0,0,0.0
2020-12-27,17,0,17,0,0,0,0,0.0
2020-12-28,223,145,78,0,145,0,0,0.0
2020-12-29,212,109,103,0,109,0,0,0.0
2020-12-30,244,145,99,0,145,0,0,0.0
2020-12-31,132,132,0,0,132,0,0,0.0
2021-01-03,10,0,10,0,0,0,0,0.0
2021-01-04,245,143,102,0,143,0,0,0.0
2021-01-05,245,140,105,0,140,0,0,0.0
2021-01-06,222,134,88,0,134,0,0,0.0
2021-01-07,245,145,100,0,145,0,0,0.0
2021-01-08,232,146,86,0,146,0,0,0.0
2021-01-10,18,0,18,0,0,0,0,0.0
2021-01-11,219,117,102,0,117,0,0,0.0
2021-01-12,182,107,75,0,107,0,0,0.0
2021-01-13,201,97,104,0,97,0,0,0.0
2021-01-14,207,107,100,0,107,0,0,0.0
2021-01-15,160,125,35,0,125,0,0,0.0
2021-01-17,5,0,5,0,0,0,0,0.0
2021-01-18,231,128,103,0,128,0,0,0.0
2021-01-19,201,105,96,0,105,0,0,0.0
2021-01-20,247,147,100,0,147,0,0,0.0
2021-01-21,252,155,97,0,155,0,0,0.0
2021-01-22,198,103,95,0,103,0,0,0.0
2021-01-24,1,0,1,0,0,0,0,0.0
2021-01-25,185,113,72,0,113,0,0,0.0
2021-01-26,177,107,70,0,107,0,0,0.0
2021-01-27,247,154,93,0,154,0,0,0.0
2021-01-28,218,114,104,0,114,0,0,0.0
2021-01-29,191,95,96,0,95,0,0,0.0
2021-01-31,18,0,18,0,0,0,0,0.0
2021-02-01,183,84,99,0,84,0,0,0.0
2021-02-02,220,133,87,0,133,0,0,0.0
2021-02-03,132,34,98,0,34,0,0,0.0
2021-02-04,254,151,103,0,151,0,0,0.0
2021-02-05,209,153,56,0,153,0,0,0.0
2021-02-07,17,0,17,0,0,0,0,0.0
2021-02-08,258,154,104,0,154,0,0,0.0
2021-02-09,191,82,109,0,82,0,0,0.0
2021-02-10,249,156,93,0,156,0,0,0.0
2021-02-11,158,135,23,0,135,0,0,0.0
2021-02-12,230,142,88,0,142,0,0,0.0
2021-02-14,11,0,11,0,0,0,0,0.0
2021-02-15,218,115,103,0,115,0,0,0.0
2021-02-16,265,152,113,0,152,0,0,0.0
2021-02-17,219,124,95,0,124,0,0,0.0
2021-02-18,176,87,89,0,87,0,0,0.0
2021-02-19,247,158,89,0,158,0,0,0.0
2021-02-21,14,0,14,0,0,0,0,0.0
2021-02-22,245,146,99,0,146,0,0,0.0
2021-02-23,242,146,96,0,146,0,0,0.0
2021-02-24,222,109,113,0,109,0,0,0.0
2021-02-25,239,131,108,0,131,0,0,0.0
2021-02-26,232,148,84,0,148,0,0,0.0
2021-02-28,6,0,6,0,0,0,0,0.0
2021-03-01,233,142,91,0,142,0,0,0.0
2021-03-02,238,132,106,0,132,0,0,0.0
2021-03-03,261,147,114,0,147,0,0,0.0
2021-03-04,265,156,109,0,156,0,0,0.0
2021-03-05,194,105,89,0,105,0,0,0.0
2021-03-07,13,0,13,0,0,0,0,0.0
2021-03-08,236,146,90,0,146,0,0,0.0
2021-03-09,257,146,111,0,146,0,0,0.0
2021-03-10,209,100,109,0,100,0,0,0.0
2021-03-11,214,110,104,0,110,0,0,0.0
2021-03-12,149,53,96,0,53,0,0,0.0
2021-03-14,22,4,18,0,4,0,0,0.0
2021-03-15,209,116,93,0,116,0,0,0.0
2021-03-16,178,78,100,0,78,0,0,0.0
2021-03-17,255,145,110,0,145,0,0,0.0
2021-03-18,237,146,91,0,146,0,0,0.0
2021-03-19,156,63,93,0,63,0,0,0.0
2021-03-21,21,12,9,0,12,0,0,0.0
2021-03-22,105,77,28,0,77,0,0,0.0
2021-03-23,220,117,103,0,117,0,0,0.0
2021-03-24,184,82,102,0,82,0,0,0.0
2021-03-25,229,119,110,0,119,0,0,0.0
2021-03-26,233,137,96,0,137,0,0,0.0
2021-03-28,28,12,16,0,12,0,0,0.0
2021-03-29,236,138,98,0,138,0,0,0.0
2021-03-30,179,69,110,0,69,0,0,0.0
2021-03-31,208,94,114,0,94,0,0,0.0
2021-04-01,215,122,93,0,122,0,0,0.0
2021-04-02,147,56,91,0,56,0,0,0.0
2021-04-04,12,0,12,0,0,0,0,0.0
2021-04-05,195,126,69,0,126,0,0,0.0
2021-04-06,177,73,104,0,73,0,0,0.0
2021-04-07,168,74,94,0,74,0,0,0.0
2021-04-08,240,143,97,0,143,0,0,0.0
2021-04-09,190,144,46,0,144,0,0,0.0
2021-04-11,30,11,19,0,11,0,0,0.0
2021-04-12,258,152,106,0,152,0,0,0.0
2021-04-13,254,140,114,0,140,0,0,0.0
2021-04-14,202,100,102,0,100,0,0,0.0
2021-04-15,220,117,103,0,117,0,0,0.0
2021-04-16,223,129,94,0,129,0,0,0.0
2021-04-18,29,12,17,0,12,0,0,0.0
2021-04-19,143,40,103,0,40,0,0,0.0
2021-04-20,242,139,103,0,139,0,0,0.0
2021-04-21,263,150,113,0,150,0,0,0.0
2021-04-22,240,127,113,0,127,0,0,0.0
2021-04-23,199,122,77,0,122,0,0,0.0
2021-04-25,29,12,17,0,12,0,0,0.0
2021-04-26,240,127,113,0,127,0,0,0.0
2021-04-27,252,140,112,0,140,0,0,0.0
2021-04-28,225,110,115,0,110,0,0,0.0
2021-04-29,210,102,108,0,102,0,0,0.0
2021-04-30,229,133,96,0,133,0,0,0.0
2021-05-02,13,12,1,0,12,0,0,0.0
2021-05-03,265,156,109,0,156,0,0,0.0
2021-05-04,253,145,108,0,145,0,0,0.0
2021-05-05,220,113,107,0,113,0,0,0.0
2021-05-06,265,156,109,0,156,0,0,0.0
2021-05-07,134,43,91,0,43,0,0,0.0
2021-05-09,0,0,0,0,0,0,0,0.0
2021-05-10,210,111,99,0,111,0,0,0.0
2021-05-11,223,123,100,0,123,0,0,0.0
2021-05-12,249,149,100,0,149,0,0,0.0
2021-05-13,178,93,85,0,93,0,0,0.0
2021-05-14,152,56,96,0,56,0,0,0.0
2021-05-16,31,12,19,0,12,0,0,0.0
2021-05-17,148,90,58,0,90,0,0,0.0
2021-05-18,176,80,96,0,80,0,0,0.0
2021-05-19,235,122,113,0,122,0,0,0.0
2021-05-20,253,139,114,0,139,0,0,0.0
2021-05-21,211,117,94,0,117,0,0,0.0
2021-05-23,16,12,4,0,12,0,0,0.0
2021-05-24,240,156,84,0,156,0,0,0.0
2021-05-25,224,134,90,0,134,0,0,0.0
2021-05-26,222,147,75,0,147,0,0,0.0
2021-05-27,263,155,108,0,155,0,0,0.0
2021-05-28,225,130,95,0,130,0,0,0.0
2021-05-30,23,12,11,0,12,0,0,0.0
2021-05-31,249,136,113,0,136,0,0,0.0
2021-06-01,217,115,102,0,115,0,0,0.0
2021-06-02,264,152,112,0,152,0,0,0.0
2021-06-03,262,151,111,0,151,0,0,0.0
2021-06-04,231,135,96,0,135,0,0,0.0
2021-06-06,29,12,17,0,12,0,0,0.0
2021-06-07,98,29,69,0,29,0,0,0.0
2021-06-08,253,148,105,0,148,0,0,0.0
2021-06-09,243,143,100,0,143,0,0,0.0
2021-06-10,254,151,103,0,151,0,0,0.0
2021-06-11,192,104,88,0,104,0,0,0.0
2021-06-13,3,0,3,0,0,0,0,0.0
2021-06-14,229,141,88,0,141,0,0,0.0
2021-06-15,169,71,98,0,71,0,0,0.0
2021-06-16,224,125,99,0,125,0,0,0.0
2021-06-17,246,145,101,0,145,0,0,0.0
2021-06-18,232,140,92,0,140,0,0,0.0
2021-06-20,12,12,0,0,12,0,0,0.0
2021-06-21,232,133,99,0,133,0,0,0.0
2021-06-22,184,83,101,0,83,0,0,0.0
2021-06-23,242,139,103,0,139,0,0,0.0
2021-06-24,229,135,94,0,135,0,0,0.0
2021-06-25,215,134,81,0,134,0,0,0.0
2021-06-27,12,12,0,0,12,0,0,0.0
2021-06-28,246,152,94,0,152,0,0,0.0
2021-06-29,251,150,101,0,150,0,0,0.0
2021-06-30,224,123,101,0,123,0,0,0.0
2021-07-01,244,150,94,0,150,0,0,0.0
2021-07-02,179,83,96,0,83,0,0,0.0
2021-07-04,31,12,19,0,12,0,0,0.0
2021-07-05,163,83,80,0,83,0,0,0.0
2021-07-06,246,142,104,0,142,0,0,0.0
2021-07-07,174,67,107,0,67,0,0,0.0
2021-07-08,244,131,113,0,131,0,0,0.0
2021-07-09,232,136,96,0,136,0,0,0.0
2021-07-11,20,12,8,0,12,0,0,0.0
2021-07-12,187,157,30,0,157,0,0,0.0
2021-07-13,233,123,110,0,123,0,0,0.0
2021-07-14,249,135,114,0,135,0,0,0.0
2021-07-15,215,103,112,0,103,0,0,0.0
2021-07-16,226,130,96,0,130,0,0,0.0
2021-07-18,26,12,14,0,12,0,0,0.0
2021-07-19,209,96,113,0,96,0,0,0.0
2021-07-20,259,152,107,0,152,0,0,0.0
2021-07-21,154,59,95,0,59,0,0,0.0
2021-07-22,173,70,103,0,70,0,0,0.0
2021-07-23,175,84,91,0,84,0,0,0.0
2021-07-25,4,0,4,0,0,0,0,0.0
2021-07-26,176,68,108,0,68,0,0,0.0
2021-07-27,227,117,110,0,117,0,0,0.0
2021-07-28,240,129,111,0,129,0,0,0.0
2021-07-29,219,108,111,0,108,0,0,0.0
2021-07-30,176,80,96,0,80,0,0,0.0
2021-08-01,16,12,4,0,12,0,0,0.0
2021-08-02,180,149,31,0,149,0,0,0.0
2021-08-03,255,145,110,0,145,0,0,0.0
2021-08-04,210,137,73,0,137,0,0,0.0
2021-08-05,246,143,103,0,143,0,0,0.0
2021-08-06,240,146,94,0,146,0,0,0.0
2021-08-08,18,11,7,0,11,0,0,0.0
2021-08-09,218,138,80,0,138,0,0,0.0
2021-08-10,216,145,71,0,145,0,0,0.0
2021-08-11,208,99,109,0,99,0,0,0.0
2021-08-12,247,138,109,0,138,0,0,0.0
2021-08-13,195,112,83,0,112,0,0,0.0
2021-08-15,13,12,1,0,12,0,0,0.0
2021-08-16,164,52,112,0,52,0,0,0.0
2021-08-17,208,107,101,0,107,0,0,0.0
2021-08-18,212,122,90,0,122,0,0,0.0
2021-08-19,150,48,102,0,48,0,0,0.0
2021-08-20,142,54,88,0,54,0,0,0.0
2021-08-22,30,12,18,0,12,0,0,0.0
2021-08-23,217,105,112,0,105,0,0,0.0
2021-08-24,255,151,104,0,151,0,0,0.0
2021-08-25,226,119,107,0,119,0,0,0.0
2021-08-26,241,133,108,0,133,0,0,0.0
2021-08-27,213,117,96,0,117,0,0,0.0
2021-08-29,18,12,6,0,12,0,0,0.0
2021-08-30,193,105,88,0,105,0,0,0.0
2021-08-31,247,146,101,0,146,0,0,0.0
2021-09-01,178,73,105,0,73,0,0,0.0
2021-09-02,235,129,106,0,129,0,0,0.0
2021-09-03,235,139,96,0,139,0,0,0.0
2021-09-05,11,7,4,0,7,0,0,0.0
2021-09-06,168,63,105,0,63,0,0,0.0
2021-09-07,217,107,110,0,107,0,0,0.0
2021-09-08,170,72,98,0,72,0,0,0.0
2021-09-09,211,101,110,0,101,0,0,0.0
2021-09-10,154,75,79,0,75,0,0,0.0
2021-09-12,10,7,3,0,7,0,0,0.0
2021-09-13,219,110,109,0,110,0,0,0.0
2021-09-14,247,144,103,0,144,0,0,0.0
2021-09-15,205,91,114,0,91,0,0,0.0
2021-09-16,185,79,106,0,79,0,0,0.0
2021-09-17,236,140,96,0,140,0,0,0.0
2021-09-19,13,12,1,0,12,0,0,0.0
2021-09-20,228,128,100,0,128,0,0,0.0
2021-09-21,224,110,114,0,110,0,0,0.0
2021-09-22,225,121,104,0,121,0,0,0.0
2021-09-23,245,149,96,0,149,0,0,0.0
2021-09-24,209,113,96,0,113,0,0,0.0
2021-09-26,12,12,0,0,12,0,0,0.0
2021-09-27,235,147,88,0,147,0,0,0.0
2021-09-28,207,95,112,0,95,0,0,0.0
2021-09-29,249,141,108,0,141,0,0,0.0
2021-09-30,262,153,109,0,153,0,0,0.0
2021-10-01,148,58,90,0,58,0,0,0.0
2021-10-03,12,12,0,0,12,0,0,0.0
2021-10-04,233,155,78,0,155,0,0,0.0
2021-10-05,265,153,112,0,153,0,0,0.0
2021-10-06,210,99,111,0,99,0,0,0.0
2021-10-07,237,125,112,0,125,0,0,0.0
2021-10-08,241,145,96,0,145,0,0,0.0
2021-10-10,15,12,3,0,12,0,0,0.0
2021-10-11,228,129,99,0,129,0,0,0.0
2021-10-12,142,45,97,0,45,0,0,0.0
2021-10-13,236,124,112,0,124,0,0,0.0
2021-10-14,244,138,106,0,138,0,0,0.0
2021-10-15,238,142,96,0,142,0,0,0.0
2021-10-17,14,12,2,0,12,0,0,0.0
2021-10-18,109,45,64,0,45,0,0,0.0
2021-10-19,223,115,108,0,115,0,0,0.0
2021-10-20,172,61,111,0,61,0,0,0.0
2021-10-21,207,101,106,0,101,0,0,0.0
2021-10-22,223,127,96,0,127,0,0,0.0
2021-10-24,27,12,15,0,12,0,0,0.0
2021-10-25,220,119,101,0,119,0,0,0.0
2021-10-26,207,108,99,0,108,0,0,0.0
2021-10-27,225,120,105,0,120,0,0,0.0
2021-10-28,195,98,97,0,98,0,0,0.0
2021-10-29,201,105,96,0,105,0,0,0.0
2021-10-31,19,12,7,0,12,0,0,0.0
2021-11-01,221,131,90,0,131,0,0,0.0
2021-11-02,230,133,97,0,133,0,0,0.0
2021-11-03,243,136,107,0,136,0,0,0.0
2021-11-04,266,152,114,0,152,0,0,0.0
2021-11-05,201,109,92,0,109,0,0,0.0
2021-11-07,19,0,19,0,0,0,0,0.0
2021-11-08,263,149,114,0,149,0,0,0.0
2021-11-09,244,133,111,0,133,0,0,0.0
2021-11-10,248,154,94,0,154,0,0,0.0
2021-11-11,225,124,101,0,124,0,0,0.0
2021-11-12,225,129,96,0,129,0,0,0.0
2021-11-14,17,0,17,0,0,0,0,0.0
2021-11-15,239,143,96,0,143,0,0,0.0
2021-11-16,250,136,114,0,136,0,0,0.0
2021-11-17,254,150,104,0,150,0,0,0.0
2021-11-18,132,69,63,0,69,0,0,0.0
2021-11-19,233,137,96,0,137,0,0,0.0
2021-11-21,18,0,18,0,0,0,0,0.0
2021-11-22,220,120,100,0,120,0,0,0.0
2021-11-23,182,81,101,0,81,0,0,0.0
2021-11-24,242,152,90,0,152,0,0,0.0
2021-11-25,147,100,47,0,100,0,0,0.0
2021-11-26,203,107,96,0,107,0,0,0.0
2021-11-28,11,0,11,0,0,0,0,0.0
2021-11-29,138,82,56,0,82,0,0,0.0
2021-11-30,226,115,111,1,114,1,1,6.842857142856474
2021-12-01,220,111,109,1,110,1,1,5.0999999999997385
2021-12-02,219,107,112,1,106,1,1,3.757142857142071
2021-12-03,226,152,74,0,152,0,0,0.0
2021-12-05,14,0,14,0,0,0,0,0.0
2021-12-06,205,92,113,1,91,1,1,-0.2710278525929084
2021-12-07,164,60,104,0,60,0,0,0.0
2021-12-08,187,100,87,1,99,1,0,-3.7600000000002183
2021-12-09,241,134,107,0,134,0,0,0.0
2021-12-10,250,155,95,0,155,0,0,0.0
2021-12-12,17,0,17,0,0,0,0,0.0
2021-12-13,249,138,111,0,138,0,0,0.0
2021-12-14,248,146,102,0,146,0,0,0.0
2021-12-15,228,133,95,0,133,0,0,0.0
2021-12-16,247,134,113,0,134,0,0,0.0
2021-12-17,249,156,93,0,156,0,0,0.0
2021-12-19,11,0,11,0,0,0,0,0.0
2021-12-20,218,126,92,0,126,0,0,0.0
2021-12-21,241,140,101,0,140,0,0,0.0
2021-12-22,157,80,77,0,80,0,0,0.0
2021-12-23,238,123,115,0,123,0,0,0.0
2021-12-24,216,120,96,0,120,0,0,0.0
2021-12-26,2,0,2,0,0,0,0,0.0
2021-12-27,224,151,73,0,151,0,0,0.0
2021-12-28,245,144,101,0,144,0,0,0.0
2021-12-29,202,89,113,0,89,0,0,0.0
2021-12-30,193,78,115,0,78,0,0,0.0
2021-12-31,219,123,96,0,123,0,0,0.0
2022-01-02,18,0,18,0,0,0,0,0.0
2022-01-03,264,149,115,0,149,0,0,0.0
2022-01-04,267,153,114,0,153,0,0,0.0
2022-01-05,240,125,115,0,125,0,0,0.0
2022-01-06,195,80,115,1,79,1,1,3.3857142857139593
2022-01-07,253,157,96,0,157,0,0,0.0
2022-01-09,6,0,6,0,0,0,0,0.0
2022-01-10,237,132,105,0,132,0,0,0.0
2022-01-11,258,146,112,0,146,0,0,0.0
2022-01-12,248,141,107,0,141,0,0,0.0
2022-01-13,188,91,97,1,90,1,0,-2.5514285714284597
2022-01-14,241,145,96,0,145,0,0,0.0
2022-01-16,18,0,18,0,0,0,0,0.0
2022-01-17,213,107,106,0,107,0,0,0.0
2022-01-18,237,139,98,0,139,0,0,0.0
2022-01-19,254,139,115,0,139,0,0,0.0
2022-01-20,251,143,108,0,143,0,0,0.0
2022-01-21,230,134,96,0,134,0,0,0.0
2022-01-23,16,0,16,0,0,0,0,0.0
2022-01-24,217,103,114,0,103,0,0,0.0
2022-01-25,260,153,107,0,153,0,0,0.0
2022-01-26,244,145,99,0,145,0,0,0.0
2022-01-27,201,98,103,1,97,1,1,2.6999999999996476
2022-01-28,205,111,94,0,111,0,0,0.0
2022-01-30,17,0,17,0,0,0,0,0.0
2022-01-31,235,123,112,0,123,0,0,0.0
2022-02-01,178,64,114,1,63,1,0,-2.58857142857255
2022-02-02,254,143,111,0,143,0,0,0.0
2022-02-03,203,115,88,0,115,0,0,0.0
2022-02-04,246,156,90,0,156,0,0,0.0
2022-02-06,3,0,3,0,0,0,0,0.0
2022-02-07,211,155,56,0,155,0,0,0.0
2022-02-08,250,139,111,0,139,0,0,0.0
2022-02-09,208,97,111,0,97,0,0,0.0
2022-02-10,269,155,114,0,155,0,0,0.0
2022-02-11,139,51,88,1,50,1,0,-2.5228571428575037
2022-02-13,18,0,18,0,0,0,0,0.0
2022-02-14,209,139,70,0,139,0,0,0.0
2022-02-15,214,109,105,0,109,0,0,0.0
2022-02-16,215,107,108,0,107,0,0,0.0
2022-02-17,164,61,103,0,61,0,0,0.0
2022-02-18,169,73,96,0,73,0,0,0.0
2022-02-20,17,0,17,0,0,0,0,0.0
2022-02-21,241,133,108,0,133,0,0,0.0
2022-02-22,233,126,107,0,126,0,0,0.0
2022-02-23,213,117,96,0,117,0,0,0.0
2022-02-24,217,104,113,0,104,0,0,0.0
2022-02-25,185,89,96,1,88,1,0,-4.17999999999995
2022-02-27,0,0,0,0,0,0,0,0.0
2022-02-28,146,128,18,0,128,0,0,0.0
2022-03-01,195,87,108,0,87,0,0,0.0
2022-03-02,241,137,104,0,137,0,0,0.0
2022-03-03,230,120,110,0,120,0,0,0.0
2022-03-04,235,140,95,0,140,0,0,0.0
2022-03-06,2,0,2,0,0,0,0,0.0
2022-03-07,193,138,55,0,138,0,0,0.0
2022-03-08,234,128,106,0,128,0,0,0.0
2022-03-09,193,79,114,0,79,0,0,0.0
2022-03-10,256,147,109,0,147,0,0,0.0
2022-03-11,249,153,96,0,153,0,0,0.0
2022-03-13,31,12,19,0,12,0,0,0.0
2022-03-14,192,96,96,0,96,0,0,0.0
2022-03-15,205,104,101,0,104,0,0,0.0
2022-03-16,210,103,107,0,103,0,0,0.0
2022-03-17,204,142,62,0,142,0,0,0.0
2022-03-18,201,106,95,0,106,0,0,0.0
2022-03-20,24,12,12,0,12,0,0,0.0
2022-03-21,155,126,29,0,126,0,0,0.0
2022-03-22,203,93,110,1,92,1,1,4.214285714285893
2022-03-23,210,113,97,0,113,0,0,0.0
2022-03-24,208,114,94,0,114,0,0,0.0
2022-03-25,111,15,96,1,14,1,0,-5.482857142857711
2022-03-27,17,0,17,0,0,0,0,0.0
2022-03-28,211,101,110,1,100,1,0,-8.882857142856892
2022-03-29,142,37,105,1,36,1,0,-5.894285714285729
2022-03-30,130,25,105,1,24,1,0,0.9315019145087149
2022-03-31,169,65,104,0,65,0,0,0.0
2022-04-01,215,119,96,0,119,0,0,0.0
2022-04-03,14,12,2,0,12,0,0,0.0
2022-04-04,170,126,44,0,126,0,0,0.0
2022-04-05,217,114,103,0,114,0,0,0.0
2022-04-06,222,124,98,0,124,0,0,0.0
2022-04-07,145,38,107,0,38,0,0,0.0
2022-04-08,167,82,85,0,82,0,0,0.0
2022-04-10,27,12,15,0,12,0,0,0.0
2022-04-11,216,104,112,0,104,0,0,0.0
2022-04-12,220,122,98,0,122,0,0,0.0
2022-04-13,215,108,107,0,108,0,0,0.0
2022-04-14,243,134,109,0,134,0,0,0.0
2022-04-15,185,89,96,0,89,0,0,0.0
2022-04-17,11,10,1,0,10,0,0,0.0
2022-04-18,174,151,23,0,151,0,0,0.0
2022-04-19,216,119,97,0,119,0,0,0.0
2022-04-20,183,103,80,1,102,1,1,9.264285714285847
2022-04-21,173,92,81,1,91,1,0,-5.171428571427327
2022-04-22,230,139,91,0,139,0,0,0.0
2022-04-24,4,3,1,0,3,0,0,0.0
2022-04-25,167,84,83,1,83,1,0,-6.1657142857119425
2022-04-26,207,115,92,0,115,0,0,0.0
2022-04-27,225,118,107,0,118,0,0,0.0
2022-04-28,171,69,102,1,68,1,1,10.30000000000041
2022-04-29,184,88,96,1,87,1,1,9.107142857143458
2022-05-01,14,12,2,0,12,0,0,0.0
2022-05-02,165,102,63,1,101,1,0,-4.751428571427596
2022-05-03,228,131,97,0,131,0,0,0.0
2022-05-04,178,121,57,0,121,0,0,0.0
2022-05-05,193,129,64,0,129,0,0,0.0
2022-05-06,185,89,96,0,89,0,0,0.0
2022-05-08,0,0,0,0,0,0,0,0.0
2022-05-09,227,126,101,0,126,0,0,0.0
2022-05-10,211,139,72,0,139,0,0,0.0
2022-05-11,158,108,50,1,107,1,1,6.357142857143117
2022-05-12,99,2,97,2,0,2,2,7.004039496950099
2022-05-13,96,6,90,2,4,2,1,3.034285714288899
2022-05-15,12,0,12,0,0,0,0,0.0
2022-05-16,99,2,97,2,0,2,0,-11.779999999999745
2022-05-17,162,53,109,1,52,1,1,7.5000000000012506
2022-05-18,188,82,106,1,81,1,1,6.821428571430033
2022-05-19,97,2,95,2,0,2,0,-14.15142857142888
2022-05-20,84,6,78,2,4,2,1,3.488571428572641
2022-05-22,0,0,0,0,0,0,0,0.0
2022-05-23,109,16,93,1,15,1,0,-4.811428571428166
2022-05-24,144,41,103,1,40,1,1,7.435714285714823
2022-05-25,144,33,111,1,32,1,1,4.307142857143276
2022-05-26,165,54,111,1,53,1,1,4.0571428571420824
2022-05-27,131,37,94,1,36,1,0,-3.2257142857138206
2022-05-29,16,0,16,0,0,0,0,0.0
2022-05-30,177,65,112,1,64,1,1,1.6214285714279413
2022-05-31,166,52,114,2,50,2,1,-0.05142857142692492
2022-06-01,169,61,108,1,60,1,1,6.264285714285734
2022-06-02,175,69,106,1,68,1,0,-4.282857142857665
2022-06-03,146,71,75,1,70,1,1,3.2142857142868024
2022-06-05,10,0,10,0,0,0,0,0.0
2022-06-06,135,30,105,1,29,1,1,3.235714285716085
2022-06-07,125,17,108,1,16,1,1,1.3500849757231208
2022-06-08,126,11,115,2,9,2,0,-11.368571428571727
2022-06-09,88,2,86,2,0,2,1,1.930000000000632
2022-06-10,103,7,96,2,5,2,1,-4.098571428566288
2022-06-12,9,0,9,0,0,0,0,0.0
2022-06-13,113,11,102,2,9,2,0,-12.817142857140084
2022-06-14,122,11,111,2,9,2,0,-10.357142857140843
2022-06-15,109,6,103,2,4,2,0,-10.191428571429583
2022-06-16,120,14,106,2,12,2,1,13.887142857145363
2022-06-17,105,9,96,2,7,2,1,2.6728571428568557
2022-06-19,8,0,8,0,0,0,0,0.0
2022-06-20,145,54,91,1,53,1,0,-4.365714285711874
2022-06-21,140,50,90,1,49,1,0,-0.27842922015440763
2022-06-22,144,35,109,1,34,1,0,-6.391428571428037
2022-06-23,139,29,110,2,27,2,1,3.2857142857172903
2022-06-24,106,10,96,2,8,2,1,7.318571428574728
2022-06-26,11,0,11,0,0,0,0,0.0
2022-06-27,160,61,99,1,60,1,0,-5.5114285714272455
2022-06-28,171,68,103,0,68,0,0,0.0
2022-06-29,161,62,99,1,61,1,0,-5.30285714285742
2022-06-30,129,53,76,1,52,1,1,8.86428571428678
2022-07-01,159,63,96,1,62,1,1,7.764285714287212
2022-07-03,12,0,12,0,0,0,0,0.0
2022-07-04,213,113,100,1,112,1,1,4.721428571431375
2022-07-05,137,24,113,1,23,1,0,-4.988571428572641
2022-07-06,126,15,111,2,13,2,1,11.88857142857296
2022-07-07,157,52,105,1,51,1,0,-5.059999999997899
2022-07-08,167,78,89,1,77,1,1,4.150000000000887
2022-07-10,19,0,19,0,0,0,0,0.0
2022-07-11,182,80,102,1,79,1,1,4.671428571429715
2022-07-12,155,50,105,1,49,1,1,6.185714285717381
2022-07-13,149,37,112,1,36,1,1,8.557142857145095
2022-07-14,111,10,101,2,8,2,0,-12.951428571424572
2022-07-15,125,51,74,1,50,1,0,-6.119999999998981
2022-07-17,13,0,13,0,0,0,0,0.0
2022-07-18,263,148,115,1,147,1,1,2.3785714285731956
2022-07-19,152,49,103,1,48,1,1,6.5428571428578834
2022-07-20,176,64,112,1,63,1,1,2.7428571428596342
2022-07-21,174,65,109,1,64,1,1,8.028571428573173
2022-07-22,121,38,83,2,36,2,2,18.30714285714714
2022-07-24,13,0,13,0,0,0,0,0.0
2022-07-25,92,2,90,2,0,2,0,-7.171428571428805
2022-07-26,146,41,105,1,40,1,1,7.20000000000266
2022-07-27,145,42,103,1,41,1,0,-4.84285714285636
2022-07-28,134,31,103,2,29,2,1,-3.530620600361999
2022-07-29,74,2,72,2,0,2,0,-13.982857142858961
2022-07-31,13,0,13,0,0,0,0,0.0
2022-08-01,114,2,112,2,0,2,1,-3.494648240045194
2022-08-02,108,3,105,2,1,2,0,-12.657142857143299
2022-08-03,119,44,75,1,43,1,0,-4.797142857143399
2022-08-04,147,37,110,1,36,1,0,-7.168571428571113
2022-08-05,142,49,93,2,47,2,1,5.394285714287662
2022-08-07,10,0,10,0,0,0,0,0.0
2022-08-08,103,44,59,1,43,1,0,-5.494285714283819
2022-08-09,175,71,104,0,71,0,0,0.0
2022-08-10,124,25,99,1,24,1,0,-18.254285714283924
2022-08-11,122,29,93,1,28,1,0,-9.239999999997394
2022-08-12,148,52,96,1,51,1,0,-8.242857142855541
2022-08-14,12,0,12,0,0,0,0,0.0
2022-08-15,149,44,105,1,43,1,0,-5.851428571427164
2022-08-16,253,148,105,0,148,0,0,0.0
2022-08-17,193,90,103,1,89,1,1,1.2389222128088022
2022-08-18,134,37,97,1,36,1,1,9.364285714286325
2022-08-19,158,62,96,1,61,1,0,-5.437142857141907
2022-08-21,10,0,10,0,0,0,0,0.0
2022-08-22,173,64,109,1,63,1,1,6.1642857142880985
2022-08-23,184,69,115,1,68,1,1,11.164285714286393
2022-08-24,155,51,104,1,50,1,0,-6.8771428571413935
2022-08-25,144,35,109,1,34,1,0,-4.662857142856069
2022-08-26,170,74,96,1,73,1,1,13.000000000001933
2022-08-28,13,0,13,0,0,0,0,0.0
2022-08-29,154,54,100,1,53,1,0,-4.888571428572163
2022-08-30,142,35,107,1,34,1,1,9.607142857143003
2022-08-31,202,95,107,0,95,0,0,0.0
2022-09-01,136,27,109,1,26,1,1,14.30714285714555
2022-09-02,144,52,92,0,52,0,0,0.0
2022-09-04,17,0,17,0,0,0,0,0.0
2022-09-05,178,96,82,0,96,0,0,0.0
2022-09-06,172,68,104,1,67,1,1,7.1500000000010004
2022-09-07,165,52,113,1,51,1,1,1.506562085063024
2022-09-08,87,2,85,2,0,2,0,-15.108571428570826
2022-09-09,145,50,95,1,49,1,0,-8.242857142855541
2022-09-11,14,0,14,0,0,0,0,0.0
2022-09-12,122,31,91,1,30,1,0,-5.131428571428842
2022-09-13,133,49,84,1,48,1,1,22.242857142858952
2022-09-14,102,2,100,2,0,2,0,-15.9114285714262
2022-09-15,141,52,89,1,51,1,0,-7.1142857142835965
2022-09-16,146,73,73,1,72,1,1,6.478571428572877
2022-09-18,16,0,16,0,0,0,0,0.0
2022-09-19,135,31,104,1,30,1,1,5.64285714285927
2022-09-20,118,11,107,1,10,1,0,-2.8571428571443676
2022-09-21,181,67,114,1,66,1,1,3.8285714285730137
2022-09-22,106,9,97,2,7,2,1,-0.6014285714238667
2022-09-23,147,55,92,1,54,1,0,1.1652526924502808
2022-09-25,8,0,8,0,0,0,0,0.0
2022-09-26,156,47,109,1,46,1,0,-5.131428571428842
2022-09-27,160,56,104,1,55,1,0,-4.177142857142712
2022-09-28,173,64,109,1,63,1,1,7.4714285714288735
2022-09-29,118,20,98,1,19,1,1,4.671428571429715
2022-09-30,153,67,86,1,66,1,1,3.3285714285734684
2022-10-02,16,0,16,0,0,0,0,0.0
2022-10-03,190,76,114,1,75,1,1,7.578571428572445
2022-10-04,205,97,108,1,96,1,1,3.114285714286325
2022-10-05,113,35,78,1,34,1,1,5.685714285714994
2022-10-06,148,83,65,1,82,1,1,5.021428571429965
2022-10-07,91,28,63,1,27,1,0,-7.8542857142854245
2022-10-09,9,0,9,0,0,0,0,0.0
2022-10-10,121,32,89,1,31,1,0,-2.168571428572818
2022-10-11,163,65,98,1,64,1,1,3.1642857142879848
2022-10-12,180,67,113,1,66,1,1,5.5857142857173585
2022-10-13,101,48,53,0,48,0,0,0.0
2022-10-14,142,52,90,1,51,1,1,5.735714285716654
2022-10-16,6,0,6,0,0,0,0,0.0
2022-10-17,99,35,64,1,34,1,0,-3.005714285715044
2022-10-18,180,73,107,1,72,1,1,3.4714285714296693
2022-10-19,207,141,66,0,141,0,0,0.0
2022-10-20,231,124,107,0,124,0,0,0.0
2022-10-21,150,54,96,1,53,1,1,5.289309817356525
2022-10-23,14,0,14,0,0,0,0,0.0
2022-10-24,68,41,27,2,39,2,0,-11.38571428571231
2022-10-25,53,25,28,1,24,1,0,-4.894285714286639
2022-10-26,59,17,42,1,16,1,0,-4.960000000000264
2022-10-27,144,54,90,1,53,1,1,15.25714285714298
2022-10-28,116,39,77,1,38,1,0,-7.55714285714123
2022-10-30,3,0,3,0,0,0,0,0.0
2022-10-31,168,55,113,1,54,1,0,-4.525714285711501
2022-11-01,154,50,104,1,49,1,1,11.27857142857306
2022-11-02,129,16,113,1,15,1,0,-5.231428571426477
2022-11-03,153,51,102,1,50,1,0,-4.9428571428568375
2022-11-04,63,7,56,1,6,1,0,-11.134285714283465
2022-11-06,0,0,0,0,0,0,0,0.0
2022-11-07,123,56,67,1,55,1,0,-7.36285714285475
2022-11-08,171,60,111,1,59,1,1,9.628571428572286
2022-11-09,156,52,104,1,51,1,0,-7.197142857140648
2022-11-10,165,51,114,1,50,1,1,5.099743138776603
2022-11-11,121,25,96,2,23,2,1,16.755714285715385
2022-11-13,0,0,0,0,0,0,0,0.0
2022-11-14,42,8,34,2,6,2,1,9.247142857141966
2022-11-15,111,2,109,2,0,2,1,-4.086727552803836
2022-11-16,137,25,112,1,24,1,1,2.352839039289279
2022-11-17,100,2,98,2,0,2,0,-13.531428571426773
2022-11-18,123,27,96,1,26,1,0,-3.334285714283169
2022-11-20,15,0,15,0,0,0,0,0.0
2022-11-21,166,71,95,1,70,1,0,-5.960000000002196
2022-11-22,178,65,113,1,64,1,0,-5.43428571428467
2022-11-23,173,65,108,1,64,1,1,20.07142857142935
2022-11-24,170,61,109,1,60,1,0,-5.077142857141325
2022-11-25,156,65,91,1,64,1,0,-5.980000000000018
2022-11-27,10,0,10,0,0,0,0,0.0
2022-11-28,142,40,102,1,39,1,0,-7.259999999999877
2022-11-29,159,51,108,1,50,1,1,9.900000000001342
2022-11-30,164,66,98,1,65,1,1,14.600000000001046
2022-12-01,155,40,115,1,39,1,0,-4.480000000001382
2022-12-02,152,56,96,1,55,1,1,6.121537097407781
2022-12-04,2,0,2,0,0,0,0,0.0
2022-12-05,118,56,62,1,55,1,0,-5.737142857140498
2022-12-06,163,57,106,1,56,1,1,8.907142857145345
2022-12-07,114,9,105,1,8,1,1,10.950000000002092
2022-12-08,151,46,105,1,45,1,0,-6.85714285714073
2022-12-09,149,53,96,1,52,1,1,18.22857142857356
2022-12-11,17,0,17,0,0,0,0,0.0
2022-12-12,116,19,97,1,18,1,1,4.671428571429715
2022-12-13,116,23,93,1,22,1,1,5.558770245465439
2022-12-14,130,25,105,2,23,2,1,9.281428571428819
2022-12-15,118,4,114,2,2,2,1,5.1128571428582745
2022-12-16,103,7,96,2,5,2,0,-11.345714285710983
2022-12-18,12,0,12,0,0,0,0,0.0
2022-12-19,86,54,32,1,53,1,0,-5.365714285713807
2022-12-20,123,14,109,2,12,2,1,2.8342857142851017
2022-12-21,136,40,96,1,39,1,0,-3.5399999999985994
2022-12-22,134,24,110,1,23,1,0,-2.405714285715021
2022-12-23,117,22,95,1,21,1,1,8.571428571431284
2022-12-25,11,0,11,0,0,0,0,0.0
2022-12-26,263,154,109,0,154,0,0,0.0
2022-12-27,138,56,82,1,55,1,0,-4.2314285714273865
2022-12-28,154,39,115,1,38,1,1,7.450000000002433
2022-12-29,140,31,109,1,30,1,1,10.65000000000066
2022-12-30,112,16,96,1,15,1,0,-3.688571428572118
2023-01-01,8,0,8,0,0,0,0,0.0
2023-01-02,88,49,39,1,48,1,0,-2.500000000001023
2023-01-03,117,3,114,2,1,2,0,-12.90571428571161
2023-01-04,176,65,111,1,64,1,1,9.600000000002751
2023-01-05,118,15,103,1,14,1,0,-8.171428571427441
2023-01-06,127,31,96,1,30,1,1,21.178571428572013
2023-01-08,17,0,17,0,0,0,0,0.0
2023-01-09,148,48,100,1,47,1,0,-6.382857142856324
2023-01-10,110,38,72,1,37,1,1,10.921428571429715
2023-01-11,115,12,103,1,11,1,1,0.5984823712192338
2023-01-12,154,47,107,1,46,1,0,-4.334285714285102
2023-01-13,107,25,82,1,24,1,0,-4.480000000001382
2023-01-15,15,0,15,0,0,0,0,0.0
2023-01-16,116,2,114,1,1,1,0,-4.702857142857397
2023-01-17,150,35,115,1,34,1,0,-7.177142857142826
2023-01-18,146,45,101,1,44,1,1,4.097812042476335
2023-01-19,145,46,99,1,45,1,0,-7.791428571426195
2023-01-20,173,77,96,1,76,1,1,9.814285714287053
2023-01-22,16,0,16,0,0,0,0,0.0
2023-01-23,155,47,108,1,46,1,1,1.3247759673812425
2023-01-24,177,68,109,1,67,1,1,10.37142857142851
2023-01-25,177,67,110,1,66,1,0,-4.71142857142911
2023-01-26,152,42,110,1,41,1,0,-2.8473882650762334
2023-01-27,121,25,96,1,24,1,0,-6.73714285714243
2023-01-29,6,0,6,0,0,0,0,0.0
2023-01-30,152,40,112,1,39,1,0,-4.122857142858038
2023-01-31,190,77,113,1,76,1,1,9.221428571430124
2023-02-01,196,86,110,1,85,1,1,7.021428571430988
2023-02-02,163,53,110,1,52,1,0,-5.182857142856278
2023-02-03,136,47,89,1,46,1,1,17.842857142857838
2023-02-05,4,0,4,0,0,0,0,0.0
2023-02-06,58,41,17,1,40,1,1,7.0071428571448
2023-02-07,126,34,92,1,33,1,1,7.571428571429351
2023-02-08,147,56,91,1,55,1,1,7.950000000001978
2023-02-09,140,41,99,1,40,1,1,8.435714285715335
2023-02-10,96,2,94,2,0,2,0,-17.331428571430706
2023-02-12,13,0,13,0,0,0,0,0.0
2023-02-13,163,59,104,1,58,1,1,8.07857142857199
2023-02-14,140,34,106,1,33,1,0,-3.78285714285812
2023-02-15,139,34,105,1,33,1,1,8.650000000002478
2023-02-16,138,33,105,1,32,1,0,0.05604063722682895
2023-02-17,128,32,96,1,31,1,1,0.8937057831697075
2023-02-19,15,0,15,0,0,0,0,0.0
2023-02-20,114,14,100,1,13,1,0,-4.08285714285671
2023-02-21,122,16,106,1,15,1,0,-4.097142857142899
2023-02-22,155,53,102,1,52,1,0,-4.40857142857044
2023-02-23,135,36,99,1,35,1,1,9.185714285714653
2023-02-24,127,53,74,1,52,1,0,-0.3035793292018525
2023-02-26,12,0,12,0,0,0,0,0.0
2023-02-27,152,54,98,1,53,1,1,4.414285714286848
2023-02-28,124,26,98,1,25,1,1,6.85000000000241
2023-03-01,165,53,112,1,52,1,0,-3.6542857142852654
2023-03-02,131,33,98,1,32,1,1,1.2847914327575154
2023-03-03,103,46,57,1,45,1,1,5.164285714286166
2023-03-05,16,0,16,0,0,0,0,0.0
2023-03-06,164,53,111,1,52,1,0,-4.9999999999987494
2023-03-07,151,43,108,1,42,1,0,-4.668571428570544
2023-03-08,143,36,107,1,35,1,1,9.242857142859407
2023-03-09,166,55,111,1,54,1,1,0.8802214566084103
2023-03-10,151,55,96,1,54,1,0,-3.8342857142855564
2023-03-12,4,0,4,0,0,0,0,0.0
2023-03-13,37,10,27,2,8,2,1,5.725714285715867
2023-03-14,110,2,108,2,0,2,1,-7.791158032902445
2023-03-15,106,2,104,2,0,2,1,0.5619916243821308
2023-03-16,110,2,108,2,0,2,0,-20.397142857141603
2023-03-17,124,28,96,1,27,1,0,-6.66571428571433
2023-03-19,18,0,18,0,0,0,0,0.0
2023-03-20,83,2,81,2,0,2,0,-15.837142857140861
2023-03-21,148,52,96,1,51,1,0,-4.759999999999309
2023-03-22,149,60,89,1,59,1,1,5.614285714286893
2023-03-23,160,52,108,1,51,1,0,-5.31428571428637
2023-03-24,127,32,95,1,31,1,0,-5.728571428571627
2023-03-26,3,0,3,0,0,0,0,0.0
2023-03-27,116,56,60,1,55,1,0,-3.6914285714293555
2023-03-28,189,78,111,1,77,1,0,-5.419999999998481
2023-03-29,165,51,114,1,50,1,0,-3.780000000000882
2023-03-30,156,44,112,1,43,1,0,-5.060000000000741
2023-03-31,128,32,96,1,31,1,1,8.28571428571604
2023-04-02,1,0,1,0,0,0,0,0.0
2023-04-03,148,48,100,1,47,1,0,-5.234285714283715
2023-04-04,168,63,105,1,62,1,1,15.128571428572968
2023-04-05,158,61,97,1,60,1,0,-8.49714285714117
2023-04-06,147,52,95,1,51,1,0,-5.834285714283737
2023-04-07,129,59,70,0,59,0,0,0.0
2023-04-09,5,0,5,0,0,0,0,0.0
2023-04-10,142,42,100,1,41,1,1,7.550000000000068
2023-04-11,164,49,115,1,48,1,1,3.928571428573491
2023-04-12,186,80,106,1,79,1,0,-4.302857142855487
2023-04-13,97,48,49,1,47,1,1,12.585714285716676
2023-04-14,177,84,93,1,83,1,1,4.82142857142901
2023-04-16,17,0,17,0,0,0,0,0.0
2023-04-17,113,31,82,1,30,1,1,5.742857142856906
2023-04-18,154,70,84,1,69,1,1,4.52142857143042
2023-04-19,168,73,95,1,72,1,1,1.5785714285722179
2023-04-20,124,45,79,1,44,1,0,-5.459999999999809
2023-04-21,160,65,95,1,64,1,1,11.750000000000227
2023-04-23,17,0,17,0,0,0,0,0.0
2023-04-24,130,39,91,1,38,1,0,-3.0771428571431443
2023-04-25,126,38,88,1,37,1,0,-5.454285714285334
2023-04-26,142,34,108,1,33,1,0,-5.259999999998854
2023-04-27,118,40,78,1,39,1,0,-9.105714285712907
2023-04-28,140,52,88,1,51,1,1,9.971428571429442
2023-04-30,11,0,11,0,0,0,0,0.0
2023-05-01,143,36,107,1,35,1,0,-2.88857142857114
2023-05-02,168,64,104,1,63,1,1,9.700000000000387
2023-05-03,157,61,96,1,60,1,0,-3.5828571428543228
2023-05-04,82,42,40,1,41,1,1,2.974844022059642
2023-05-05,149,53,96,1,52,1,0,-7.717142857140857
2023-05-07,18,0,18,0,0,0,0,0.0
2023-05-08,134,45,89,1,44,1,1,4.87142857143067
2023-05-09,143,48,95,1,47,1,0,-4.234285714284624
2023-05-10,140,39,101,1,38,1,0,-2.274285714284929
2023-05-11,157,56,101,1,55,1,1,9.742857142858952
2023-05-12,190,119,71,0,119,0,0,0.0
2023-05-14,18,12,6,0,12,0,0,0.0
2023-05-15,155,58,97,1,57,1,0,-5.33714285714143
2023-05-16,184,75,109,1,74,1,1,3.142857142858702
2023-05-17,220,123,97,1,122,1,1,2.0071428571436627
2023-05-18,125,41,84,1,40,1,1,3.842857142859202
2023-05-19,153,57,96,1,56,1,1,6.585714285716449
2023-05-21,19,0,19,0,0,0,0,0.0
2023-05-22,110,39,71,1,38,1,1,5.714285714287371
2023-05-23,136,33,103,1,32,1,0,-7.971428571426486
2023-05-24,241,131,110,1,130,1,1,2.2571428571434353
2023-05-25,160,59,101,1,58,1,0,-4.50571428571368
2023-05-26,135,45,90,1,44,1,0,-7.585714285713607
2023-05-28,2,0,2,0,0,0,0,0.0
2023-05-29,162,56,106,1,55,1,0,-3.5485714285703125
2023-05-30,160,70,90,1,69,1,0,-3.819999999999368
2023-05-31,157,70,87,1,69,1,0,-6.719999999999004
2023-06-01,149,59,90,1,58,1,1,12.24285714285952
2023-06-02,167,83,84,1,82,1,1,5.228571428574014
2023-06-04,12,0,12,0,0,0,0,0.0
2023-06-05,99,8,91,1,7,1,0,-4.74571428571312
2023-06-06,136,62,74,1,61,1,0,-4.751428571427596
2023-06-07,200,90,110,1,89,1,1,4.021428571428032
2023-06-08,145,36,109,1,35,1,0,-5.6400000000001
2023-06-09,152,56,96,1,55,1,0,-4.531428571425977
2023-06-11,9,0,9,0,0,0,0,0.0
2023-06-12,141,58,83,1,57,1,1,5.500000000000227
2023-06-13,159,53,106,1,52,1,1,4.1142857142854155
2023-06-14,177,67,110,1,66,1,1,2.5571428571420256
2023-06-15,181,68,113,1,67,1,1,3.842857142859202
2023-06-16,170,75,95,1,74,1,1,8.999999999999886
2023-06-18,8,0,8,0,0,0,0,0.0
2023-06-19,115,50,65,1,49,1,0,-3.8428571428544274
2023-06-20,187,83,104,1,82,1,0,-5.214285714283051
2023-06-21,186,72,114,1,71,1,0,-3.211428571427632
2023-06-22,157,73,84,1,72,1,1,3.978571428572309
2023-06-23,163,73,90,1,72,1,1,7.650000000000546
2023-06-25,13,0,13,0,0,0,0,0.0
2023-06-26,131,24,107,1,23,1,0,-2.7457142857149393
2023-06-27,167,69,98,1,68,1,1,4.928571428572582
2023-06-28,181,86,95,0,86,0,0,0.0
2023-06-29,130,48,82,0,48,0,0,0.0
2023-06-30,164,81,83,1,80,1,0,-5.491428571426582
2023-07-02,12,0,12,0,0,0,0,0.0
2023-07-03,161,61,100,1,60,1,0,-3.7857142857125154
2023-07-04,233,144,89,0,144,0,0,0.0
2023-07-05,176,67,109,1,66,1,1,1.5785714285722179
2023-07-06,172,62,110,1,61,1,0,-5.725714285711547
2023-07-07,137,45,92,1,44,1,0,-9.511428571429292
2023-07-09,0,0,0,0,0,0,0,0.0
2023-07-10,145,47,98,1,46,1,1,9.457142857143708
2023-07-11,172,61,111,1,60,1,1,3.228571428572991
2023-07-12,137,24,113,1,23,1,1,19.42142857143051
2023-07-13,139,36,103,1,35,1,0,-7.020000000000437
2023-07-14,154,59,95,1,58,1,1,14.800000000002001
2023-07-16,3,0,3,0,0,0,0,0.0
2023-07-17,160,55,105,1,54,1,0,-6.248571428571836
2023-07-18,144,36,108,1,35,1,0,-12.111428571427496
2023-07-19,181,73,108,1,72,1,0,-4.765714285713784
2023-07-20,183,74,109,1,73,1,1,4.321428571429465
2023-07-21,122,29,93,1,28,1,1,8.492857142860089
2023-07-23,11,0,11,0,0,0,0,0.0
2023-07-24,164,49,115,1,48,1,0,-3.8457142857145072
2023-07-25,129,47,82,1,46,1,1,4.692857142858998
2023-07-26,189,82,107,1,81,1,1,2.2285714285739004
2023-07-27,137,43,94,1,42,1,0,-8.077142857141439
2023-07-28,51,2,49,2,0,2,1,5.591428571431379
2023-07-30,16,0,16,0,0,0,0,0.0
2023-07-31,126,23,103,1,22,1,0,-6.017142857141266
2023-08-01,166,67,99,1,66,1,1,3.257142857145368
2023-08-02,134,45,89,2,43,2,1,5.81571428571317
2023-08-03,130,26,104,2,24,2,1,2.5071428571455954
2023-08-04,139,48,91,1,47,1,1,18.750000000002387
2023-08-06,14,0,14,0,0,0,0,0.0
2023-08-07,153,48,105,1,47,1,1,4.7214285714285325
2023-08-08,148,35,113,1,34,1,0,-4.31428571428728
2023-08-09,165,60,105,1,59,1,1,6.528571428574537
2023-08-10,141,32,109,1,31,1,0,-6.448571428569949
2023-08-11,154,96,58,0,96,0,0,0.0
2023-08-13,20,11,9,0,11,0,0,0.0
2023-08-14,128,77,51,1,76,1,1,3.5071428571422985
2023-08-15,168,75,93,0,75,0,0,0.0
2023-08-16,166,63,103,1,62,1,0,-2.102857142856351
2023-08-17,187,73,114,1,72,1,1,3.371428571429192
2023-08-18,158,62,96,1,61,1,1,5.585714285714516
2023-08-20,7,0,7,0,0,0,0,0.0
2023-08-21,141,85,56,1,84,1,0,-2.671428571429601
2023-08-22,176,73,103,1,72,1,1,3.292857142857997
2023-08-23,156,47,109,1,46,1,0,-6.085714285712129
2023-08-24,183,75,108,1,74,1,0,-4.639999999998167
2023-08-25,141,46,95,1,45,1,0,-3.9046494706188923
2023-08-27,16,0,16,0,0,0,0,0.0
2023-08-28,159,65,94,0,65,0,0,0.0
2023-08-29,177,89,88,1,88,1,1,6.421428571430965
2023-08-30,169,54,115,1,53,1,1,3.607142857145618
2023-08-31,156,57,99,1,56,1,1,4.421428571429942
2023-09-01,97,24,73,1,23,1,0,-10.422857142856856
2023-09-03,14,0,14,0,0,0,0,0.0
2023-09-04,183,100,83,0,100,0,0,0.0
2023-09-05,264,153,111,0,153,0,0,0.0
2023-09-06,161,50,111,1,49,1,1,11.321428571428783
2023-09-07,133,35,98,1,34,1,0,-4.774285714285497
2023-09-08,152,61,91,1,60,1,0,-4.21714285714404
2023-09-10,0,0,0,0,0,0,0,0.0
2023-09-11,129,53,76,2,51,2,1,2.208571428575624
2023-09-12,162,55,107,1,54,1,0,-2.62285714285656
2023-09-13,158,53,105,1,52,1,0,-3.8314285714283187
2023-09-14,197,97,100,0,97,0,0,0.0
2023-09-15,127,54,73,0,54,0,0,0.0
2023-09-17,19,1,18,1,0,1,1,1.3642857142879166
2023-09-18,236,132,104,0,132,0,0,0.0
2023-09-19,240,132,108,0,132,0,0,0.0
2023-09-20,261,155,106,0,155,0,0,0.0
2023-09-21,241,138,103,0,138,0,0,0.0
2023-09-22,207,111,96,0,111,0,0,0.0
2023-09-24,15,2,13,1,1,1,0,-3.399999999999636
2023-09-25,105,44,61,1,43,1,0,-2.5800000000008367
2023-09-26,195,95,100,0,95,0,0,0.0
2023-09-27,211,152,59,0,152,0,0,0.0
2023-09-28,191,89,102,0,89,0,0,0.0
2023-09-29,233,137,96,0,137,0,0,0.0
2023-10-01,27,10,17,1,9,1,1,2.471428571430579
2023-10-02,172,66,106,1,65,1,0,-2.994285714286093
2023-10-03,256,137,119,0,137,0,0,0.0
2023-10-04,141,40,101,1,39,1,0,-3.780000000000882
2023-10-05,148,39,109,1,38,1,0,-3.9742857142845196
2023-10-06,166,70,96,0,70,0,0,0.0
2023-10-08,17,12,5,0,12,0,0,0.0
2023-10-09,50,38,12,1,37,1,0,-2.302857142857306
2023-10-10,167,64,103,1,63,1,1,3.6500000000013415
2023-10-11,151,51,100,1,50,1,1,3.0214285714289417
2023-10-12,219,127,92,0,127,0,0,0.0
2023-10-13,167,77,90,0,77,0,0,0.0
2023-10-15,25,11,14,0,11,0,0,0.0
2023-10-16,88,40,48,1,39,1,0,-2.2428571428581563
2023-10-17,136,77,59,0,77,0,0,0.0
2023-10-18,256,151,105,0,151,0,0,0.0
2023-10-19,120,51,69,1,50,1,1,3.4785714285727636
2023-10-20,182,86,96,0,86,0,0,0.0
2023-10-22,14,12,2,0,12,0,0,0.0
2023-10-23,232,148,84,0,148,0,0,0.0
2023-10-24,221,132,89,0,132,0,0,0.0
2023-10-25,206,138,68,0,138,0,0,0.0
2023-10-26,229,132,97,0,132,0,0,0.0
2023-10-27,221,129,92,0,129,0,0,0.0
2023-10-29,29,12,17,0,12,0,0,0.0
2023-10-30,214,142,72,0,142,0,0,0.0
2023-10-31,194,80,114,1,79,1,1,5.9928571428595205
2023-11-01,174,59,115,1,58,1,1,7.0785714285729
2023-11-02,162,58,104,1,57,1,1,6.564285714287166
2023-11-03,157,69,88,0,69,0,0,0.0
2023-11-05,13,0,13,0,0,0,0,0.0
2023-11-06,132,26,106,1,25,1,0,-1.8628571428540681
2023-11-07,185,96,89,0,96,0,0,0.0
2023-11-08,156,55,101,1,54,1,1,1.5714285714291236
2023-11-09,175,115,60,0,115,0,0,0.0
2023-11-10,229,151,78,0,151,0,0,0.0
2023-11-12,18,0,18,0,0,0,0,0.0
2023-11-13,216,119,97,0,119,0,0,0.0
2023-11-14,210,134,76,0,134,0,0,0.0
2023-11-15,164,65,99,1,64,1,1,10.985714285714721
2023-11-16,210,156,54,0,156,0,0,0.0
2023-11-17,33,4,29,2,2,2,2,2.2828888144877055
2023-11-19,17,0,17,0,0,0,0,0.0
2023-11-20,103,2,101,2,0,2,0,-9.76285714286098
2023-11-21,146,37,109,2,35,2,2,12.728571428572423
2023-11-22,111,16,95,2,14,2,1,5.121428571429988
2023-11-23,128,20,108,2,18,2,1,-2.3599999999968304
2023-11-24,177,103,74,0,103,0,0,0.0
2023-11-26,12,0,12,0,0,0,0,0.0
2023-11-27,163,57,106,1,56,1,1,5.564285714288076
2023-11-28,116,8,108,2,6,2,2,12.400000000004297
2023-11-29,119,7,112,2,5,2,1,4.042857142859702
2023-11-30,91,4,87,2,2,2,0,-9.337142857141089
2023-12-01,101,5,96,2,3,2,1,6.721428571429101
2023-12-03,13,0,13,0,0,0,0,0.0
2023-12-04,155,56,99,1,55,1,0,-5.739999999997735
2023-12-05,150,68,82,1,67,1,0,-7.12285714285531
2023-12-06,192,99,93,0,99,0,0,0.0
2023-12-07,117,3,114,2,1,2,0,-13.70285714285535
2023-12-08,98,2,96,2,0,2,1,5.56571428571624
2023-12-10,6,0,6,0,0,0,0,0.0
2023-12-11,118,9,109,2,7,2,1,-0.5285714285699896
2023-12-12,153,43,110,1,42,1,1,12.778571428571695
2023-12-13,142,39,103,1,38,1,1,8.692857142858202
2023-12-14,151,41,110,1,40,1,1,4.257570281120138
2023-12-15,145,52,93,1,51,1,0,-3.542857142855837
2023-12-17,18,0,18,0,0,0,0,0.0
2023-12-18,153,44,109,1,43,1,0,-3.4257142857147755
2023-12-19,170,55,115,1,54,1,0,-6.7257142857134795
2023-12-20,169,63,106,1,62,1,0,-4.9399999999996
2023-12-21,147,53,94,1,52,1,1,9.821428571430147
2023-12-22,145,55,90,1,54,1,0,-3.4486815893051244
2023-12-24,0,0,0,0,0,0,0,0.0
2023-12-25,91,0,91,0,0,0,0,0.0
2023-12-26,123,51,72,1,50,1,0,-3.8628571428550913
2023-12-27,106,2,104,1,1,1,0,-3.488571428571163
2023-12-28,131,25,106,1,24,1,1,5.428571428572127
2023-12-29,151,69,82,1,68,1,1,8.121428571430556
2024-01-01,12,0,12,0,0,0,0,0.0
2024-01-02,158,48,110,1,47,1,0,-5.197142857142467
2024-01-03,135,50,85,1,49,1,1,5.942857142857861
2024-01-04,181,71,110,1,70,1,1,6.621428571429078
2024-01-05,149,53,96,1,52,1,1,11.364285714287348
2024-01-07,12,0,12,0,0,0,0,0.0
2024-01-08,97,33,64,1,32,1,0,-4.988571428569799
2024-01-09,151,39,112,1,38,1,1,8.000000000000796
2024-01-10,147,45,102,1,44,1,0,-5.117142857142653
2024-01-11,137,24,113,1,23,1,0,1.8046939762423335
2024-01-12,131,35,96,1,34,1,1,9.21428571428703
2024-01-14,16,0,16,0,0,0,0,0.0
2024-01-15,165,54,111,1,53,1,1,3.7571428571449133
2024-01-16,170,56,114,1,55,1,1,0.8029905440305356
2024-01-17,129,33,96,1,32,1,1,0.3500184181542636
2024-01-18,130,35,95,1,34,1,0,-3.1971428571442857
2024-01-19,145,50,95,1,49,1,0,-4.934285714285124
2024-01-21,1,0,1,0,0,0,0,0.0
2024-01-22,111,42,69,1,41,1,0,-4.919999999998936
2024-01-23,137,47,90,1,46,1,0,-3.7457142857140298
2024-01-24,158,51,107,1,50,1,0,-5.871428571427828
2024-01-25,159,51,108,1,50,1,1,8.742857142859862
2024-01-26,113,43,70,1,42,1,1,7.128571428571718
2024-01-28,15,0,15,0,0,0,0,0.0
2024-01-29,141,31,110,1,30,1,1,4.350000000001842
2024-01-30,110,7,103,1,6,1,0,-4.302857142855487
2024-01-31,161,55,106,1,54,1,0,0.181575220349373
2024-02-01,131,32,99,1,31,1,1,7.035714285714334
2024-02-02,78,45,33,1,44,1,1,2.166864961599913
2024-02-04,12,0,12,0,0,0,0,0.0
2024-02-05,79,18,61,1,17,1,0,-4.325714285713389
2024-02-06,158,48,110,1,47,1,0,-4.122857142855196
2024-02-07,151,52,99,1,51,1,0,-5.417142857141243
2024-02-08,142,42,100,1,41,1,1,7.721428571428646
2024-02-09,109,22,87,1,21,1,0,-4.908571428569985
2024-02-11,12,0,12,0,0,0,0,0.0
2024-02-12,126,41,85,1,40,1,1,2.450000000001296
2024-02-13,145,39,106,1,38,1,1,10.435714285716358
2024-02-14,173,62,111,1,61,1,1,3.957142857145868
2024-02-15,132,24,108,1,23,1,0,-2.04024430929951
2024-02-16,120,24,96,1,23,1,1,3.842857142859202
2024-02-18,3,0,3,0,0,0,0,0.0
2024-02-19,209,102,107,0,102,0,0,0.0
2024-02-20,157,51,106,1,50,1,1,-0.37868067804868133
2024-02-21,144,53,91,1,52,1,0,-3.7971428571414663
2024-02-22,148,54,94,1,53,1,1,3.057142857144413
2024-02-23,126,53,73,1,52,1,0,-4.01142857142861
2024-02-25,11,0,11,0,0,0,0,0.0
2024-02-26,81,57,24,1,56,1,0,-2.3628571428564555
2024-02-27,143,40,103,1,39,1,0,-4.545714285712165
2024-02-28,188,82,106,0,82,0,0,0.0
2024-02-29,161,53,108,1,52,1,1,5.364285714287121
2024-03-01,145,49,96,1,48,1,0,-3.480000000002292
2024-03-03,15,0,15,0,0,0,0,0.0
2024-03-04,153,51,102,1,50,1,0,-4.125714285712434
2024-03-05,84,6,78,1,5,1,1,3.7428571428587247
2024-03-06,152,50,102,1,49,1,0,-2.7999999999996135
2024-03-07,148,34,114,1,33,1,0,-6.534285714284238
2024-03-08,142,54,88,1,53,1,1,14.050000000002683
2024-03-10,12,0,12,0,0,0,0,0.0
2024-03-11,117,45,72,1,44,1,0,-3.2371428571427714
2024-03-12,121,20,101,1,19,1,0,-9.968571428573114
2024-03-13,183,86,97,1,85,1,1,3.6500000000013415
2024-03-14,145,33,112,1,32,1,0,-8.359999999999445
2024-03-15,113,20,93,1,19,1,0,-3.3314285714287735
2024-03-17,1,0,1,0,0,0,0,0.0
2024-03-18,170,73,97,1,72,1,1,3.778571428571354
2024-03-19,201,93,108,1,92,1,1,1.6857142857157896
2024-03-20,184,70,114,1,69,1,1,3.0428571428582245
2024-03-21,143,37,106,1,36,1,0,-4.9999999999987494
2024-03-22,149,53,96,1,52,1,0,-4.419999999999391
2024-03-24,14,0,14,0,0,0,0,0.0
2024-03-25,143,46,97,1,45,1,1,2.2857142857158124
2024-03-26,221,123,98,0,123,0,0,0.0
2024-03-27,227,125,102,0,125,0,0,0.0
2024-03-28,101,50,51,1,49,1,1,1.2571428571443448
2024-03-29,127,43,84,1,42,1,0,-2.9142857142834373
2024-03-31,17,0,17,0,0,0,0,0.0
2024-04-01,244,148,96,0,148,0,0,0.0
2024-04-02,196,97,99,0,97,0,0,0.0
2024-04-03,233,152,81,0,152,0,0,0.0
2024-04-04,188,102,86,0,102,0,0,0.0
2024-04-05,103,37,66,1,36,1,0,-4.399999999998727
2024-04-07,0,0,0,0,0,0,0,0.0
2024-04-08,198,98,100,0,98,0,0,0.0
2024-04-09,234,137,97,0,137,0,0,0.0
2024-04-10,106,37,69,1,36,1,0,-7.065714285713398
2024-04-11,118,36,82,1,35,1,0,-5.137142857143317
2024-04-12,122,52,70,1,51,1,0,-5.102857142856465
2024-04-14,11,0,11,0,0,0,0,0.0
2024-04-15,109,11,98,1,10,1,0,-4.891428571429401
2024-04-16,183,85,98,1,84,1,1,1.6285714285738777
2024-04-17,203,117,86,0,117,0,0,0.0
2024-04-18,184,97,87,1,96,1,1,0.6428571428581336
2024-04-19,164,74,90,0,74,0,0,0.0
2024-04-21,5,5,0,1,4,1,1,3.778571428574196
2024-04-22,116,57,59,1,56,1,0,-1.9571428571400702
2024-04-23,206,111,95,0,111,0,0,0.0
2024-04-24,231,136,95,0,136,0,0,0.0
2024-04-25,144,43,101,0,43,0,0,0.0
2024-04-26,180,96,84,1,95,1,1,1.3714285714310108
2024-04-28,0,0,0,0,0,0,0,0.0
2024-04-29,111,22,89,1,21,1,0,-3.6142857142867797
2024-04-30,128,32,96,1,31,1,0,-4.200000000000614
2024-05-01,118,19,99,1,18,1,0,-2.5314285714277958
2024-05-02,162,54,108,1,53,1,0,-5.728571428571627
2024-05-03,148,52,96,1,51,1,0,-13.122857142855537
2024-05-05,18,0,18,0,0,0,0,0.0
2024-05-06,158,44,114,1,43,1,0,-3.5028571428573514
2024-05-07,179,67,112,1,66,1,0,-4.440000000000055
2024-05-08,151,38,113,1,37,1,0,-4.148571428570335
2024-05-09,161,70,91,1,69,1,0,-4.277142857140348
2024-05-10,172,77,95,0,77,0,0,0.0
2024-05-12,19,1,18,0,1,0,0,0.0
2024-05-13,220,109,111,0,109,0,0,0.0
2024-05-14,133,28,105,0,28,0,0,0.0
2024-05-15,245,148,97,1,147,1,1,3.1000000000001364
2024-05-16,133,22,111,1,21,1,0,-7.125714285712547
2024-05-17,156,60,96,1,59,1,1,3.121428571429419
2024-05-19,19,0,19,0,0,0,0,0.0
2024-05-20,138,31,107,1,30,1,0,-4.77142857142826
2024-05-21,187,74,113,0,74,0,0,0.0
2024-05-22,191,92,99,0,92,0,0,0.0
2024-05-23,207,149,58,0,149,0,0,0.0
2024-05-24,229,134,95,0,134,0,0,0.0
2024-05-26,14,12,2,0,12,0,0,0.0
2024-05-27,199,126,73,0,126,0,0,0.0
2024-05-28,247,150,97,0,150,0,0,0.0
2024-05-29,233,137,96,0,137,0,0,0.0
2024-05-30,226,120,106,0,120,0,0,0.0
2024-05-31,196,119,77,0,119,0,0,0.0
2024-06-02,17,12,5,0,12,0,0,0.0
2024-06-03,122,50,72,1,49,1,0,-3.0171428571439947
2024-06-04,178,72,106,1,71,1,1,7.192857142859566
2024-06-05,173,63,110,1,62,1,0,-1.733777292151217
2024-06-06,172,67,105,1,66,1,1,5.214285714287826
2024-06-07,142,47,95,1,46,1,1,7.35714285714505
2024-06-09,1,0,1,0,0,0,0,0.0
2024-06-10,190,95,95,0,95,0,0,0.0
2024-06-11,255,141,114,0,141,0,0,0.0
2024-06-12,182,64,118,1,63,1,1,4.700000000002092
2024-06-13,164,52,112,1,51,1,1,3.985714285715403
2024-06-14,167,71,96,0,71,0,0,0.0
2024-06-16,20,4,16,1,3,1,0,-4.442857142857292
2024-06-17,62,36,26,1,35,1,0,-4.242857142856337
2024-06-18,130,44,86,0,44,0,0,0.0
2024-06-19,210,141,69,0,141,0,0,0.0
2024-06-20,229,127,102,0,127,0,0,0.0
2024-06-21,221,139,82,0,139,0,0,0.0
2024-06-23,25,12,13,0,12,0,0,0.0
2024-06-24,203,151,52,0,151,0,0,0.0
2024-06-25,193,88,105,0,88,0,0,0.0
2024-06-26,257,150,107,0,150,0,0,0.0
2024-06-27,256,151,105,0,151,0,0,0.0
2024-06-28,177,82,95,1,81,1,1,2.7000000000010687
2024-06-30,7,0,7,0,0,0,0,0.0
2024-07-01,119,45,74,1,44,1,0,-4.454285714283401
2024-07-02,155,43,112,1,42,1,1,2.907142857145118
2024-07-03,216,110,106,0,110,0,0,0.0
2024-07-04,148,45,103,1,44,1,0,-2.140000000000441
2024-07-05,164,68,96,1,67,1,0,-4.87714285714037
2024-07-07,7,0,7,0,0,0,0,0.0
2024-07-08,174,69,105,1,68,1,0,-4.319999999998913
2024-07-09,265,152,113,0,152,0,0,0.0
2024-07-10,229,127,102,0,127,0,0,0.0
2024-07-11,148,46,102,1,45,1,0,-32.2314285714275
2024-07-12,76,36,40,0,36,0,0,0.0
2024-07-14,16,0,16,0,0,0,0,0.0
2024-07-15,96,40,56,1,39,1,0,-4.559999999998354
2024-07-16,243,146,97,0,146,0,0,0.0
2024-07-17,224,128,96,0,128,0,0,0.0
2024-07-18,146,56,90,1,55,1,1,7.0928571428590885
2024-07-19,155,60,95,1,59,1,1,4.47142857142876
2024-07-21,16,0,16,0,0,0,0,0.0
2024-07-22,122,44,78,1,43,1,0,-4.031428571429274
2024-07-23,146,35,111,1,34,1,0,-4.114285714283483
2024-07-24,177,76,101,1,75,1,1,12.528571428571922
2024-07-25,153,42,111,1,41,1,0,-13.171428571428578
2024-07-26,146,50,96,1,49,1,1,20.757142857143663
2024-07-28,16,0,16,0,0,0,0,0.0
2024-07-29,120,11,109,1,10,1,0,-4.14285714285586
2024-07-30,128,22,106,1,21,1,1,3.633619606758998
2024-07-31,115,8,107,1,7,1,1,16.507142857144686
2024-08-01,146,44,102,1,43,1,1,15.071428571431056
2024-08-02,107,35,72,1,34,1,0,-19.46571428571292
2024-08-04,9,0,9,0,0,0,0,0.0
2024-08-05,163,50,113,1,49,1,0,-13.245714285713916
2024-08-06,103,5,98,1,4,1,0,-11.365714285714034
2024-08-07,159,53,106,1,52,1,0,-6.182857142858211
2024-08-08,143,55,88,1,54,1,0,-11.848571428570153
2024-08-09,107,18,89,1,17,1,0,-5.69999999999925
2024-08-11,13,0,13,0,0,0,0,0.0
2024-08-12,103,38,65,1,37,1,0,-5.828571428569262
2024-08-13,210,99,111,0,99,0,0,0.0
2024-08-14,167,55,112,1,54,1,0,-9.671428571426077
2024-08-15,132,44,88,0,44,0,0,0.0
2024-08-16,141,57,84,1,56,1,0,-7.482857142855892
2024-08-18,12,0,12,0,0,0,0,0.0
2024-08-19,130,30,100,1,29,1,0,-6.9428571428550185
2024-08-20,224,115,109,0,115,0,0,0.0
2024-08-21,138,34,104,1,33,1,1,16.914285714286848
2024-08-22,156,53,103,1,52,1,0,-7.717142857140857
2024-08-23,167,72,95,1,71,1,1,23.321428571429237
2024-08-25,16,0,16,0,0,0,0,0.0
2024-08-26,148,45,103,1,44,1,0,-5.148571428572268
2024-08-27,162,64,98,1,63,1,0,-6.871428571426918
2024-08-28,243,138,105,0,138,0,0,0.0
2024-08-29,215,121,94,0,121,0,0,0.0
2024-08-30,212,135,77,0,135,0,0,0.0
2024-09-01,30,11,19,0,11,0,0,0.0
2024-09-02,177,115,62,0,115,0,0,0.0
2024-09-03,171,56,115,0,56,0,0,0.0
2024-09-04,124,35,89,1,34,1,1,14.107142857144595
2024-09-05,151,50,101,1,49,1,1,12.071428571430943
2024-09-06,163,67,96,1,66,1,1,28.871428571428737
2024-09-08,10,0,10,0,0,0,0,0.0
2024-09-09,160,52,108,1,51,1,0,-4.739999999998645
2024-09-10,156,56,100,1,55,1,0,-5.634285714285625
2024-09-11,161,47,114,1,46,1,1,13.3285714285729
2024-09-12,155,47,108,1,46,1,0,-7.774285714285611
2024-09-13,104,8,96,1,7,1,0,-7.959999999997535
2024-09-15,11,0,11,0,0,0,0,0.0
2024-09-16,121,41,80,1,40,1,0,-6.877142857144236
2024-09-17,143,36,107,1,35,1,1,13.13571428571504
2024-09-18,166,52,114,1,51,1,0,-6.237142857142885
2024-09-19,150,37,113,1,36,1,0,-9.851428571426368
2024-09-20,215,119,96,0,119,0,0,0.0
2024-09-22,12,2,10,0,2,0,0,0.0
2024-09-23,137,34,103,1,33,1,1,14.578571428574605
2024-09-24,155,53,102,1,52,1,1,12.014285714286189
2024-09-25,153,50,103,1,49,1,0,-5.871428571427828
2024-09-26,174,67,107,1,66,1,1,11.89285714285927
2024-09-27,110,14,96,1,13,1,0,-8.328571428572673
2024-09-29,19,0,19,0,0,0,0,0.0
2024-09-30,127,50,77,1,49,1,0,-4.608571428568553
2024-10-01,156,47,109,1,46,1,1,12.614285714286211
2024-10-02,177,75,102,1,74,1,1,11.035714285713539
2024-10-03,157,62,95,1,61,1,1,2.445636129723539
2024-10-04,163,69,94,1,68,1,0,-5.2657142857133294
2024-10-06,0,0,0,0,0,0,0,0.0
2024-10-07,159,44,115,1,43,1,0,-7.0114285714287234
2024-10-08,167,62,105,1,61,1,1,7.9642857142853245
2024-10-09,232,144,88,0,144,0,0,0.0
2024-10-10,133,57,76,1,56,1,1,0.8731908915985969
2024-10-11,162,70,92,1,69,1,0,-4.4114285714276775
2024-10-13,17,0,17,0,0,0,0,0.0
2024-10-14,163,100,63,0,100,0,0,0.0
2024-10-15,211,101,110,0,101,0,0,0.0
2024-10-16,233,130,103,0,130,0,0,0.0
2024-10-17,255,152,103,0,152,0,0,0.0
2024-10-18,231,135,96,0,135,0,0,0.0
2024-10-20,18,12,6,0,12,0,0,0.0
2024-10-21,258,153,105,0,153,0,0,0.0
2024-10-22,120,17,103,1,16,1,0,-3.185714285715335
2024-10-23,226,123,103,0,123,0,0,0.0
2024-10-24,180,72,108,1,71,1,0,-5.457142857142571
2024-10-25,184,94,90,0,94,0,0,0.0
2024-10-27,1,1,0,1,0,1,1,8.564285714285347
2024-10-28,153,53,100,1,52,1,0,-4.025714285714798
2024-10-29,196,81,115,1,80,1,1,7.9928571428577015
2024-10-30,133,64,69,1,63,1,1,5.414285714288781
2024-10-31,196,85,111,1,84,1,1,12.092857142857383
2024-11-01,144,50,94,1,49,1,1,15.478571428573218
2024-11-03,4,0,4,0,0,0,0,0.0
2024-11-04,159,50,109,1,49,1,0,-5.1314285714259995
2024-11-05,180,69,111,1,68,1,1,9.992857142858725
2024-11-06,144,36,108,1,35,1,0,-5.779999999999063
2024-11-07,137,32,105,1,31,1,1,8.307142857145323
2024-11-08,151,69,82,1,68,1,0,-4.565714285712829
2024-11-10,18,0,18,0,0,0,0,0.0
2024-11-11,141,27,114,1,26,1,0,-3.431428571426409
2024-11-12,190,81,109,1,80,1,1,5.842857142860225
2024-11-13,178,79,99,1,78,1,0,-7.177142857142826
2024-11-14,173,60,113,1,59,1,0,-6.494285714285752
2024-11-15,168,72,96,1,71,1,0,-8.237142857141066
2024-11-17,16,0,16,0,0,0,0,0.0
2024-11-18,141,45,96,1,44,1,0,-5.677142857141348
2024-11-19,184,77,107,1,76,1,0,-7.365714285711988
2024-11-20,171,63,108,1,62,1,1,13.507142857144572
2024-11-21,164,56,108,1,55,1,0,-7.185714285711697
2024-11-22,134,56,78,1,55,1,0,-5.6914285714275366
2024-11-24,4,0,4,0,0,0,0,0.0
2024-11-25,130,46,84,1,45,1,0,-6.908571428571008
2024-11-26,191,86,105,0,86,0,0,0.0
2024-11-27,166,53,113,1,52,1,0,-8.782857142856415
2024-11-28,246,137,109,0,137,0,0,0.0
2024-11-29,215,119,96,0,119,0,0,0.0
2024-12-01,16,0,16,0,0,0,0,0.0
2024-12-02,254,143,111,0,143,0,0,0.0
2024-12-03,172,59,113,1,58,1,1,16.98571428571495
2024-12-04,184,72,112,1,71,1,1,11.442857142858543
2024-12-05,172,57,115,1,56,1,1,8.399999999999864
2024-12-06,162,80,82,1,79,1,1,15.964285714286575
2024-12-08,0,0,0,0,0,0,0,0.0
2024-12-09,82,30,52,1,29,1,0,-3.6457142857135523
2024-12-10,123,34,89,1,33,1,0,-5.5971428571415345
2024-12-11,193,89,104,1,88,1,1,6.835714285716222
2024-12-12,133,50,83,1,49,1,1,11.871428571429988
2024-12-13,176,80,96,1,79,1,1,5.478571428573787
2024-12-15,15,0,15,0,0,0,0,0.0
2024-12-16,152,59,93,1,58,1,1,3.2714285714315565
2024-12-17,185,91,94,1,90,1,1,5.728571428573559
2024-12-18,120,44,76,1,43,1,0,-4.459999999997876
2024-12-19,167,54,113,1,53,1,0,-5.882857142856778
2024-12-20,142,47,95,1,46,1,1,9.535714285714903
2024-12-22,13,0,13,0,0,0,0,0.0
2024-12-23,125,29,96,1,28,1,0,-4.171428571428237
2024-12-24,175,105,70,1,104,1,0,-4.262857142857001
2024-12-25,119,0,119,0,0,0,0,0.0
2024-12-26,265,156,109,0,156,0,0,0.0
2024-12-27,143,47,96,1,46,1,0,-4.397142857141489
2024-12-29,12,0,12,0,0,0,0,0.0
2024-12-30,159,51,108,1,50,1,1,4.414285714286848
2024-12-31,177,81,96,1,80,1,1,6.700000000003115
