date,breakouts,gate_pass,gate_block,ev_pass,ev_reject,fills,wins,pnl_pips
2018-01-01,10,0,10,0,0,0,0,0.0
2018-01-02,213,111,102,1,100,11,10,-2.3342857142843627
2018-01-03,204,147,57,0,147,0,0,0.0
2018-01-04,218,105,113,0,105,0,0,0.0
2018-01-05,248,152,96,0,152,0,0,0.0
2018-01-07,12,0,12,0,0,0,0,0.0
2018-01-08,235,147,88,0,147,0,0,0.0
2018-01-09,239,131,108,0,131,0,0,0.0
2018-01-10,193,88,105,1,87,1,0,-3.0571428571439014
2018-01-11,208,104,104,1,103,1,0,-3.905714285715078
2018-01-12,218,161,57,0,161,0,0,0.0
2018-01-14,17,0,17,0,0,0,0,0.0
2018-01-15,252,145,107,0,145,0,0,0.0
2018-01-16,212,95,117,0,95,0,0,0.0
2018-01-17,231,126,105,0,126,0,0,0.0
2018-01-18,217,132,85,0,132,0,0,0.0
2018-01-19,160,71,89,0,71,0,0,0.0
2018-01-21,12,0,12,0,0,0,0,0.0
2018-01-22,262,149,113,0,149,0,0,0.0
2018-01-23,206,103,103,1,102,1,0,-4.617142857143108
2018-01-24,256,149,107,0,149,0,0,0.0
2018-01-25,215,104,111,1,103,1,0,-4.51714285714263
2018-01-26,226,146,80,0,146,0,0,0.0
2018-01-28,13,0,13,0,0,0,0,0.0
2018-01-29,252,155,97,0,155,0,0,0.0
2018-01-30,249,151,98,0,151,0,0,0.0
2018-01-31,237,140,97,0,140,0,0,0.0
2018-02-01,256,143,113,0,143,0,0,0.0
2018-02-02,247,153,94,0,153,0,0,0.0
2018-02-04,20,0,20,0,0,0,0,0.0
2018-02-05,218,106,112,0,106,0,0,0.0
2018-02-06,211,98,113,0,98,0,0,0.0
2018-02-07,261,157,104,0,157,0,0,0.0
2018-02-08,232,161,71,0,161,0,0,0.0
2018-02-09,242,148,94,0,148,0,0,0.0
2018-02-11,15,0,15,0,0,0,0,0.0
2018-02-12,249,136,113,0,136,0,0,0.0
2018-02-13,237,129,108,0,129,0,0,0.0
2018-02-14,251,145,106,0,145,0,0,0.0
2018-02-15,246,135,111,0,135,0,0,0.0
2018-02-16,211,118,93,0,118,0,0,0.0
2018-02-18,20,0,20,0,0,0,0,0.0
2018-02-19,245,139,106,0,139,0,0,0.0
2018-02-20,249,138,111,0,138,0,0,0.0
2018-02-21,264,155,109,0,155,0,0,0.0
2018-02-22,263,147,116,0,147,0,0,0.0
2018-02-23,239,143,96,0,143,0,0,0.0
2018-02-25,6,0,6,0,0,0,0,0.0
2018-02-26,235,122,113,0,122,0,0,0.0
2018-02-27,226,116,110,0,116,0,0,0.0
2018-02-28,235,130,105,0,130,0,0,0.0
2018-03-01,265,154,111,0,154,0,0,0.0
2018-03-02,242,149,93,0,149,0,0,0.0
2018-03-04,6,0,6,0,0,0,0,0.0
2018-03-05,188,158,30,0,158,0,0,0.0
2018-03-06,238,125,113,0,125,0,0,0.0
2018-03-07,230,119,111,0,119,0,0,0.0
2018-03-08,228,120,108,0,120,0,0,0.0
2018-03-09,223,121,102,0,121,0,0,0.0
2018-03-11,30,12,18,0,12,0,0,0.0
2018-03-12,227,113,114,0,113,0,0,0.0
2018-03-13,256,146,110,0,146,0,0,0.0
2018-03-14,244,151,93,0,151,0,0,0.0
2018-03-15,254,149,105,0,149,0,0,0.0
2018-03-16,219,123,96,0,123,0,0,0.0
2018-03-18,27,12,15,0,12,0,0,0.0
2018-03-19,263,151,112,0,151,0,0,0.0
2018-03-20,212,105,107,0,105,0,0,0.0
2018-03-21,254,139,115,0,139,0,0,0.0
2018-03-22,247,130,117,0,130,0,0,0.0
2018-03-23,221,125,96,0,125,0,0,0.0
2018-03-25,27,12,15,0,12,0,0,0.0
2018-03-26,214,111,103,0,111,0,0,0.0
2018-03-27,256,147,109,0,147,0,0,0.0
2018-03-28,262,158,104,0,158,0,0,0.0
2018-03-29,252,147,105,0,147,0,0,0.0
2018-03-30,165,70,95,0,70,0,0,0.0
2018-04-01,8,6,2,0,6,0,0,0.0
2018-04-02,185,156,29,0,156,0,0,0.0
2018-04-03,254,140,114,0,140,0,0,0.0
2018-04-04,214,119,95,0,119,0,0,0.0
2018-04-05,270,156,114,0,156,0,0,0.0
2018-04-06,204,109,95,0,109,0,0,0.0
2018-04-08,20,12,8,0,12,0,0,0.0
2018-04-09,192,130,62,0,130,0,0,0.0
2018-04-10,256,146,110,0,146,0,0,0.0
2018-04-11,217,102,115,0,102,0,0,0.0
2018-04-12,231,116,115,0,116,0,0,0.0
2018-04-13,242,146,96,0,146,0,0,0.0
2018-04-15,18,12,6,0,12,0,0,0.0
2018-04-16,238,128,110,0,128,0,0,0.0
2018-04-17,259,146,113,0,146,0,0,0.0
2018-04-18,261,145,116,0,145,0,0,0.0
2018-04-19,230,125,105,0,125,0,0,0.0
2018-04-20,237,142,95,0,142,0,0,0.0
2018-04-22,22,12,10,0,12,0,0,0.0
2018-04-23,262,160,102,0,160,0,0,0.0
2018-04-24,241,141,100,0,141,0,0,0.0
2018-04-25,250,157,93,0,157,0,0,0.0
2018-04-26,252,146,106,0,146,0,0,0.0
2018-04-27,198,103,95,0,103,0,0,0.0
2018-04-29,32,12,20,0,12,0,0,0.0
2018-04-30,196,106,90,0,106,0,0,0.0
2018-05-01,262,148,114,0,148,0,0,0.0
2018-05-02,270,158,112,0,158,0,0,0.0
2018-05-03,270,155,115,0,155,0,0,0.0
2018-05-04,218,122,96,0,122,0,0,0.0
2018-05-06,26,12,14,0,12,0,0,0.0
2018-05-07,262,155,107,0,155,0,0,0.0
2018-05-08,213,112,101,0,112,0,0,0.0
2018-05-09,227,121,106,0,121,0,0,0.0
2018-05-10,223,111,112,0,111,0,0,0.0
2018-05-11,231,136,95,0,136,0,0,0.0
2018-05-13,13,12,1,0,12,0,0,0.0
2018-05-14,196,122,74,0,122,0,0,0.0
2018-05-15,255,140,115,0,140,0,0,0.0
2018-05-16,253,146,107,0,146,0,0,0.0
2018-05-17,201,99,102,0,99,0,0,0.0
2018-05-18,237,141,96,0,141,0,0,0.0
2018-05-20,16,12,4,0,12,0,0,0.0
2018-05-21,267,152,115,0,152,0,0,0.0
2018-05-22,205,105,100,0,105,0,0,0.0
2018-05-23,220,121,99,0,121,0,0,0.0
2018-05-24,272,155,117,0,155,0,0,0.0
2018-05-25,208,112,96,0,112,0,0,0.0
2018-05-27,20,12,8,0,12,0,0,0.0
2018-05-28,250,144,106,0,144,0,0,0.0
2018-05-29,263,146,117,0,146,0,0,0.0
2018-05-30,202,91,111,0,91,0,0,0.0
2018-05-31,207,95,112,0,95,0,0,0.0
2018-06-01,235,140,95,0,140,0,0,0.0
2018-06-03,16,12,4,0,12,0,0,0.0
2018-06-04,242,126,116,0,126,0,0,0.0
2018-06-05,234,120,114,0,120,0,0,0.0
2018-06-06,261,154,107,0,154,0,0,0.0
2018-06-07,268,157,111,0,157,0,0,0.0
2018-06-08,218,125,93,0,125,0,0,0.0
2018-06-10,18,12,6,0,12,0,0,0.0
2018-06-11,238,137,101,0,137,0,0,0.0
2018-06-12,273,156,117,0,156,0,0,0.0
2018-06-13,253,154,99,0,154,0,0,0.0
2018-06-14,198,124,74,0,124,0,0,0.0
2018-06-15,215,120,95,0,120,0,0,0.0
2018-06-17,23,12,11,0,12,0,0,0.0
2018-06-18,211,101,110,0,101,0,0,0.0
2018-06-19,260,152,108,0,152,0,0,0.0
2018-06-20,263,147,116,0,147,0,0,0.0
2018-06-21,257,152,105,0,152,0,0,0.0
2018-06-22,205,110,95,0,110,0,0,0.0
2018-06-24,21,12,9,0,12,0,0,0.0
2018-06-25,245,130,115,0,130,0,0,0.0
2018-06-26,256,149,107,0,149,0,0,0.0
2018-06-27,228,126,102,0,126,0,0,0.0
2018-06-28,262,157,105,0,157,0,0,0.0
2018-06-29,224,129,95,0,129,0,0,0.0
2018-07-01,22,12,10,0,12,0,0,0.0
2018-07-02,184,86,98,0,86,0,0,0.0
2018-07-03,266,152,114,0,152,0,0,0.0
2018-07-04,201,101,100,0,101,0,0,0.0
2018-07-05,220,124,96,0,124,0,0,0.0
2018-07-06,183,115,68,0,115,0,0,0.0
2018-07-08,18,12,6,0,12,0,0,0.0
2018-07-09,203,141,62,0,141,0,0,0.0
2018-07-10,272,157,115,0,157,0,0,0.0
2018-07-11,248,158,90,0,158,0,0,0.0
2018-07-12,205,90,115,0,90,0,0,0.0
2018-07-13,233,137,96,0,137,0,0,0.0
2018-07-15,25,12,13,0,12,0,0,0.0
2018-07-16,240,143,97,0,143,0,0,0.0
2018-07-17,268,153,115,0,153,0,0,0.0
2018-07-18,223,123,100,0,123,0,0,0.0
2018-07-19,238,130,108,0,130,0,0,0.0
2018-07-20,218,123,95,0,123,0,0,0.0
2018-07-22,31,12,19,0,12,0,0,0.0
2018-07-23,261,147,114,0,147,0,0,0.0
2018-07-24,237,147,90,0,147,0,0,0.0
2018-07-25,212,121,91,0,121,0,0,0.0
2018-07-26,257,154,103,0,154,0,0,0.0
2018-07-27,211,115,96,0,115,0,0,0.0
2018-07-29,20,12,8,0,12,0,0,0.0
2018-07-30,227,112,115,0,112,0,0,0.0
2018-07-31,244,132,112,0,132,0,0,0.0
2018-08-01,258,155,103,0,155,0,0,0.0
2018-08-02,259,155,104,0,155,0,0,0.0
2018-08-03,209,122,87,0,122,0,0,0.0
2018-08-05,13,12,1,0,12,0,0,0.0
2018-08-06,232,131,101,0,131,0,0,0.0
2018-08-07,277,161,116,0,161,0,0,0.0
2018-08-08,262,154,108,0,154,0,0,0.0
2018-08-09,261,147,114,0,147,0,0,0.0
2018-08-10,246,150,96,0,150,0,0,0.0
2018-08-12,13,12,1,0,12,0,0,0.0
2018-08-13,241,143,98,0,143,0,0,0.0
2018-08-14,259,160,99,0,160,0,0,0.0
2018-08-15,256,140,116,0,140,0,0,0.0
2018-08-16,249,140,109,0,140,0,0,0.0
2018-08-17,212,116,96,0,116,0,0,0.0
2018-08-19,19,12,7,0,12,0,0,0.0
2018-08-20,221,123,98,0,123,0,0,0.0
2018-08-21,264,156,108,0,156,0,0,0.0
2018-08-22,255,156,99,0,156,0,0,0.0
2018-08-23,245,144,101,0,144,0,0,0.0
2018-08-24,200,134,66,0,134,0,0,0.0
2018-08-26,20,12,8,0,12,0,0,0.0
2018-08-27,261,153,108,0,153,0,0,0.0
2018-08-28,251,145,106,0,145,0,0,0.0
2018-08-29,256,154,102,0,154,0,0,0.0
2018-08-30,253,151,102,0,151,0,0,0.0
2018-08-31,184,118,66,0,118,0,0,0.0
2018-09-02,32,12,20,0,12,0,0,0.0
2018-09-03,256,148,108,0,148,0,0,0.0
2018-09-04,262,152,110,0,152,0,0,0.0
2018-09-05,150,63,87,0,63,0,0,0.0
2018-09-06,243,130,113,0,130,0,0,0.0
2018-09-07,216,120,96,0,120,0,0,0.0
2018-09-09,19,2,17,0,2,0,0,0.0
2018-09-10,209,112,97,0,112,0,0,0.0
2018-09-11,270,158,112,0,158,0,0,0.0
2018-09-12,227,120,107,0,120,0,0,0.0
2018-09-13,263,148,115,0,148,0,0,0.0
2018-09-14,177,85,92,0,85,0,0,0.0
2018-09-16,10,0,10,0,0,0,0,0.0
2018-09-17,190,143,47,0,143,0,0,0.0
2018-09-18,247,143,104,0,143,0,0,0.0
2018-09-19,215,120,95,0,120,0,0,0.0
2018-09-20,226,125,101,0,125,0,0,0.0
2018-09-21,221,128,93,0,128,0,0,0.0
2018-09-23,21,12,9,0,12,0,0,0.0
2018-09-24,226,130,96,0,130,0,0,0.0
2018-09-25,264,155,109,0,155,0,0,0.0
2018-09-26,259,147,112,0,147,0,0,0.0
2018-09-27,267,158,109,0,158,0,0,0.0
2018-09-28,223,128,95,0,128,0,0,0.0
2018-09-30,29,12,17,0,12,0,0,0.0
2018-10-01,251,137,114,0,137,0,0,0.0
2018-10-02,255,153,102,0,153,0,0,0.0
2018-10-03,266,158,108,0,158,0,0,0.0
2018-10-04,251,140,111,0,140,0,0,0.0
2018-10-05,218,140,78,0,140,0,0,0.0
2018-10-07,31,12,19,0,12,0,0,0.0
2018-10-08,264,154,110,0,154,0,0,0.0
2018-10-09,231,126,105,0,126,0,0,0.0
2018-10-10,264,162,102,0,162,0,0,0.0
2018-10-11,201,120,81,0,120,0,0,0.0
2018-10-12,234,138,96,0,138,0,0,0.0
2018-10-14,20,12,8,0,12,0,0,0.0
2018-10-15,234,132,102,0,132,0,0,0.0
2018-10-16,223,111,112,0,111,0,0,0.0
2018-10-17,247,132,115,0,132,0,0,0.0
2018-10-18,262,149,113,0,149,0,0,0.0
2018-10-19,229,133,96,0,133,0,0,0.0
2018-10-21,33,12,21,0,12,0,0,0.0
2018-10-22,251,142,109,0,142,0,0,0.0
2018-10-23,248,144,104,0,144,0,0,0.0
2018-10-24,257,153,104,0,153,0,0,0.0
2018-10-25,227,148,79,0,148,0,0,0.0
2018-10-26,235,142,93,0,142,0,0,0.0
2018-10-28,22,12,10,0,12,0,0,0.0
2018-10-29,198,109,89,0,109,0,0,0.0
2018-10-30,240,124,116,0,124,0,0,0.0
2018-10-31,220,112,108,0,112,0,0,0.0
2018-11-01,254,146,108,0,146,0,0,0.0
2018-11-02,227,131,96,0,131,0,0,0.0
2018-11-04,17,0,17,0,0,0,0,0.0
2018-11-05,221,155,66,0,155,0,0,0.0
2018-11-06,262,151,111,0,151,0,0,0.0
2018-11-07,237,144,93,0,144,0,0,0.0
2018-11-08,248,144,104,0,144,0,0,0.0
2018-11-09,216,120,96,0,120,0,0,0.0
2018-11-11,8,0,8,0,0,0,0,0.0
2018-11-12,232,125,107,0,125,0,0,0.0
2018-11-13,239,136,103,0,136,0,0,0.0
2018-11-14,240,135,105,0,135,0,0,0.0
2018-11-15,226,140,86,0,140,0,0,0.0
2018-11-16,231,147,84,0,147,0,0,0.0
2018-11-18,16,0,16,0,0,0,0,0.0
2018-11-19,212,121,91,0,121,0,0,0.0
2018-11-20,234,139,95,0,139,0,0,0.0
2018-11-21,235,132,103,0,132,0,0,0.0
2018-11-22,151,123,28,0,123,0,0,0.0
2018-11-23,230,152,78,0,152,0,0,0.0
2018-11-25,12,0,12,0,0,0,0,0.0
2018-11-26,252,139,113,0,139,0,0,0.0
2018-11-27,239,138,101,0,138,0,0,0.0
2018-11-28,252,145,107,0,145,0,0,0.0
2018-11-29,249,153,96,0,153,0,0,0.0
2018-11-30,136,136,0,0,136,0,0,0.0
2018-12-02,14,0,14,0,0,0,0,0.0
2018-12-03,244,155,89,0,155,0,0,0.0
2018-12-04,268,156,112,0,156,0,0,0.0
2018-12-05,271,156,115,0,156,0,0,0.0
2018-12-06,275,161,114,0,161,0,0,0.0
2018-12-07,248,154,94,0,154,0,0,0.0
2018-12-09,14,0,14,0,0,0,0,0.0
2018-12-10,263,149,114,0,149,0,0,0.0
2018-12-11,253,143,110,0,143,0,0,0.0
2018-12-12,233,137,96,0,137,0,0,0.0
2018-12-13,239,143,96,0,143,0,0,0.0
2018-12-14,223,151,72,0,151,0,0,0.0
2018-12-16,18,0,18,0,0,0,0,0.0
2018-12-17,254,151,103,0,151,0,0,0.0
2018-12-18,270,159,111,0,159,0,0,0.0
2018-12-19,253,135,118,0,135,0,0,0.0
2018-12-20,256,157,99,0,157,0,0,0.0
2018-12-21,214,137,77,0,137,0,0,0.0
2018-12-23,5,0,5,0,0,0,0,0.0
2018-12-24,149,140,9,0,140,0,0,0.0
2018-12-25,117,0,117,0,0,0,0,0.0
2018-12-26,233,155,78,0,155,0,0,0.0
2018-12-27,232,120,112,0,120,0,0,0.0
2018-12-28,242,147,95,0,147,0,0,0.0
2018-12-30,19,0,19,0,0,0,0,0.0
2018-12-31,244,149,95,0,149,0,0,0.0
2019-01-01,18,0,18,0,0,0,0,0.0
2019-01-02,245,132,113,0,132,0,0,0.0
2019-01-03,167,56,111,0,56,0,0,0.0
2019-01-04,249,153,96,0,153,0,0,0.0
2019-01-06,12,0,12,0,0,0,0,0.0
2019-01-07,243,154,89,0,154,0,0,0.0
2019-01-08,235,126,109,0,126,0,0,0.0
2019-01-09,224,121,103,0,121,0,0,0.0
2019-01-10,262,155,107,0,155,0,0,0.0
2019-01-11,212,127,85,0,127,0,0,0.0
2019-01-13,13,0,13,0,0,0,0,0.0
2019-01-14,251,139,112,0,139,0,0,0.0
2019-01-15,244,147,97,0,147,0,0,0.0
2019-01-16,235,133,102,0,133,0,0,0.0
2019-01-17,226,121,105,0,121,0,0,0.0
2019-01-18,237,142,95,0,142,0,0,0.0
2019-01-20,8,0,8,0,0,0,0,0.0
2019-01-21,216,113,103,0,113,0,0,0.0
2019-01-22,243,145,98,0,145,0,0,0.0
2019-01-23,240,141,99,0,141,0,0,0.0
2019-01-24,252,157,95,0,157,0,0,0.0
2019-01-25,249,154,95,0,154,0,0,0.0
2019-01-27,18,0,18,0,0,0,0,0.0
2019-01-28,251,143,108,0,143,0,0,0.0
2019-01-29,257,160,97,0,160,0,0,0.0
2019-01-30,206,158,48,0,158,0,0,0.0
2019-01-31,260,156,104,0,156,0,0,0.0
2019-02-01,241,153,88,0,153,0,0,0.0
2019-02-03,20,0,20,0,0,0,0,0.0
2019-02-04,250,137,113,0,137,0,0,0.0
2019-02-05,233,139,94,0,139,0,0,0.0
2019-02-06,258,153,105,0,153,0,0,0.0
2019-02-07,245,154,91,0,154,0,0,0.0
2019-02-08,209,146,63,0,146,0,0,0.0
2019-02-10,10,0,10,0,0,0,0,0.0
2019-02-11,253,161,92,0,161,0,0,0.0
2019-02-12,246,144,102,0,144,0,0,0.0
2019-02-13,248,137,111,0,137,0,0,0.0
2019-02-14,260,152,108,0,152,0,0,0.0
2019-02-15,244,160,84,0,160,0,0,0.0
2019-02-17,13,0,13,0,0,0,0,0.0
2019-02-18,254,146,108,0,146,0,0,0.0
2019-02-19,255,160,95,0,160,0,0,0.0
2019-02-20,267,159,108,0,159,0,0,0.0
2019-02-21,209,113,96,0,113,0,0,0.0
2019-02-22,249,159,90,0,159,0,0,0.0
2019-02-24,17,0,17,0,0,0,0,0.0
2019-02-25,226,156,70,0,156,0,0,0.0
2019-02-26,257,158,99,0,158,0,0,0.0
2019-02-27,244,160,84,0,160,0,0,0.0
2019-02-28,245,132,113,0,132,0,0,0.0
2019-03-01,220,124,96,0,124,0,0,0.0
2019-03-03,21,0,21,0,0,0,0,0.0
2019-03-04,238,140,98,0,140,0,0,0.0
2019-03-05,242,136,106,0,136,0,0,0.0
2019-03-06,242,143,99,0,143,0,0,0.0
2019-03-07,249,160,89,0,160,0,0,0.0
2019-03-08,240,137,103,0,137,0,0,0.0
2019-03-10,27,12,15,0,12,0,0,0.0
2019-03-11,235,150,85,0,150,0,0,0.0
2019-03-12,249,139,110,0,139,0,0,0.0
2019-03-13,252,139,113,0,139,0,0,0.0
2019-03-14,241,124,117,0,124,0,0,0.0
2019-03-15,195,101,94,0,101,0,0,0.0
2019-03-17,26,12,14,0,12,0,0,0.0
2019-03-18,256,142,114,0,142,0,0,0.0
2019-03-19,244,129,115,0,129,0,0,0.0
2019-03-20,248,136,112,0,136,0,0,0.0
2019-03-21,257,156,101,0,156,0,0,0.0
2019-03-22,237,145,92,0,145,0,0,0.0
2019-03-24,28,12,16,0,12,0,0,0.0
2019-03-25,242,146,96,0,146,0,0,0.0
2019-03-26,237,129,108,0,129,0,0,0.0
2019-03-27,170,115,55,0,115,0,0,0.0
2019-03-28,178,73,105,0,73,0,0,0.0
2019-03-29,179,84,95,0,84,0,0,0.0
2019-03-31,19,12,7,0,12,0,0,0.0
2019-04-01,256,148,108,0,148,0,0,0.0
2019-04-02,199,123,76,0,123,0,0,0.0
2019-04-03,200,91,109,0,91,0,0,0.0
2019-04-04,243,133,110,0,133,0,0,0.0
2019-04-05,227,130,97,0,130,0,0,0.0
2019-04-07,25,11,14,0,11,0,0,0.0
2019-04-08,252,137,115,0,137,0,0,0.0
2019-04-09,254,142,112,0,142,0,0,0.0
2019-04-10,250,154,96,0,154,0,0,0.0
2019-04-11,240,130,110,0,130,0,0,0.0
2019-04-12,221,125,96,0,125,0,0,0.0
2019-04-14,32,12,20,0,12,0,0,0.0
2019-04-15,173,75,98,0,75,0,0,0.0
2019-04-16,152,67,85,0,67,0,0,0.0
2019-04-17,230,123,107,0,123,0,0,0.0
2019-04-18,202,105,97,0,105,0,0,0.0
2019-04-19,173,86,87,0,86,0,0,0.0
2019-04-21,28,12,16,0,12,0,0,0.0
2019-04-22,135,50,85,0,50,0,0,0.0
2019-04-23,249,134,115,0,134,0,0,0.0
2019-04-24,260,154,106,0,154,0,0,0.0
2019-04-25,265,156,109,0,156,0,0,0.0
2019-04-26,238,142,96,0,142,0,0,0.0
2019-04-28,24,12,12,0,12,0,0,0.0
2019-04-29,221,119,102,0,119,0,0,0.0
2019-04-30,236,131,105,0,131,0,0,0.0
2019-05-01,245,144,101,0,144,0,0,0.0
2019-05-02,241,131,110,0,131,0,0,0.0
2019-05-03,226,132,94,0,132,0,0,0.0
2019-05-05,27,12,15,0,12,0,0,0.0
2019-05-06,222,132,90,0,132,0,0,0.0
2019-05-07,237,159,78,0,159,0,0,0.0
2019-05-08,206,107,99,0,107,0,0,0.0
2019-05-09,250,142,108,0,142,0,0,0.0
2019-05-10,223,128,95,0,128,0,0,0.0
2019-05-12,29,12,17,0,12,0,0,0.0
2019-05-13,218,137,81,0,137,0,0,0.0
2019-05-14,258,147,111,0,147,0,0,0.0
2019-05-15,264,156,108,0,156,0,0,0.0
2019-05-16,267,161,106,0,161,0,0,0.0
2019-05-17,231,135,96,0,135,0,0,0.0
2019-05-19,22,12,10,0,12,0,0,0.0
2019-05-20,269,158,111,0,158,0,0,0.0
2019-05-21,258,142,116,0,142,0,0,0.0
2019-05-22,263,157,106,0,157,0,0,0.0
2019-05-23,263,159,104,0,159,0,0,0.0
2019-05-24,233,138,95,0,138,0,0,0.0
2019-05-26,33,12,21,0,12,0,0,0.0
2019-05-27,258,143,115,0,143,0,0,0.0
2019-05-28,225,134,91,0,134,0,0,0.0
2019-05-29,228,131,97,0,131,0,0,0.0
2019-05-30,253,144,109,0,144,0,0,0.0
2019-05-31,227,131,96,0,131,0,0,0.0
2019-06-02,24,12,12,0,12,0,0,0.0
2019-06-03,235,145,90,0,145,0,0,0.0
2019-06-04,249,140,109,0,140,0,0,0.0
2019-06-05,252,159,93,0,159,0,0,0.0
2019-06-06,224,135,89,0,135,0,0,0.0
2019-06-07,220,124,96,0,124,0,0,0.0
2019-06-09,18,12,6,0,12,0,0,0.0
2019-06-10,217,135,82,0,135,0,0,0.0
2019-06-11,257,158,99,0,158,0,0,0.0
2019-06-12,189,86,103,0,86,0,0,0.0
2019-06-13,262,154,108,0,154,0,0,0.0
2019-06-14,219,123,96,0,123,0,0,0.0
2019-06-16,13,5,8,0,5,0,0,0.0
2019-06-17,236,126,110,0,126,0,0,0.0
2019-06-18,260,148,112,0,148,0,0,0.0
2019-06-19,235,132,103,0,132,0,0,0.0
2019-06-20,259,147,112,0,147,0,0,0.0
2019-06-21,214,134,80,0,134,0,0,0.0
2019-06-23,31,12,19,0,12,0,0,0.0
2019-06-24,253,157,96,0,157,0,0,0.0
2019-06-25,255,150,105,0,150,0,0,0.0
2019-06-26,243,136,107,0,136,0,0,0.0
2019-06-27,265,156,109,0,156,0,0,0.0
2019-06-28,221,125,96,0,125,0,0,0.0
2019-06-30,32,12,20,0,12,0,0,0.0
2019-07-01,195,135,60,0,135,0,0,0.0
2019-07-02,219,140,79,0,140,0,0,0.0
2019-07-03,267,152,115,0,152,0,0,0.0
2019-07-04,183,78,105,0,78,0,0,0.0
2019-07-05,207,111,96,0,111,0,0,0.0
2019-07-07,6,1,5,0,1,0,0,0.0
2019-07-08,250,161,89,0,161,0,0,0.0
2019-07-09,217,109,108,0,109,0,0,0.0
2019-07-10,265,152,113,0,152,0,0,0.0
2019-07-11,248,141,107,0,141,0,0,0.0
2019-07-12,216,120,96,0,120,0,0,0.0
2019-07-14,20,12,8,0,12,0,0,0.0
2019-07-15,216,124,92,0,124,0,0,0.0
2019-07-16,237,125,112,0,125,0,0,0.0
2019-07-17,232,122,110,0,122,0,0,0.0
2019-07-18,261,144,117,0,144,0,0,0.0
2019-07-19,191,95,96,0,95,0,0,0.0
2019-07-21,25,5,20,0,5,0,0,0.0
2019-07-22,206,99,107,0,99,0,0,0.0
2019-07-23,243,134,109,0,134,0,0,0.0
2019-07-24,246,141,105,0,141,0,0,0.0
2019-07-25,223,138,85,0,138,0,0,0.0
2019-07-26,157,83,74,0,83,0,0,0.0
2019-07-28,6,0,6,0,0,0,0,0.0
2019-07-29,252,160,92,0,160,0,0,0.0
2019-07-30,257,155,102,0,155,0,0,0.0
2019-07-31,215,108,107,0,108,0,0,0.0
2019-08-01,277,161,116,0,161,0,0,0.0
2019-08-02,238,143,95,0,143,0,0,0.0
2019-08-04,26,12,14,0,12,0,0,0.0
2019-08-05,237,137,100,0,137,0,0,0.0
2019-08-06,186,75,111,0,75,0,0,0.0
2019-08-07,252,148,104,0,148,0,0,0.0
2019-08-08,159,109,50,0,109,0,0,0.0
2019-08-09,236,143,93,0,143,0,0,0.0
2019-08-11,27,12,15,0,12,0,0,0.0
2019-08-12,267,157,110,0,157,0,0,0.0
2019-08-13,268,146,122,0,146,0,0,0.0
2019-08-14,244,128,116,0,128,0,0,0.0
2019-08-15,265,144,121,0,144,0,0,0.0
2019-08-16,210,116,94,0,116,0,0,0.0
2019-08-18,22,7,15,0,7,0,0,0.0
2019-08-19,156,127,29,0,127,0,0,0.0
2019-08-20,181,103,78,0,103,0,0,0.0
2019-08-21,263,152,111,0,152,0,0,0.0
2019-08-22,265,156,109,0,156,0,0,0.0
2019-08-23,225,129,96,0,129,0,0,0.0
2019-08-25,29,12,17,0,12,0,0,0.0
2019-08-26,204,99,105,0,99,0,0,0.0
2019-08-27,214,107,107,0,107,0,0,0.0
2019-08-28,249,144,105,0,144,0,0,0.0
2019-08-29,268,160,108,0,160,0,0,0.0
2019-08-30,238,143,95,0,143,0,0,0.0
2019-09-01,14,12,2,0,12,0,0,0.0
2019-09-02,249,153,96,0,153,0,0,0.0
2019-09-03,244,134,110,0,134,0,0,0.0
2019-09-04,209,109,100,0,109,0,0,0.0
2019-09-05,272,155,117,0,155,0,0,0.0
2019-09-06,190,94,96,0,94,0,0,0.0
2019-09-08,8,0,8,0,0,0,0,0.0
2019-09-09,181,134,47,0,134,0,0,0.0
2019-09-10,247,141,106,0,141,0,0,0.0
2019-09-11,232,124,108,0,124,0,0,0.0
2019-09-12,254,138,116,0,138,0,0,0.0
2019-09-13,145,71,74,0,71,0,0,0.0
2019-09-15,12,12,0,0,12,0,0,0.0
2019-09-16,180,153,27,0,153,0,0,0.0
2019-09-17,136,37,99,0,37,0,0,0.0
2019-09-18,220,120,100,0,120,0,0,0.0
2019-09-19,256,149,107,0,149,0,0,0.0
2019-09-20,237,141,96,0,141,0,0,0.0
2019-09-22,19,12,7,0,12,0,0,0.0
2019-09-23,125,86,39,0,86,0,0,0.0
2019-09-24,267,157,110,0,157,0,0,0.0
2019-09-25,232,127,105,0,127,0,0,0.0
2019-09-26,268,153,115,0,153,0,0,0.0
2019-09-27,225,131,94,0,131,0,0,0.0
2019-09-29,31,12,19,0,12,0,0,0.0
2019-09-30,242,146,96,0,146,0,0,0.0
2019-10-01,244,147,97,0,147,0,0,0.0
2019-10-02,256,152,104,0,152,0,0,0.0
2019-10-03,264,158,106,0,158,0,0,0.0
2019-10-04,227,130,97,0,130,0,0,0.0
2019-10-06,26,12,14,0,12,0,0,0.0
2019-10-07,226,140,86,0,140,0,0,0.0
2019-10-08,265,150,115,0,150,0,0,0.0
2019-10-09,268,153,115,0,153,0,0,0.0
2019-10-10,248,145,103,0,145,0,0,0.0
2019-10-11,236,146,90,0,146,0,0,0.0
2019-10-13,26,10,16,0,10,0,0,0.0
2019-10-14,259,154,105,0,154,0,0,0.0
2019-10-15,255,156,99,0,156,0,0,0.0
2019-10-16,259,145,114,0,145,0,0,0.0
2019-10-17,261,153,108,0,153,0,0,0.0
2019-10-18,163,70,93,0,70,0,0,0.0
2019-10-20,4,4,0,0,4,0,0,0.0
2019-10-21,237,126,111,0,126,0,0,0.0
2019-10-22,259,146,113,0,146,0,0,0.0
2019-10-23,258,152,106,0,152,0,0,0.0
2019-10-24,195,97,98,0,97,0,0,0.0
2019-10-25,240,144,96,0,144,0,0,0.0
2019-10-27,14,12,2,0,12,0,0,0.0
2019-10-28,262,157,105,0,157,0,0,0.0
2019-10-29,176,121,55,0,121,0,0,0.0
2019-10-30,225,145,80,0,145,0,0,0.0
2019-10-31,262,159,103,0,159,0,0,0.0
2019-11-01,207,134,73,0,134,0,0,0.0
2019-11-03,3,0,3,0,0,0,0,0.0
2019-11-04,158,125,33,0,125,0,0,0.0
2019-11-05,211,114,97,0,114,0,0,0.0
2019-11-06,209,107,102,0,107,0,0,0.0
2019-11-07,255,155,100,0,155,0,0,0.0
2019-11-08,247,159,88,0,159,0,0,0.0
2019-11-10,19,0,19,0,0,0,0,0.0
2019-11-11,236,139,97,0,139,0,0,0.0
2019-11-12,241,140,101,0,140,0,0,0.0
2019-11-13,247,153,94,0,153,0,0,0.0
2019-11-14,242,155,87,0,155,0,0,0.0
2019-11-15,245,149,96,0,149,0,0,0.0
2019-11-17,15,0,15,0,0,0,0,0.0
2019-11-18,256,152,104,0,152,0,0,0.0
2019-11-19,271,162,109,0,162,0,0,0.0
2019-11-20,245,135,110,0,135,0,0,0.0
2019-11-21,149,54,95,0,54,0,0,0.0
2019-11-22,244,152,92,0,152,0,0,0.0
2019-11-24,13,0,13,0,0,0,0,0.0
2019-11-25,227,112,115,0,112,0,0,0.0
2019-11-26,255,141,114,0,141,0,0,0.0
2019-11-27,268,159,109,0,159,0,0,0.0
2019-11-28,249,153,96,0,153,0,0,0.0
2019-11-29,241,145,96,0,145,0,0,0.0
2019-12-01,17,0,17,0,0,0,0,0.0
2019-12-02,263,147,116,0,147,0,0,0.0
2019-12-03,271,154,117,0,154,0,0,0.0
2019-12-04,250,139,111,0,139,0,0,0.0
2019-12-05,248,147,101,0,147,0,0,0.0
2019-12-06,250,151,99,0,151,0,0,0.0
2019-12-08,15,0,15,0,0,0,0,0.0
2019-12-09,252,154,98,0,154,0,0,0.0
2019-12-10,266,155,111,0,155,0,0,0.0
2019-12-11,168,153,15,0,153,0,0,0.0
2019-12-12,219,141,78,0,141,0,0,0.0
2019-12-13,200,141,59,0,141,0,0,0.0
2019-12-15,18,0,18,0,0,0,0,0.0
2019-12-16,227,114,113,0,114,0,0,0.0
2019-12-17,171,136,35,0,136,0,0,0.0
2019-12-18,177,91,86,0,91,0,0,0.0
2019-12-19,198,143,55,0,143,0,0,0.0
2019-12-20,161,141,20,0,141,0,0,0.0
2019-12-22,20,0,20,0,0,0,0,0.0
2019-12-23,184,139,45,0,139,0,0,0.0
2019-12-24,219,138,81,0,138,0,0,0.0
2019-12-25,98,0,98,0,0,0,0,0.0
2019-12-26,252,156,96,0,156,0,0,0.0
2019-12-27,199,107,92,0,107,0,0,0.0
2019-12-29,6,0,6,0,0,0,0,0.0
2019-12-30,261,153,108,0,153,0,0,0.0
2019-12-31,237,141,96,0,141,0,0,0.0
2020-01-01,1,0,1,0,0,0,0,0.0
2020-01-02,151,129,22,0,129,0,0,0.0
2020-01-03,213,127,86,0,127,0,0,0.0
2020-01-05,14,0,14,0,0,0,0,0.0
2020-01-06,254,145,109,0,145,0,0,0.0
2020-01-07,259,152,107,0,152,0,0,0.0
2020-01-08,230,127,103,0,127,0,0,0.0
2020-01-09,246,150,96,0,150,0,0,0.0
2020-01-10,199,160,39,0,160,0,0,0.0
2020-01-12,15,0,15,0,0,0,0,0.0
2020-01-13,251,146,105,0,146,0,0,0.0
2020-01-14,236,130,106,0,130,0,0,0.0
2020-01-15,250,150,100,0,150,0,0,0.0
2020-01-16,261,153,108,0,153,0,0,0.0
2020-01-17,247,158,89,0,158,0,0,0.0
2020-01-19,21,0,21,0,0,0,0,0.0
2020-01-20,250,134,116,0,134,0,0,0.0
2020-01-21,240,133,107,0,133,0,0,0.0
2020-01-22,257,146,111,0,146,0,0,0.0
2020-01-23,245,129,116,0,129,0,0,0.0
2020-01-24,239,144,95,0,144,0,0,0.0
2020-01-26,13,0,13,0,0,0,0,0.0
2020-01-27,214,150,64,0,150,0,0,0.0
2020-01-28,260,156,104,0,156,0,0,0.0
2020-01-29,180,112,68,0,112,0,0,0.0
2020-01-30,247,139,108,0,139,0,0,0.0
2020-01-31,248,154,94,0,154,0,0,0.0
2020-02-02,6,0,6,0,0,0,0,0.0
2020-02-03,245,138,107,0,138,0,0,0.0
2020-02-04,252,156,96,0,156,0,0,0.0
2020-02-05,181,96,85,0,96,0,0,0.0
2020-02-06,253,147,106,0,147,0,0,0.0
2020-02-07,249,153,96,0,153,0,0,0.0
2020-02-09,18,0,18,0,0,0,0,0.0
2020-02-10,238,136,102,0,136,0,0,0.0
2020-02-11,255,156,99,0,156,0,0,0.0
2020-02-12,260,161,99,0,161,0,0,0.0
2020-02-13,256,149,107,0,149,0,0,0.0
2020-02-14,215,157,58,0,157,0,0,0.0
2020-02-16,0,0,0,0,0,0,0,0.0
2020-02-17,176,151,25,0,151,0,0,0.0
2020-02-18,227,119,108,0,119,0,0,0.0
2020-02-19,271,158,113,0,158,0,0,0.0
2020-02-20,244,130,114,0,130,0,0,0.0
2020-02-21,239,144,95,0,144,0,0,0.0
2020-02-23,14,0,14,0,0,0,0,0.0
2020-02-24,262,156,106,0,156,0,0,0.0
2020-02-25,274,159,115,0,159,0,0,0.0
2020-02-26,253,144,109,0,144,0,0,0.0
2020-02-27,238,130,108,0,130,0,0,0.0
2020-02-28,224,156,68,0,156,0,0,0.0
2020-03-01,4,0,4,0,0,0,0,0.0
2020-03-02,245,148,97,0,148,0,0,0.0
2020-03-03,222,112,110,0,112,0,0,0.0
2020-03-04,212,100,112,0,100,0,0,0.0
2020-03-05,268,158,110,0,158,0,0,0.0
2020-03-06,239,148,91,0,148,0,0,0.0
2020-03-08,27,12,15,0,12,0,0,0.0
2020-03-09,207,95,112,0,95,0,0,0.0
2020-03-10,254,152,102,1,151,1,1,10.372857142857129
2020-03-11,205,91,114,1,90,1,0,-6.982857142856346
2020-03-12,244,135,109,0,135,0,0,0.0
2020-03-13,229,133,96,0,133,0,0,0.0
2020-03-15,27,12,15,0,12,0,0,0.0
2020-03-16,198,156,42,0,156,0,0,0.0
2020-03-17,254,137,117,0,137,0,0,0.0
2020-03-18,248,142,106,0,142,0,0,0.0
2020-03-19,250,140,110,0,140,0,0,0.0
2020-03-20,240,146,94,0,146,0,0,0.0
2020-03-22,22,12,10,0,12,0,0,0.0
2020-03-23,264,154,110,0,154,0,0,0.0
2020-03-24,269,154,115,0,154,0,0,0.0
2020-03-25,262,149,113,0,149,0,0,0.0
2020-03-26,208,97,111,0,97,0,0,0.0
2020-03-27,213,117,96,0,117,0,0,0.0
2020-03-29,26,12,14,0,12,0,0,0.0
2020-03-30,219,121,98,0,121,0,0,0.0
2020-03-31,262,147,115,0,147,0,0,0.0
2020-04-01,265,151,114,0,151,0,0,0.0
2020-04-02,241,126,115,0,126,0,0,0.0
2020-04-03,176,124,52,0,124,0,0,0.0
2020-04-05,24,12,12,0,12,0,0,0.0
2020-04-06,220,103,117,0,103,0,0,0.0
2020-04-07,255,144,111,0,144,0,0,0.0
2020-04-08,251,155,96,0,155,0,0,0.0
2020-04-09,275,161,114,0,161,0,0,0.0
2020-04-10,223,134,89,0,134,0,0,0.0
2020-04-12,15,12,3,0,12,0,0,0.0
2020-04-13,235,132,103,0,132,0,0,0.0
2020-04-14,250,160,90,0,160,0,0,0.0
2020-04-15,240,135,105,0,135,0,0,0.0
2020-04-16,260,157,103,0,157,0,0,0.0
2020-04-17,226,130,96,0,130,0,0,0.0
2020-04-19,21,3,18,0,3,0,0,0.0
2020-04-20,261,149,112,0,149,0,0,0.0
2020-04-21,184,73,111,0,73,0,0,0.0
2020-04-22,205,109,96,0,109,0,0,0.0
2020-04-23,192,139,53,0,139,0,0,0.0
2020-04-24,239,145,94,0,145,0,0,0.0
2020-04-26,26,10,16,0,10,0,0,0.0
2020-04-27,260,156,104,0,156,0,0,0.0
2020-04-28,268,154,114,0,154,0,0,0.0
2020-04-29,207,111,96,0,111,0,0,0.0
2020-04-30,235,130,105,0,130,0,0,0.0
2020-05-01,191,143,48,0,143,0,0,0.0
2020-05-03,18,11,7,0,11,0,0,0.0
2020-05-04,245,131,114,0,131,0,0,0.0
2020-05-05,248,137,111,0,137,0,0,0.0
2020-05-06,269,154,115,0,154,0,0,0.0
2020-05-07,267,157,110,0,157,0,0,0.0
2020-05-08,197,102,95,0,102,0,0,0.0
2020-05-10,33,12,21,0,12,0,0,0.0
2020-05-11,263,158,105,0,158,0,0,0.0
2020-05-12,230,120,110,0,120,0,0,0.0
2020-05-13,253,146,107,0,146,0,0,0.0
2020-05-14,263,157,106,0,157,0,0,0.0
2020-05-15,223,144,79,0,144,0,0,0.0
2020-05-17,33,12,21,0,12,0,0,0.0
2020-05-18,202,143,59,0,143,0,0,0.0
2020-05-19,267,151,116,0,151,0,0,0.0
2020-05-20,240,136,104,0,136,0,0,0.0
2020-05-21,224,127,97,0,127,0,0,0.0
2020-05-22,178,98,80,0,98,0,0,0.0
2020-05-24,18,7,11,0,7,0,0,0.0
2020-05-25,169,106,63,0,106,0,0,0.0
2020-05-26,227,112,115,0,112,0,0,0.0
2020-05-27,246,158,88,0,158,0,0,0.0
2020-05-28,250,150,100,0,150,0,0,0.0
2020-05-29,235,145,90,0,145,0,0,0.0
2020-05-31,28,12,16,0,12,0,0,0.0
2020-06-01,254,145,109,0,145,0,0,0.0
2020-06-02,255,156,99,0,156,0,0,0.0
2020-06-03,260,148,112,0,148,0,0,0.0
2020-06-04,260,150,110,0,150,0,0,0.0
2020-06-05,189,104,85,0,104,0,0,0.0
2020-06-07,7,4,3,0,4,0,0,0.0
2020-06-08,261,151,110,0,151,0,0,0.0
2020-06-09,267,156,111,0,156,0,0,0.0
2020-06-10,260,152,108,0,152,0,0,0.0
2020-06-11,210,101,109,0,101,0,0,0.0
2020-06-12,224,129,95,0,129,0,0,0.0
2020-06-14,16,11,5,0,11,0,0,0.0
2020-06-15,222,121,101,0,121,0,0,0.0
2020-06-16,233,145,88,0,145,0,0,0.0
2020-06-17,224,118,106,0,118,0,0,0.0
2020-06-18,227,121,106,0,121,0,0,0.0
2020-06-19,172,87,85,0,87,0,0,0.0
2020-06-21,15,12,3,0,12,0,0,0.0
2020-06-22,222,124,98,0,124,0,0,0.0
2020-06-23,176,64,112,0,64,0,0,0.0
2020-06-24,207,116,91,0,116,0,0,0.0
2020-06-25,218,158,60,0,158,0,0,0.0
2020-06-26,225,144,81,0,144,0,0,0.0
2020-06-28,14,12,2,0,12,0,0,0.0
2020-06-29,218,148,70,0,148,0,0,0.0
2020-06-30,248,147,101,0,147,0,0,0.0
2020-07-01,187,80,107,0,80,0,0,0.0
2020-07-02,229,147,82,0,147,0,0,0.0
2020-07-03,171,113,58,0,113,0,0,0.0
2020-07-05,19,12,7,0,12,0,0,0.0
2020-07-06,254,144,110,0,144,0,0,0.0
2020-07-07,260,153,107,0,153,0,0,0.0
2020-07-08,261,155,106,0,155,0,0,0.0
2020-07-09,231,128,103,0,128,0,0,0.0
2020-07-10,237,141,96,0,141,0,0,0.0
2020-07-12,26,12,14,0,12,0,0,0.0
2020-07-13,213,128,85,0,128,0,0,0.0
2020-07-14,243,154,89,0,154,0,0,0.0
2020-07-15,218,155,63,0,155,0,0,0.0
2020-07-16,258,158,100,0,158,0,0,0.0
2020-07-17,240,146,94,0,146,0,0,0.0
2020-07-19,15,10,5,0,10,0,0,0.0
2020-07-20,249,143,106,0,143,0,0,0.0
2020-07-21,270,154,116,0,154,0,0,0.0
2020-07-22,231,146,85,0,146,0,0,0.0
2020-07-23,230,150,80,0,150,0,0,0.0
2020-07-24,229,133,96,0,133,0,0,0.0
2020-07-26,9,0,9,0,0,0,0,0.0
2020-07-27,230,126,104,0,126,0,0,0.0
2020-07-28,213,114,99,0,114,0,0,0.0
2020-07-29,217,118,99,0,118,0,0,0.0
2020-07-30,234,121,113,0,121,0,0,0.0
2020-07-31,246,150,96,0,150,0,0,0.0
2020-08-02,17,12,5,0,12,0,0,0.0
2020-08-03,247,160,87,0,160,0,0,0.0
2020-08-04,262,148,114,0,148,0,0,0.0
2020-08-05,215,114,101,0,114,0,0,0.0
2020-08-06,192,93,99,0,93,0,0,0.0
2020-08-07,212,118,94,0,118,0,0,0.0
2020-08-09,19,12,7,0,12,0,0,0.0
2020-08-10,221,115,106,0,115,0,0,0.0
2020-08-11,247,139,108,0,139,0,0,0.0
2020-08-12,245,144,101,0,144,0,0,0.0
2020-08-13,234,121,113,0,121,0,0,0.0
2020-08-14,198,119,79,0,119,0,0,0.0
2020-08-16,20,11,9,0,11,0,0,0.0
2020-08-17,244,152,92,0,152,0,0,0.0
2020-08-18,246,129,117,0,129,0,0,0.0
2020-08-19,263,152,111,0,152,0,0,0.0
2020-08-20,235,133,102,0,133,0,0,0.0
2020-08-21,238,142,96,0,142,0,0,0.0
2020-08-23,31,12,19,0,12,0,0,0.0
2020-08-24,201,142,59,0,142,0,0,0.0
2020-08-25,207,104,103,0,104,0,0,0.0
2020-08-26,243,133,110,0,133,0,0,0.0
2020-08-27,243,154,89,0,154,0,0,0.0
2020-08-28,245,149,96,0,149,0,0,0.0
2020-08-30,16,12,4,0,12,0,0,0.0
2020-08-31,186,149,37,0,149,0,0,0.0
2020-09-01,272,159,113,0,159,0,0,0.0
2020-09-02,203,90,113,0,90,0,0,0.0
2020-09-03,269,157,112,0,157,0,0,0.0
2020-09-04,213,141,72,0,141,0,0,0.0
2020-09-06,26,12,14,0,12,0,0,0.0
2020-09-07,253,149,104,0,149,0,0,0.0
2020-09-08,235,123,112,0,123,0,0,0.0
2020-09-09,118,85,33,0,85,0,0,0.0
2020-09-10,249,141,108,0,141,0,0,0.0
2020-09-11,216,129,87,0,129,0,0,0.0
2020-09-13,24,12,12,0,12,0,0,0.0
2020-09-14,259,156,103,0,156,0,0,0.0
2020-09-15,235,133,102,0,133,0,0,0.0
2020-09-16,238,122,116,0,122,0,0,0.0
2020-09-17,271,157,114,0,157,0,0,0.0
2020-09-18,239,146,93,0,146,0,0,0.0
2020-09-20,12,12,0,0,12,0,0,0.0
2020-09-21,224,137,87,0,137,0,0,0.0
2020-09-22,261,160,101,0,160,0,0,0.0
2020-09-23,243,144,99,0,144,0,0,0.0
2020-09-24,206,100,106,0,100,0,0,0.0
2020-09-25,233,148,85,0,148,0,0,0.0
2020-09-27,32,12,20,0,12,0,0,0.0
2020-09-28,220,106,114,0,106,0,0,0.0
2020-09-29,208,111,97,0,111,0,0,0.0
2020-09-30,258,155,103,0,155,0,0,0.0
2020-10-01,239,145,94,0,145,0,0,0.0
2020-10-02,213,129,84,0,129,0,0,0.0
2020-10-04,24,8,16,0,8,0,0,0.0
2020-10-05,215,113,102,0,113,0,0,0.0
2020-10-06,226,122,104,0,122,0,0,0.0
2020-10-07,253,155,98,0,155,0,0,0.0
2020-10-08,181,100,81,0,100,0,0,0.0
2020-10-09,214,118,96,0,118,0,0,0.0
2020-10-11,32,12,20,0,12,0,0,0.0
2020-10-12,201,94,107,0,94,0,0,0.0
2020-10-13,200,105,95,0,105,0,0,0.0
2020-10-14,241,135,106,0,135,0,0,0.0
2020-10-15,268,154,114,0,154,0,0,0.0
2020-10-16,228,132,96,0,132,0,0,0.0
2020-10-18,11,0,11,0,0,0,0,0.0
2020-10-19,222,156,66,0,156,0,0,0.0
2020-10-20,254,154,100,0,154,0,0,0.0
2020-10-21,261,152,109,0,152,0,0,0.0
2020-10-22,258,151,107,0,151,0,0,0.0
2020-10-23,162,67,95,0,67,0,0,0.0
2020-10-25,30,12,18,0,12,0,0,0.0
2020-10-26,251,144,107,0,144,0,0,0.0
2020-10-27,264,148,116,0,148,0,0,0.0
2020-10-28,244,140,104,0,140,0,0,0.0
2020-10-29,255,151,104,0,151,0,0,0.0
2020-10-30,188,92,96,0,92,0,0,0.0
2020-11-01,8,0,8,0,0,0,0,0.0
2020-11-02,253,157,96,0,157,0,0,0.0
2020-11-03,190,148,42,0,148,0,0,0.0
2020-11-04,253,140,113,0,140,0,0,0.0
2020-11-05,202,85,117,0,85,0,0,0.0
2020-11-06,226,138,88,0,138,0,0,0.0
2020-11-08,21,0,21,0,0,0,0,0.0
2020-11-09,254,149,105,0,149,0,0,0.0
2020-11-10,175,79,96,0,79,0,0,0.0
2020-11-11,207,112,95,0,112,0,0,0.0
2020-11-12,252,148,104,0,148,0,0,0.0
2020-11-13,250,154,96,0,154,0,0,0.0
2020-11-15,0,0,0,0,0,0,0,0.0
2020-11-16,236,154,82,0,154,0,0,0.0
2020-11-17,210,93,117,0,93,0,0,0.0
2020-11-18,243,133,110,0,133,0,0,0.0
2020-11-19,226,133,93,0,133,0,0,0.0
2020-11-20,198,109,89,0,109,0,0,0.0
2020-11-22,16,0,16,0,0,0,0,0.0
2020-11-23,179,134,45,0,134,0,0,0.0
2020-11-24,206,112,94,0,112,0,0,0.0
2020-11-25,198,88,110,0,88,0,0,0.0
2020-11-26,216,104,112,0,104,0,0,0.0
2020-11-27,225,129,96,0,129,0,0,0.0
2020-11-29,16,0,16,0,0,0,0,0.0
2020-11-30,250,139,111,0,139,0,0,0.0
2020-12-01,243,132,111,0,132,0,0,0.0
2020-12-02,256,139,117,0,139,0,0,0.0
2020-12-03,233,128,105,0,128,0,0,0.0
2020-12-04,191,116,75,0,116,0,0,0.0
2020-12-06,17,0,17,0,0,0,0,0.0
2020-12-07,219,149,70,0,149,0,0,0.0
2020-12-08,204,109,95,0,109,0,0,0.0
2020-12-09,269,156,113,0,156,0,0,0.0
2020-12-10,230,130,100,0,130,0,0,0.0
2020-12-11,241,145,96,0,145,0,0,0.0
2020-12-13,6,0,6,0,0,0,0,0.0
2020-12-14,186,150,36,0,150,0,0,0.0
2020-12-15,235,146,89,0,146,0,0,0.0
2020-12-16,268,155,113,0,155,0,0,0.0
2020-12-17,227,126,101,0,126,0,0,0.0
2020-12-18,168,72,96,0,72,0,0,0.0
2020-12-20,1,0,1,0,0,0,0,0.0
2020-12-21,162,143,19,0,143,0,0,0.0
2020-12-22,258,150,108,0,150,0,0,0.0
2020-12-23,209,95,114,0,95,0,0,0.0
2020-12-24,230,117,113,0,117,0,0,0.0
2020-12-25,60,0,60,0,0,0,0,0.0
2020-12-27,17,0,17,0,0,0,0,0.0
2020-12-28,230,151,79,0,151,0,0,0.0
2020-12-29,223,120,103,0,120,0,0,0.0
2020-12-30,254,151,103,0,151,0,0,0.0
2020-12-31,149,146,3,0,146,0,0,0.0
2021-01-03,13,0,13,0,0,0,0,0.0
2021-01-04,257,155,102,0,155,0,0,0.0
2021-01-05,256,151,105,0,151,0,0,0.0
2021-01-06,226,138,88,0,138,0,0,0.0
2021-01-07,257,147,110,0,147,0,0,0.0
2021-01-08,251,155,96,0,155,0,0,0.0
2021-01-10,20,0,20,0,0,0,0,0.0
2021-01-11,247,134,113,0,134,0,0,0.0
2021-01-12,217,131,86,0,131,0,0,0.0
2021-01-13,207,97,110,0,97,0,0,0.0
2021-01-14,214,110,104,0,110,0,0,0.0
2021-01-15,160,125,35,0,125,0,0,0.0
2021-01-17,5,0,5,0,0,0,0,0.0
2021-01-18,246,142,104,0,142,0,0,0.0
2021-01-19,208,112,96,0,112,0,0,0.0
2021-01-20,249,149,100,0,149,0,0,0.0
2021-01-21,264,156,108,0,156,0,0,0.0
2021-01-22,212,116,96,0,116,0,0,0.0
2021-01-24,1,0,1,0,0,0,0,0.0
2021-01-25,195,117,78,0,117,0,0,0.0
2021-01-26,194,123,71,0,123,0,0,0.0
2021-01-27,253,160,93,0,160,0,0,0.0
2021-01-28,221,116,105,0,116,0,0,0.0
2021-01-29,215,119,96,0,119,0,0,0.0
2021-01-31,18,0,18,0,0,0,0,0.0
2021-02-01,218,115,103,0,115,0,0,0.0
2021-02-02,227,135,92,0,135,0,0,0.0
2021-02-03,199,88,111,0,88,0,0,0.0
2021-02-04,259,155,104,0,155,0,0,0.0
2021-02-05,214,158,56,0,158,0,0,0.0
2021-02-07,21,0,21,0,0,0,0,0.0
2021-02-08,261,156,105,0,156,0,0,0.0
2021-02-09,212,102,110,0,102,0,0,0.0
2021-02-10,258,156,102,0,156,0,0,0.0
2021-02-11,172,138,34,0,138,0,0,0.0
2021-02-12,243,155,88,0,155,0,0,0.0
2021-02-14,18,0,18,0,0,0,0,0.0
2021-02-15,232,128,104,0,128,0,0,0.0
2021-02-16,269,155,114,0,155,0,0,0.0
2021-02-17,241,141,100,0,141,0,0,0.0
2021-02-18,201,104,97,0,104,0,0,0.0
2021-02-19,251,162,89,0,162,0,0,0.0
2021-02-21,16,0,16,0,0,0,0,0.0
2021-02-22,250,150,100,0,150,0,0,0.0
2021-02-23,242,146,96,0,146,0,0,0.0
2021-02-24,225,112,113,0,112,0,0,0.0
2021-02-25,247,135,112,0,135,0,0,0.0
2021-02-26,234,148,86,0,148,0,0,0.0
2021-02-28,7,0,7,0,0,0,0,0.0
2021-03-01,243,151,92,0,151,0,0,0.0
2021-03-02,250,143,107,0,143,0,0,0.0
2021-03-03,268,153,115,0,153,0,0,0.0
2021-03-04,270,161,109,0,161,0,0,0.0
2021-03-05,210,121,89,0,121,0,0,0.0
2021-03-07,13,0,13,0,0,0,0,0.0
2021-03-08,241,151,90,0,151,0,0,0.0
2021-03-09,264,150,114,0,150,0,0,0.0
2021-03-10,212,101,111,0,101,0,0,0.0
2021-03-11,233,128,105,0,128,0,0,0.0
2021-03-12,149,53,96,0,53,0,0,0.0
2021-03-14,22,4,18,0,4,0,0,0.0
2021-03-15,216,123,93,0,123,0,0,0.0
2021-03-16,183,83,100,0,83,0,0,0.0
2021-03-17,270,155,115,0,155,0,0,0.0
2021-03-18,259,150,109,0,150,0,0,0.0
2021-03-19,166,70,96,0,70,0,0,0.0
2021-03-21,22,12,10,0,12,0,0,0.0
2021-03-22,111,78,33,0,78,0,0,0.0
2021-03-23,235,126,109,0,126,0,0,0.0
2021-03-24,221,114,107,0,114,0,0,0.0
2021-03-25,247,132,115,0,132,0,0,0.0
2021-03-26,233,137,96,0,137,0,0,0.0
2021-03-28,28,12,16,0,12,0,0,0.0
2021-03-29,252,154,98,0,154,0,0,0.0
2021-03-30,226,113,113,0,113,0,0,0.0
2021-03-31,220,104,116,0,104,0,0,0.0
2021-04-01,246,150,96,0,150,0,0,0.0
2021-04-02,149,58,91,0,58,0,0,0.0
2021-04-04,20,0,20,0,0,0,0,0.0
2021-04-05,203,127,76,0,127,0,0,0.0
2021-04-06,200,93,107,0,93,0,0,0.0
2021-04-07,222,116,106,0,116,0,0,0.0
2021-04-08,259,147,112,0,147,0,0,0.0
2021-04-09,219,148,71,0,148,0,0,0.0
2021-04-11,30,11,19,0,11,0,0,0.0
2021-04-12,263,157,106,0,157,0,0,0.0
2021-04-13,256,141,115,0,141,0,0,0.0
2021-04-14,204,101,103,0,101,0,0,0.0
2021-04-15,259,143,116,0,143,0,0,0.0
2021-04-16,234,138,96,0,138,0,0,0.0
2021-04-18,29,12,17,0,12,0,0,0.0
2021-04-19,156,49,107,0,49,0,0,0.0
2021-04-20,261,148,113,0,148,0,0,0.0
2021-04-21,266,150,116,0,150,0,0,0.0
2021-04-22,242,129,113,0,129,0,0,0.0
2021-04-23,201,124,77,0,124,0,0,0.0
2021-04-25,29,12,17,0,12,0,0,0.0
2021-04-26,249,134,115,0,134,0,0,0.0
2021-04-27,264,150,114,0,150,0,0,0.0
2021-04-28,263,146,117,0,146,0,0,0.0
2021-04-29,217,104,113,0,104,0,0,0.0
2021-04-30,236,140,96,0,140,0,0,0.0
2021-05-02,13,12,1,0,12,0,0,0.0
2021-05-03,266,157,109,0,157,0,0,0.0
2021-05-04,263,155,108,0,155,0,0,0.0
2021-05-05,226,117,109,0,117,0,0,0.0
2021-05-06,269,159,110,0,159,0,0,0.0
2021-05-07,141,50,91,0,50,0,0,0.0
2021-05-09,1,0,1,0,0,0,0,0.0
2021-05-10,236,121,115,0,121,0,0,0.0
2021-05-11,233,125,108,0,125,0,0,0.0
2021-05-12,270,160,110,0,160,0,0,0.0
2021-05-13,203,112,91,0,112,0,0,0.0
2021-05-14,174,78,96,0,78,0,0,0.0
2021-05-16,32,12,20,0,12,0,0,0.0
2021-05-17,176,103,73,0,103,0,0,0.0
2021-05-18,209,109,100,0,109,0,0,0.0
2021-05-19,237,123,114,0,123,0,0,0.0
2021-05-20,258,142,116,0,142,0,0,0.0
2021-05-21,217,122,95,0,122,0,0,0.0
2021-05-23,17,12,5,0,12,0,0,0.0
2021-05-24,242,158,84,0,158,0,0,0.0
2021-05-25,243,138,105,0,138,0,0,0.0
2021-05-26,245,150,95,0,150,0,0,0.0
2021-05-27,272,160,112,0,160,0,0,0.0
2021-05-28,225,130,95,0,130,0,0,0.0
2021-05-30,24,12,12,0,12,0,0,0.0
2021-05-31,255,140,115,0,140,0,0,0.0
2021-06-01,228,126,102,0,126,0,0,0.0
2021-06-02,272,156,116,0,156,0,0,0.0
2021-06-03,269,158,111,0,158,0,0,0.0
2021-06-04,235,139,96,0,139,0,0,0.0
2021-06-06,30,12,18,0,12,0,0,0.0
2021-06-07,116,42,74,0,42,0,0,0.0
2021-06-08,255,150,105,0,150,0,0,0.0
2021-06-09,247,147,100,0,147,0,0,0.0
2021-06-10,266,155,111,0,155,0,0,0.0
2021-06-11,235,143,92,0,143,0,0,0.0
2021-06-13,3,0,3,0,0,0,0,0.0
2021-06-14,230,142,88,0,142,0,0,0.0
2021-06-15,181,83,98,0,83,0,0,0.0
2021-06-16,238,139,99,0,139,0,0,0.0
2021-06-17,263,156,107,0,156,0,0,0.0
2021-06-18,240,146,94,0,146,0,0,0.0
2021-06-20,14,12,2,0,12,0,0,0.0
2021-06-21,240,133,107,0,133,0,0,0.0
2021-06-22,217,116,101,0,116,0,0,0.0
2021-06-23,243,140,103,0,140,0,0,0.0
2021-06-24,253,152,101,0,152,0,0,0.0
2021-06-25,223,134,89,0,134,0,0,0.0
2021-06-27,12,12,0,0,12,0,0,0.0
2021-06-28,254,160,94,0,160,0,0,0.0
2021-06-29,254,153,101,0,153,0,0,0.0
2021-06-30,257,152,105,0,152,0,0,0.0
2021-07-01,245,151,94,0,151,0,0,0.0
2021-07-02,219,123,96,0,123,0,0,0.0
2021-07-04,33,12,21,0,12,0,0,0.0
2021-07-05,212,121,91,0,121,0,0,0.0
2021-07-06,255,145,110,0,145,0,0,0.0
2021-07-07,196,86,110,0,86,0,0,0.0
2021-07-08,248,134,114,0,134,0,0,0.0
2021-07-09,236,140,96,0,140,0,0,0.0
2021-07-11,28,12,16,0,12,0,0,0.0
2021-07-12,215,159,56,0,159,0,0,0.0
2021-07-13,259,144,115,0,144,0,0,0.0
2021-07-14,255,139,116,0,139,0,0,0.0
2021-07-15,226,114,112,0,114,0,0,0.0
2021-07-16,233,137,96,0,137,0,0,0.0
2021-07-18,26,12,14,0,12,0,0,0.0
2021-07-19,214,101,113,0,101,0,0,0.0
2021-07-20,262,155,107,0,155,0,0,0.0
2021-07-21,161,60,101,0,60,0,0,0.0
2021-07-22,175,71,104,0,71,0,0,0.0
2021-07-23,236,145,91,0,145,0,0,0.0
2021-07-25,13,9,4,0,9,0,0,0.0
2021-07-26,177,69,108,0,69,0,0,0.0
2021-07-27,232,118,114,0,118,0,0,0.0
2021-07-28,244,130,114,0,130,0,0,0.0
2021-07-29,227,115,112,0,115,0,0,0.0
2021-07-30,201,105,96,0,105,0,0,0.0
2021-08-01,16,12,4,0,12,0,0,0.0
2021-08-02,189,155,34,0,155,0,0,0.0
2021-08-03,261,147,114,0,147,0,0,0.0
2021-08-04,228,146,82,0,146,0,0,0.0
2021-08-05,261,157,104,0,157,0,0,0.0
2021-08-06,244,150,94,0,150,0,0,0.0
2021-08-08,24,11,13,0,11,0,0,0.0
2021-08-09,233,140,93,0,140,0,0,0.0
2021-08-10,222,151,71,0,151,0,0,0.0
2021-08-11,236,127,109,0,127,0,0,0.0
2021-08-12,247,138,109,0,138,0,0,0.0
2021-08-13,205,122,83,0,122,0,0,0.0
2021-08-15,28,12,16,0,12,0,0,0.0
2021-08-16,181,69,112,0,69,0,0,0.0
2021-08-17,224,123,101,0,123,0,0,0.0
2021-08-18,212,122,90,0,122,0,0,0.0
2021-08-19,184,81,103,0,81,0,0,0.0
2021-08-20,155,66,89,0,66,0,0,0.0
2021-08-22,32,12,20,0,12,0,0,0.0
2021-08-23,254,142,112,0,142,0,0,0.0
2021-08-24,273,158,115,0,158,0,0,0.0
2021-08-25,254,140,114,0,140,0,0,0.0
2021-08-26,245,133,112,0,133,0,0,0.0
2021-08-27,216,120,96,0,120,0,0,0.0
2021-08-29,18,12,6,0,12,0,0,0.0
2021-08-30,204,115,89,0,115,0,0,0.0
2021-08-31,254,151,103,0,151,0,0,0.0
2021-09-01,214,99,115,0,99,0,0,0.0
2021-09-02,252,143,109,0,143,0,0,0.0
2021-09-03,241,145,96,0,145,0,0,0.0
2021-09-05,16,12,4,0,12,0,0,0.0
2021-09-06,181,76,105,0,76,0,0,0.0
2021-09-07,220,109,111,0,109,0,0,0.0
2021-09-08,192,89,103,0,89,0,0,0.0
2021-09-09,220,103,117,0,103,0,0,0.0
2021-09-10,180,99,81,0,99,0,0,0.0
2021-09-12,15,11,4,0,11,0,0,0.0
2021-09-13,258,144,114,0,144,0,0,0.0
2021-09-14,259,145,114,0,145,0,0,0.0
2021-09-15,213,98,115,0,98,0,0,0.0
2021-09-16,197,88,109,0,88,0,0,0.0
2021-09-17,239,143,96,0,143,0,0,0.0
2021-09-19,16,12,4,0,12,0,0,0.0
2021-09-20,252,144,108,0,144,0,0,0.0
2021-09-21,240,124,116,0,124,0,0,0.0
2021-09-22,260,145,115,0,145,0,0,0.0
2021-09-23,250,153,97,0,153,0,0,0.0
2021-09-24,212,116,96,0,116,0,0,0.0
2021-09-26,12,12,0,0,12,0,0,0.0
2021-09-27,243,151,92,0,151,0,0,0.0
2021-09-28,216,104,112,0,104,0,0,0.0
2021-09-29,255,147,108,0,147,0,0,0.0
2021-09-30,275,160,115,0,160,0,0,0.0
2021-10-01,164,73,91,0,73,0,0,0.0
2021-10-03,14,12,2,0,12,0,0,0.0
2021-10-04,240,157,83,0,157,0,0,0.0
2021-10-05,271,159,112,0,159,0,0,0.0
2021-10-06,234,122,112,0,122,0,0,0.0
2021-10-07,239,126,113,0,126,0,0,0.0
2021-10-08,244,148,96,0,148,0,0,0.0
2021-10-10,30,12,18,0,12,0,0,0.0
2021-10-11,248,135,113,0,135,0,0,0.0
2021-10-12,164,62,102,0,62,0,0,0.0
2021-10-13,238,126,112,0,126,0,0,0.0
2021-10-14,254,139,115,0,139,0,0,0.0
2021-10-15,244,148,96,0,148,0,0,0.0
2021-10-17,16,12,4,0,12,0,0,0.0
2021-10-18,190,117,73,0,117,0,0,0.0
2021-10-19,233,116,117,0,116,0,0,0.0
2021-10-20,252,136,116,0,136,0,0,0.0
2021-10-21,243,131,112,0,131,0,0,0.0
2021-10-22,226,130,96,0,130,0,0,0.0
2021-10-24,32,12,20,0,12,0,0,0.0
2021-10-25,258,147,111,0,147,0,0,0.0
2021-10-26,225,109,116,0,109,0,0,0.0
2021-10-27,239,126,113,0,126,0,0,0.0
2021-10-28,239,129,110,0,129,0,0,0.0
2021-10-29,245,149,96,0,149,0,0,0.0
2021-10-31,27,12,15,0,12,0,0,0.0
2021-11-01,240,132,108,0,132,0,0,0.0
2021-11-02,249,137,112,0,137,0,0,0.0
2021-11-03,264,154,110,0,154,0,0,0.0
2021-11-04,275,158,117,0,158,0,0,0.0
2021-11-05,219,123,96,0,123,0,0,0.0
2021-11-07,20,0,20,0,0,0,0,0.0
2021-11-08,274,159,115,0,159,0,0,0.0
2021-11-09,256,143,113,0,143,0,0,0.0
2021-11-10,249,155,94,0,155,0,0,0.0
2021-11-11,238,132,106,0,132,0,0,0.0
2021-11-12,235,139,96,0,139,0,0,0.0
2021-11-14,21,0,21,0,0,0,0,0.0
2021-11-15,247,148,99,0,148,0,0,0.0
2021-11-16,258,144,114,0,144,0,0,0.0
2021-11-17,259,154,105,0,154,0,0,0.0
2021-11-18,147,83,64,0,83,0,0,0.0
2021-11-19,244,136,108,0,136,0,0,0.0
2021-11-21,21,0,21,0,0,0,0,0.0
2021-11-22,224,123,101,0,123,0,0,0.0
2021-11-23,196,95,101,0,95,0,0,0.0
2021-11-24,250,157,93,0,157,0,0,0.0
2021-11-25,167,117,50,0,117,0,0,0.0
2021-11-26,216,120,96,0,120,0,0,0.0
2021-11-28,15,0,15,0,0,0,0,0.0
2021-11-29,177,104,73,0,104,0,0,0.0
2021-11-30,274,159,115,0,159,0,0,0.0
2021-12-01,240,131,109,0,131,0,0,0.0
2021-12-02,247,135,112,0,135,0,0,0.0
2021-12-03,232,158,74,0,158,0,0,0.0
2021-12-05,14,0,14,0,0,0,0,0.0
2021-12-06,255,142,113,0,142,0,0,0.0
2021-12-07,203,91,112,0,91,0,0,0.0
2021-12-08,244,154,90,0,154,0,0,0.0
2021-12-09,247,139,108,0,139,0,0,0.0
2021-12-10,253,158,95,0,158,0,0,0.0
2021-12-12,17,0,17,0,0,0,0,0.0
2021-12-13,255,141,114,0,141,0,0,0.0
2021-12-14,258,152,106,0,152,0,0,0.0
2021-12-15,242,137,105,0,137,0,0,0.0
2021-12-16,257,143,114,0,143,0,0,0.0
2021-12-17,254,161,93,0,161,0,0,0.0
2021-12-19,12,0,12,0,0,0,0,0.0
2021-12-20,244,143,101,0,143,0,0,0.0
2021-12-21,263,156,107,0,156,0,0,0.0
2021-12-22,218,139,79,0,139,0,0,0.0
2021-12-23,240,123,117,0,123,0,0,0.0
2021-12-24,220,124,96,0,124,0,0,0.0
2021-12-26,4,0,4,0,0,0,0,0.0
2021-12-27,228,153,75,0,153,0,0,0.0
2021-12-28,245,144,101,0,144,0,0,0.0
2021-12-29,227,111,116,0,111,0,0,0.0
2021-12-30,218,103,115,0,103,0,0,0.0
2021-12-31,221,125,96,0,125,0,0,0.0
2022-01-02,19,0,19,0,0,0,0,0.0
2022-01-03,269,153,116,0,153,0,0,0.0
2022-01-04,272,156,116,0,156,0,0,0.0
2022-01-05,258,141,117,0,141,0,0,0.0
2022-01-06,238,121,117,0,121,0,0,0.0
2022-01-07,255,159,96,0,159,0,0,0.0
2022-01-09,6,0,6,0,0,0,0,0.0
2022-01-10,246,139,107,0,139,0,0,0.0
2022-01-11,265,153,112,0,153,0,0,0.0
2022-01-12,255,147,108,0,147,0,0,0.0
2022-01-13,240,143,97,0,143,0,0,0.0
2022-01-14,244,148,96,0,148,0,0,0.0
2022-01-16,20,0,20,0,0,0,0,0.0
2022-01-17,217,110,107,0,110,0,0,0.0
2022-01-18,254,155,99,0,155,0,0,0.0
2022-01-19,261,146,115,0,146,0,0,0.0
2022-01-20,264,155,109,0,155,0,0,0.0
2022-01-21,231,135,96,0,135,0,0,0.0
2022-01-23,18,0,18,0,0,0,0,0.0
2022-01-24,241,127,114,0,127,0,0,0.0
2022-01-25,264,157,107,0,157,0,0,0.0
2022-01-26,249,148,101,0,148,0,0,0.0
2022-01-27,228,117,111,0,117,0,0,0.0
2022-01-28,245,151,94,0,151,0,0,0.0
2022-01-30,18,0,18,0,0,0,0,0.0
2022-01-31,240,128,112,0,128,0,0,0.0
2022-02-01,252,136,116,0,136,0,0,0.0
2022-02-02,263,152,111,0,152,0,0,0.0
2022-02-03,214,126,88,0,126,0,0,0.0
2022-02-04,250,160,90,0,160,0,0,0.0
2022-02-06,12,0,12,0,0,0,0,0.0
2022-02-07,241,162,79,0,162,0,0,0.0
2022-02-08,269,155,114,0,155,0,0,0.0
2022-02-09,223,112,111,0,112,0,0,0.0
2022-02-10,271,156,115,0,156,0,0,0.0
2022-02-11,177,89,88,0,89,0,0,0.0
2022-02-13,19,0,19,0,0,0,0,0.0
2022-02-14,228,158,70,0,158,0,0,0.0
2022-02-15,226,119,107,0,119,0,0,0.0
2022-02-16,231,123,108,0,123,0,0,0.0
2022-02-17,216,112,104,0,112,0,0,0.0
2022-02-18,175,79,96,0,79,0,0,0.0
2022-02-20,18,0,18,0,0,0,0,0.0
2022-02-21,251,140,111,0,140,0,0,0.0
2022-02-22,252,141,111,0,141,0,0,0.0
2022-02-23,233,135,98,0,135,0,0,0.0
2022-02-24,242,129,113,0,129,0,0,0.0
2022-02-25,234,138,96,0,138,0,0,0.0
2022-02-27,1,0,1,0,0,0,0,0.0
2022-02-28,161,143,18,0,143,0,0,0.0
2022-03-01,248,139,109,0,139,0,0,0.0
2022-03-02,255,145,110,0,145,0,0,0.0
2022-03-03,241,128,113,0,128,0,0,0.0
2022-03-04,239,144,95,0,144,0,0,0.0
2022-03-06,2,0,2,0,0,0,0,0.0
2022-03-07,207,151,56,0,151,0,0,0.0
2022-03-08,241,135,106,0,135,0,0,0.0
2022-03-09,214,100,114,0,100,0,0,0.0
2022-03-10,262,153,109,0,153,0,0,0.0
2022-03-11,251,155,96,0,155,0,0,0.0
2022-03-13,33,12,21,0,12,0,0,0.0
2022-03-14,220,105,115,0,105,0,0,0.0
2022-03-15,242,131,111,0,131,0,0,0.0
2022-03-16,233,105,128,0,105,0,0,0.0
2022-03-17,232,147,85,0,147,0,0,0.0
2022-03-18,202,107,95,0,107,0,0,0.0
2022-03-20,24,12,12,0,12,0,0,0.0
2022-03-21,162,131,31,0,131,0,0,0.0
2022-03-22,251,140,111,0,140,0,0,0.0
2022-03-23,232,135,97,0,135,0,0,0.0
2022-03-24,218,123,95,0,123,0,0,0.0
2022-03-25,208,112,96,0,112,0,0,0.0
2022-03-27,30,12,18,0,12,0,0,0.0
2022-03-28,256,145,111,0,145,0,0,0.0
2022-03-29,194,79,115,0,79,0,0,0.0
2022-03-30,160,55,105,0,55,0,0,0.0
2022-03-31,201,97,104,0,97,0,0,0.0
2022-04-01,241,145,96,0,145,0,0,0.0
2022-04-03,14,12,2,0,12,0,0,0.0
2022-04-04,180,136,44,0,136,0,0,0.0
2022-04-05,246,138,108,0,138,0,0,0.0
2022-04-06,238,137,101,0,137,0,0,0.0
2022-04-07,146,38,108,0,38,0,0,0.0
2022-04-08,183,98,85,0,98,0,0,0.0
2022-04-10,28,12,16,0,12,0,0,0.0
2022-04-11,220,107,113,0,107,0,0,0.0
2022-04-12,227,124,103,0,124,0,0,0.0
2022-04-13,234,126,108,0,126,0,0,0.0
2022-04-14,260,144,116,0,144,0,0,0.0
2022-04-15,186,90,96,0,90,0,0,0.0
2022-04-17,29,10,19,0,10,0,0,0.0
2022-04-18,242,152,90,0,152,0,0,0.0
2022-04-19,230,126,104,0,126,0,0,0.0
2022-04-20,247,158,89,0,158,0,0,0.0
2022-04-21,218,128,90,0,128,0,0,0.0
2022-04-22,236,142,94,0,142,0,0,0.0
2022-04-24,5,3,2,0,3,0,0,0.0
2022-04-25,239,155,84,0,155,0,0,0.0
2022-04-26,222,119,103,0,119,0,0,0.0
2022-04-27,248,141,107,0,141,0,0,0.0
2022-04-28,217,114,103,0,114,0,0,0.0
2022-04-29,232,136,96,0,136,0,0,0.0
2022-05-01,15,12,3,0,12,0,0,0.0
2022-05-02,220,150,70,0,150,0,0,0.0
2022-05-03,231,134,97,0,134,0,0,0.0
2022-05-04,194,123,71,0,123,0,0,0.0
2022-05-05,214,140,74,0,140,0,0,0.0
2022-05-06,203,107,96,0,107,0,0,0.0
2022-05-08,7,6,1,0,6,0,0,0.0
2022-05-09,238,136,102,0,136,0,0,0.0
2022-05-10,229,156,73,0,156,0,0,0.0
2022-05-11,210,157,53,0,157,0,0,0.0
2022-05-12,182,85,97,0,85,0,0,0.0
2022-05-13,226,136,90,0,136,0,0,0.0
2022-05-15,23,11,12,0,11,0,0,0.0
2022-05-16,146,49,97,0,49,0,0,0.0
2022-05-17,261,152,109,0,152,0,0,0.0
2022-05-18,269,160,109,0,160,0,0,0.0
2022-05-19,258,156,102,0,156,0,0,0.0
2022-05-20,180,102,78,0,102,0,0,0.0
2022-05-22,2,2,0,0,2,0,0,0.0
2022-05-23,208,115,93,0,115,0,0,0.0
2022-05-24,233,130,103,0,130,0,0,0.0
2022-05-25,221,108,113,0,108,0,0,0.0
2022-05-26,219,105,114,0,105,0,0,0.0
2022-05-27,213,119,94,0,119,0,0,0.0
2022-05-29,27,8,19,0,8,0,0,0.0
2022-05-30,244,131,113,0,131,0,0,0.0
2022-05-31,220,103,117,0,103,0,0,0.0
2022-06-01,248,139,109,0,139,0,0,0.0
2022-06-02,260,153,107,0,153,0,0,0.0
2022-06-03,208,133,75,0,133,0,0,0.0
2022-06-05,23,12,11,0,12,0,0,0.0
2022-06-06,270,158,112,0,158,0,0,0.0
2022-06-07,246,129,117,0,129,0,0,0.0
2022-06-08,241,126,115,0,126,0,0,0.0
2022-06-09,251,153,98,0,153,0,0,0.0
2022-06-10,222,126,96,0,126,0,0,0.0
2022-06-12,21,12,9,0,12,0,0,0.0
2022-06-13,223,120,103,0,120,0,0,0.0
2022-06-14,261,148,113,0,148,0,0,0.0
2022-06-15,270,142,128,0,142,0,0,0.0
2022-06-16,212,103,109,1,102,1,1,12.224285714287475
2022-06-17,189,93,96,1,92,1,0,-7.814285714286939
2022-06-19,20,12,8,0,12,0,0,0.0
2022-06-20,148,57,91,0,57,0,0,0.0
2022-06-21,211,121,90,0,121,0,0,0.0
2022-06-22,237,123,114,0,123,0,0,0.0
2022-06-23,194,79,115,0,79,0,0,0.0
2022-06-24,221,125,96,0,125,0,0,0.0
2022-06-26,13,1,12,0,1,0,0,0.0
2022-06-27,217,107,110,0,107,0,0,0.0
2022-06-28,182,71,111,0,71,0,0,0.0
2022-06-29,177,74,103,0,74,0,0,0.0
2022-06-30,223,147,76,0,147,0,0,0.0
2022-07-01,178,82,96,0,82,0,0,0.0
2022-07-03,18,0,18,0,0,0,0,0.0
2022-07-04,236,134,102,0,134,0,0,0.0
2022-07-05,197,80,117,0,80,0,0,0.0
2022-07-06,241,128,113,0,128,0,0,0.0
2022-07-07,249,138,111,0,138,0,0,0.0
2022-07-08,226,136,90,0,136,0,0,0.0
2022-07-10,33,12,21,0,12,0,0,0.0
2022-07-11,264,154,110,0,154,0,0,0.0
2022-07-12,231,122,109,0,122,0,0,0.0
2022-07-13,251,138,113,0,138,0,0,0.0
2022-07-14,258,147,111,0,147,0,0,0.0
2022-07-15,204,121,83,0,121,0,0,0.0
2022-07-17,25,10,15,0,10,0,0,0.0
2022-07-18,271,156,115,0,156,0,0,0.0
2022-07-19,244,136,108,0,136,0,0,0.0
2022-07-20,252,137,115,0,137,0,0,0.0
2022-07-21,263,153,110,0,153,0,0,0.0
2022-07-22,228,143,85,0,143,0,0,0.0
2022-07-24,32,12,20,0,12,0,0,0.0
2022-07-25,231,132,99,0,132,0,0,0.0
2022-07-26,244,138,106,0,138,0,0,0.0
2022-07-27,256,153,103,0,153,0,0,0.0
2022-07-28,194,91,103,0,91,0,0,0.0
2022-07-29,209,137,72,0,137,0,0,0.0
2022-07-31,27,12,15,0,12,0,0,0.0
2022-08-01,245,131,114,0,131,0,0,0.0
2022-08-02,236,130,106,0,130,0,0,0.0
2022-08-03,220,145,75,0,145,0,0,0.0
2022-08-04,258,147,111,0,147,0,0,0.0
2022-08-05,233,140,93,0,140,0,0,0.0
2022-08-07,22,12,10,0,12,0,0,0.0
2022-08-08,194,135,59,0,135,0,0,0.0
2022-08-09,178,73,105,0,73,0,0,0.0
2022-08-10,229,128,101,0,128,0,0,0.0
2022-08-11,246,152,94,0,152,0,0,0.0
2022-08-12,225,129,96,0,129,0,0,0.0
2022-08-14,27,11,16,0,11,0,0,0.0
2022-08-15,257,144,113,0,144,0,0,0.0
2022-08-16,256,149,107,0,149,0,0,0.0
2022-08-17,216,112,104,0,112,0,0,0.0
2022-08-18,233,132,101,0,132,0,0,0.0
2022-08-19,186,90,96,0,90,0,0,0.0
2022-08-21,11,0,11,0,0,0,0,0.0
2022-08-22,261,149,112,0,149,0,0,0.0
2022-08-23,263,148,115,0,148,0,0,0.0
2022-08-24,183,68,115,0,68,0,0,0.0
2022-08-25,213,99,114,0,99,0,0,0.0
2022-08-26,234,138,96,0,138,0,0,0.0
2022-08-28,26,12,14,0,12,0,0,0.0
2022-08-29,259,158,101,0,158,0,0,0.0
2022-08-30,222,112,110,0,112,0,0,0.0
2022-08-31,262,155,107,0,155,0,0,0.0
2022-09-01,252,143,109,0,143,0,0,0.0
2022-09-02,229,137,92,0,137,0,0,0.0
2022-09-04,30,12,18,0,12,0,0,0.0
2022-09-05,198,114,84,0,114,0,0,0.0
2022-09-06,260,149,111,0,149,0,0,0.0
2022-09-07,271,154,117,0,154,0,0,0.0
2022-09-08,193,82,111,0,82,0,0,0.0
2022-09-09,228,132,96,0,132,0,0,0.0
2022-09-11,18,4,14,0,4,0,0,0.0
2022-09-12,216,122,94,0,122,0,0,0.0
2022-09-13,188,94,94,0,94,0,0,0.0
2022-09-14,174,74,100,0,74,0,0,0.0
2022-09-15,192,93,99,0,93,0,0,0.0
2022-09-16,240,149,91,0,149,0,0,0.0
2022-09-18,29,11,18,0,11,0,0,0.0
2022-09-19,234,126,108,0,126,0,0,0.0
2022-09-20,168,58,110,0,58,0,0,0.0
2022-09-21,253,126,127,0,126,0,0,0.0
2022-09-22,202,105,97,1,104,1,1,23.79142857143063
2022-09-23,198,106,92,1,105,1,0,-9.171428571426532
2022-09-25,20,12,8,0,12,0,0,0.0
2022-09-26,260,150,110,0,150,0,0,0.0
2022-09-27,243,131,112,0,131,0,0,0.0
2022-09-28,263,153,110,0,153,0,0,0.0
2022-09-29,186,87,99,0,87,0,0,0.0
2022-09-30,214,128,86,0,128,0,0,0.0
2022-10-02,27,11,16,0,11,0,0,0.0
2022-10-03,263,149,114,0,149,0,0,0.0
2022-10-04,266,157,109,0,157,0,0,0.0
2022-10-05,174,95,79,0,95,0,0,0.0
2022-10-06,219,154,65,0,154,0,0,0.0
2022-10-07,180,117,63,0,117,0,0,0.0
2022-10-09,15,6,9,0,6,0,0,0.0
2022-10-10,235,142,93,0,142,0,0,0.0
2022-10-11,220,122,98,0,122,0,0,0.0
2022-10-12,243,128,115,0,128,0,0,0.0
2022-10-13,204,146,58,0,146,0,0,0.0
2022-10-14,238,147,91,0,147,0,0,0.0
2022-10-16,25,12,13,0,12,0,0,0.0
2022-10-17,251,153,98,0,153,0,0,0.0
2022-10-18,256,149,107,0,149,0,0,0.0
2022-10-19,213,147,66,0,147,0,0,0.0
2022-10-20,236,127,109,0,127,0,0,0.0
2022-10-21,230,134,96,0,134,0,0,0.0
2022-10-23,25,11,14,0,11,0,0,0.0
2022-10-24,197,155,42,0,155,0,0,0.0
2022-10-25,216,136,80,0,136,0,0,0.0
2022-10-26,171,128,43,0,128,0,0,0.0
2022-10-27,177,86,91,0,86,0,0,0.0
2022-10-28,160,83,77,0,83,0,0,0.0
2022-10-30,10,6,4,0,6,0,0,0.0
2022-10-31,230,116,114,0,116,0,0,0.0
2022-11-01,260,151,109,0,151,0,0,0.0
2022-11-02,239,123,116,0,123,0,0,0.0
2022-11-03,226,124,102,0,124,0,0,0.0
2022-11-04,117,61,56,0,61,0,0,0.0
2022-11-06,0,0,0,0,0,0,0,0.0
2022-11-07,152,84,68,0,84,0,0,0.0
2022-11-08,261,150,111,0,150,0,0,0.0
2022-11-09,231,122,109,0,122,0,0,0.0
2022-11-10,269,136,133,0,136,0,0,0.0
2022-11-11,227,131,96,1,130,1,1,19.1457142857156
2022-11-13,0,0,0,0,0,0,0,0.0
2022-11-14,126,92,34,1,91,1,1,9.035714285715358
2022-11-15,208,99,109,1,98,1,0,-10.845714285713825
2022-11-16,189,75,114,0,75,0,0,0.0
2022-11-17,245,136,109,0,136,0,0,0.0
2022-11-18,213,117,96,0,117,0,0,0.0
2022-11-20,19,0,19,0,0,0,0,0.0
2022-11-21,242,142,100,0,142,0,0,0.0
2022-11-22,263,147,116,0,147,0,0,0.0
2022-11-23,266,158,108,0,158,0,0,0.0
2022-11-24,263,152,111,0,152,0,0,0.0
2022-11-25,242,149,93,0,149,0,0,0.0
2022-11-27,10,0,10,0,0,0,0,0.0
2022-11-28,232,128,104,0,128,0,0,0.0
2022-11-29,237,126,111,0,126,0,0,0.0
2022-11-30,263,153,110,0,153,0,0,0.0
2022-12-01,261,145,116,0,145,0,0,0.0
2022-12-02,255,159,96,0,159,0,0,0.0
2022-12-04,2,0,2,0,0,0,0,0.0
2022-12-05,223,158,65,0,158,0,0,0.0
2022-12-06,252,146,106,0,146,0,0,0.0
2022-12-07,218,113,105,0,113,0,0,0.0
2022-12-08,210,102,108,0,102,0,0,0.0
2022-12-09,247,151,96,0,151,0,0,0.0
2022-12-11,17,0,17,0,0,0,0,0.0
2022-12-12,222,110,112,0,110,0,0,0.0
2022-12-13,272,150,122,0,150,0,0,0.0
2022-12-14,241,134,107,0,134,0,0,0.0
2022-12-15,276,161,115,0,161,0,0,0.0
2022-12-16,222,126,96,0,126,0,0,0.0
2022-12-18,15,0,15,0,0,0,0,0.0
2022-12-19,195,159,36,0,159,0,0,0.0
2022-12-20,213,102,111,1,101,1,0,-10.628571428572286
2022-12-21,254,154,100,0,154,0,0,0.0
2022-12-22,244,130,114,0,130,0,0,0.0
2022-12-23,224,128,96,0,128,0,0,0.0
2022-12-25,11,0,11,0,0,0,0,0.0
2022-12-26,271,159,112,0,159,0,0,0.0
2022-12-27,240,147,93,0,147,0,0,0.0
2022-12-28,259,142,117,0,142,0,0,0.0
2022-12-29,229,120,109,0,120,0,0,0.0
2022-12-30,231,135,96,0,135,0,0,0.0
2023-01-01,8,0,8,0,0,0,0,0.0
2023-01-02,167,127,40,0,127,0,0,0.0
2023-01-03,214,100,114,0,100,0,0,0.0
2023-01-04,268,157,111,0,157,0,0,0.0
2023-01-05,163,58,105,0,58,0,0,0.0
2023-01-06,229,133,96,0,133,0,0,0.0
2023-01-08,19,0,19,0,0,0,0,0.0
2023-01-09,255,153,102,0,153,0,0,0.0
2023-01-10,204,130,74,0,130,0,0,0.0
2023-01-11,247,143,104,0,143,0,0,0.0
2023-01-12,266,151,115,0,151,0,0,0.0
2023-01-13,214,129,85,0,129,0,0,0.0
2023-01-15,20,0,20,0,0,0,0,0.0
2023-01-16,194,78,116,0,78,0,0,0.0
2023-01-17,253,136,117,0,136,0,0,0.0
2023-01-18,264,150,114,0,150,0,0,0.0
2023-01-19,222,112,110,0,112,0,0,0.0
2023-01-20,253,157,96,0,157,0,0,0.0
2023-01-22,19,0,19,0,0,0,0,0.0
2023-01-23,259,150,109,0,150,0,0,0.0
2023-01-24,265,156,109,0,156,0,0,0.0
2023-01-25,267,156,111,0,156,0,0,0.0
2023-01-26,256,144,112,0,144,0,0,0.0
2023-01-27,148,52,96,0,52,0,0,0.0
2023-01-29,8,0,8,0,0,0,0,0.0
2023-01-30,271,157,114,0,157,0,0,0.0
2023-01-31,275,160,115,0,160,0,0,0.0
2023-02-01,261,150,111,0,150,0,0,0.0
2023-02-02,238,128,110,0,128,0,0,0.0
2023-02-03,243,126,117,0,126,0,0,0.0
2023-02-05,7,0,7,0,0,0,0,0.0
2023-02-06,195,153,42,0,153,0,0,0.0
2023-02-07,248,150,98,0,150,0,0,0.0
2023-02-08,239,146,93,0,146,0,0,0.0
2023-02-09,247,147,100,0,147,0,0,0.0
2023-02-10,245,151,94,0,151,0,0,0.0
2023-02-12,20,0,20,0,0,0,0,0.0
2023-02-13,221,117,104,0,117,0,0,0.0
2023-02-14,248,137,111,0,137,0,0,0.0
2023-02-15,244,136,108,0,136,0,0,0.0
2023-02-16,226,121,105,0,121,0,0,0.0
2023-02-17,231,135,96,0,135,0,0,0.0
2023-02-19,19,0,19,0,0,0,0,0.0
2023-02-20,217,115,102,0,115,0,0,0.0
2023-02-21,218,111,107,0,111,0,0,0.0
2023-02-22,253,151,102,0,151,0,0,0.0
2023-02-23,244,142,102,0,142,0,0,0.0
2023-02-24,238,154,84,0,154,0,0,0.0
2023-02-26,19,0,19,0,0,0,0,0.0
2023-02-27,266,160,106,0,160,0,0,0.0
2023-02-28,234,136,98,0,136,0,0,0.0
2023-03-01,272,156,116,0,156,0,0,0.0
2023-03-02,210,108,102,0,108,0,0,0.0
2023-03-03,201,144,57,0,144,0,0,0.0
2023-03-05,18,0,18,0,0,0,0,0.0
2023-03-06,222,111,111,0,111,0,0,0.0
2023-03-07,257,144,113,0,144,0,0,0.0
2023-03-08,218,111,107,0,111,0,0,0.0
2023-03-09,258,147,111,0,147,0,0,0.0
2023-03-10,256,160,96,0,160,0,0,0.0
2023-03-12,33,12,21,0,12,0,0,0.0
2023-03-13,230,153,77,0,153,0,0,0.0
2023-03-14,207,92,115,0,92,0,0,0.0
2023-03-15,254,147,107,0,147,0,0,0.0
2023-03-16,226,114,112,0,114,0,0,0.0
2023-03-17,200,104,96,0,104,0,0,0.0
2023-03-19,30,12,18,0,12,0,0,0.0
2023-03-20,164,81,83,0,81,0,0,0.0
2023-03-21,236,140,96,0,140,0,0,0.0
2023-03-22,235,136,99,0,136,0,0,0.0
2023-03-23,273,162,111,0,162,0,0,0.0
2023-03-24,229,134,95,0,134,0,0,0.0
2023-03-26,16,12,4,0,12,0,0,0.0
2023-03-27,206,145,61,0,145,0,0,0.0
2023-03-28,250,137,113,0,137,0,0,0.0
2023-03-29,262,148,114,0,148,0,0,0.0
2023-03-30,261,145,116,0,145,0,0,0.0
2023-03-31,229,133,96,0,133,0,0,0.0
2023-04-02,15,12,3,0,12,0,0,0.0
2023-04-03,254,152,102,0,152,0,0,0.0
2023-04-04,267,162,105,0,162,0,0,0.0
2023-04-05,234,137,97,0,137,0,0,0.0
2023-04-06,188,89,99,0,89,0,0,0.0
2023-04-07,142,67,75,0,67,0,0,0.0
2023-04-09,8,0,8,0,0,0,0,0.0
2023-04-10,243,143,100,0,143,0,0,0.0
2023-04-11,267,152,115,0,152,0,0,0.0
2023-04-12,247,141,106,0,141,0,0,0.0
2023-04-13,181,127,54,0,127,0,0,0.0
2023-04-14,240,145,95,0,145,0,0,0.0
2023-04-16,31,10,21,0,10,0,0,0.0
2023-04-17,216,130,86,0,130,0,0,0.0
2023-04-18,238,149,89,0,149,0,0,0.0
2023-04-19,236,140,96,0,140,0,0,0.0
2023-04-20,181,99,82,0,99,0,0,0.0
2023-04-21,239,143,96,0,143,0,0,0.0
2023-04-23,29,12,17,0,12,0,0,0.0
2023-04-24,246,154,92,0,154,0,0,0.0
2023-04-25,199,111,88,0,111,0,0,0.0
2023-04-26,236,121,115,0,121,0,0,0.0
2023-04-27,157,61,96,0,61,0,0,0.0
2023-04-28,222,134,88,0,134,0,0,0.0
2023-04-30,23,12,11,0,12,0,0,0.0
2023-05-01,247,139,108,0,139,0,0,0.0
2023-05-02,261,155,106,0,155,0,0,0.0
2023-05-03,224,126,98,0,126,0,0,0.0
2023-05-04,188,144,44,0,144,0,0,0.0
2023-05-05,164,68,96,0,68,0,0,0.0
2023-05-07,18,0,18,0,0,0,0,0.0
2023-05-08,223,133,90,0,133,0,0,0.0
2023-05-09,198,99,99,0,99,0,0,0.0
2023-05-10,176,74,102,0,74,0,0,0.0
2023-05-11,259,152,107,0,152,0,0,0.0
2023-05-12,206,120,86,0,120,0,0,0.0
2023-05-14,18,12,6,0,12,0,0,0.0
2023-05-15,207,102,105,0,102,0,0,0.0
2023-05-16,256,143,113,0,143,0,0,0.0
2023-05-17,226,129,97,0,129,0,0,0.0
2023-05-18,205,121,84,0,121,0,0,0.0
2023-05-19,227,131,96,0,131,0,0,0.0
2023-05-21,33,12,21,0,12,0,0,0.0
2023-05-22,236,145,91,0,145,0,0,0.0
2023-05-23,151,48,103,0,48,0,0,0.0
2023-05-24,266,156,110,0,156,0,0,0.0
2023-05-25,248,140,108,0,140,0,0,0.0
2023-05-26,239,145,94,0,145,0,0,0.0
2023-05-28,14,12,2,0,12,0,0,0.0
2023-05-29,265,158,107,0,158,0,0,0.0
2023-05-30,217,122,95,0,122,0,0,0.0
2023-05-31,233,141,92,0,141,0,0,0.0
2023-06-01,251,145,106,0,145,0,0,0.0
2023-06-02,240,147,93,0,147,0,0,0.0
2023-06-04,24,12,12,0,12,0,0,0.0
2023-06-05,212,120,92,0,120,0,0,0.0
2023-06-06,160,86,74,0,86,0,0,0.0
2023-06-07,271,157,114,0,157,0,0,0.0
2023-06-08,257,148,109,0,148,0,0,0.0
2023-06-09,220,124,96,0,124,0,0,0.0
2023-06-11,15,6,9,0,6,0,0,0.0
2023-06-12,248,161,87,0,161,0,0,0.0
2023-06-13,236,128,108,0,128,0,0,0.0
2023-06-14,242,130,112,0,130,0,0,0.0
2023-06-15,248,135,113,0,135,0,0,0.0
2023-06-16,238,143,95,0,143,0,0,0.0
2023-06-18,24,12,12,0,12,0,0,0.0
2023-06-19,225,154,71,0,154,0,0,0.0
2023-06-20,266,158,108,0,158,0,0,0.0
2023-06-21,249,133,116,0,133,0,0,0.0
2023-06-22,241,157,84,0,157,0,0,0.0
2023-06-23,235,145,90,0,145,0,0,0.0
2023-06-25,24,11,13,0,11,0,0,0.0
2023-06-26,240,131,109,0,131,0,0,0.0
2023-06-27,247,148,99,0,148,0,0,0.0
2023-06-28,200,103,97,0,103,0,0,0.0
2023-06-29,132,50,82,0,50,0,0,0.0
2023-06-30,225,142,83,0,142,0,0,0.0
2023-07-02,24,12,12,0,12,0,0,0.0
2023-07-03,230,130,100,0,130,0,0,0.0
2023-07-04,243,154,89,0,154,0,0,0.0
2023-07-05,240,130,110,0,130,0,0,0.0
2023-07-06,203,89,114,0,89,0,0,0.0
2023-07-07,231,137,94,0,137,0,0,0.0
2023-07-09,10,10,0,0,10,0,0,0.0
2023-07-10,245,145,100,0,145,0,0,0.0
2023-07-11,226,115,111,0,115,0,0,0.0
2023-07-12,251,137,114,0,137,0,0,0.0
2023-07-13,265,159,106,0,159,0,0,0.0
2023-07-14,217,122,95,0,122,0,0,0.0
2023-07-16,14,11,3,0,11,0,0,0.0
2023-07-17,247,142,105,0,142,0,0,0.0
2023-07-18,247,138,109,0,138,0,0,0.0
2023-07-19,223,115,108,0,115,0,0,0.0
2023-07-20,260,151,109,0,151,0,0,0.0
2023-07-21,201,108,93,0,108,0,0,0.0
2023-07-23,23,12,11,0,12,0,0,0.0
2023-07-24,270,155,115,0,155,0,0,0.0
2023-07-25,209,121,88,0,121,0,0,0.0
2023-07-26,254,147,107,0,147,0,0,0.0
2023-07-27,243,149,94,0,149,0,0,0.0
2023-07-28,172,123,49,0,123,0,0,0.0
2023-07-30,33,12,21,0,12,0,0,0.0
2023-07-31,235,129,106,0,129,0,0,0.0
2023-08-01,241,139,102,0,139,0,0,0.0
2023-08-02,247,145,102,0,145,0,0,0.0
2023-08-03,205,99,106,0,99,0,0,0.0
2023-08-04,215,124,91,0,124,0,0,0.0
2023-08-06,26,12,14,0,12,0,0,0.0
2023-08-07,236,130,106,0,130,0,0,0.0
2023-08-08,223,110,113,0,110,0,0,0.0
2023-08-09,260,153,107,0,153,0,0,0.0
2023-08-10,249,135,114,0,135,0,0,0.0
2023-08-11,162,103,59,0,103,0,0,0.0
2023-08-13,25,11,14,0,11,0,0,0.0
2023-08-14,215,143,72,0,143,0,0,0.0
2023-08-15,191,79,112,0,79,0,0,0.0
2023-08-16,234,131,103,0,131,0,0,0.0
2023-08-17,258,142,116,0,142,0,0,0.0
2023-08-18,242,146,96,0,146,0,0,0.0
2023-08-20,30,12,18,0,12,0,0,0.0
2023-08-21,185,121,64,0,121,0,0,0.0
2023-08-22,256,144,112,0,144,0,0,0.0
2023-08-23,258,149,109,0,149,0,0,0.0
2023-08-24,200,91,109,0,91,0,0,0.0
2023-08-25,225,130,95,0,130,0,0,0.0
2023-08-27,32,12,20,0,12,0,0,0.0
2023-08-28,212,103,109,0,103,0,0,0.0
2023-08-29,249,156,93,0,156,0,0,0.0
2023-08-30,245,128,117,0,128,0,0,0.0
2023-08-31,228,128,100,0,128,0,0,0.0
2023-09-01,193,120,73,0,120,0,0,0.0
2023-09-03,27,12,15,0,12,0,0,0.0
2023-09-04,207,124,83,0,124,0,0,0.0
2023-09-05,272,155,117,0,155,0,0,0.0
2023-09-06,254,138,116,0,138,0,0,0.0
2023-09-07,182,68,114,0,68,0,0,0.0
2023-09-08,229,133,96,0,133,0,0,0.0
2023-09-10,21,12,9,0,12,0,0,0.0
2023-09-11,198,118,80,0,118,0,0,0.0
2023-09-12,214,103,111,0,103,0,0,0.0
2023-09-13,184,79,105,0,79,0,0,0.0
2023-09-14,218,117,101,0,117,0,0,0.0
2023-09-15,128,55,73,0,55,0,0,0.0
2023-09-17,33,12,21,0,12,0,0,0.0
2023-09-18,248,143,105,0,143,0,0,0.0
2023-09-19,248,140,108,0,140,0,0,0.0
2023-09-20,265,156,109,0,156,0,0,0.0
2023-09-21,262,154,108,0,154,0,0,0.0
2023-09-22,222,126,96,0,126,0,0,0.0
2023-09-24,28,12,16,0,12,0,0,0.0
2023-09-25,219,156,63,0,156,0,0,0.0
2023-09-26,209,96,113,0,96,0,0,0.0
2023-09-27,230,155,75,0,155,0,0,0.0
2023-09-28,200,97,103,0,97,0,0,0.0
2023-09-29,237,141,96,0,141,0,0,0.0
2023-10-01,29,12,17,0,12,0,0,0.0
2023-10-02,243,135,108,0,135,0,0,0.0
2023-10-03,259,138,121,0,138,0,0,0.0
2023-10-04,255,140,115,0,140,0,0,0.0
2023-10-05,265,152,113,0,152,0,0,0.0
2023-10-06,189,93,96,0,93,0,0,0.0
2023-10-08,18,12,6,0,12,0,0,0.0
2023-10-09,165,151,14,0,151,0,0,0.0
2023-10-10,246,143,103,0,143,0,0,0.0
2023-10-11,224,124,100,0,124,0,0,0.0
2023-10-12,228,136,92,0,136,0,0,0.0
2023-10-13,190,100,90,0,100,0,0,0.0
2023-10-15,25,11,14,0,11,0,0,0.0
2023-10-16,197,144,53,0,144,0,0,0.0
2023-10-17,145,83,62,0,83,0,0,0.0
2023-10-18,260,152,108,0,152,0,0,0.0
2023-10-19,216,141,75,0,141,0,0,0.0
2023-10-20,245,149,96,0,149,0,0,0.0
2023-10-22,14,12,2,0,12,0,0,0.0
2023-10-23,233,149,84,0,149,0,0,0.0
2023-10-24,240,146,94,0,146,0,0,0.0
2023-10-25,220,150,70,0,150,0,0,0.0
2023-10-26,236,135,101,0,135,0,0,0.0
2023-10-27,239,147,92,0,147,0,0,0.0
2023-10-29,30,12,18,0,12,0,0,0.0
2023-10-30,231,155,76,0,155,0,0,0.0
2023-10-31,263,148,115,0,148,0,0,0.0
2023-11-01,267,150,117,0,150,0,0,0.0
2023-11-02,260,149,111,0,149,0,0,0.0
2023-11-03,172,82,90,0,82,0,0,0.0
2023-11-05,16,0,16,0,0,0,0,0.0
2023-11-06,189,83,106,0,83,0,0,0.0
2023-11-07,232,132,100,0,132,0,0,0.0
2023-11-08,253,151,102,0,151,0,0,0.0
2023-11-09,217,157,60,0,157,0,0,0.0
2023-11-10,248,158,90,0,158,0,0,0.0
2023-11-12,20,0,20,0,0,0,0,0.0
2023-11-13,220,123,97,0,123,0,0,0.0
2023-11-14,218,139,79,0,139,0,0,0.0
2023-11-15,275,160,115,0,160,0,0,0.0
2023-11-16,243,161,82,0,161,0,0,0.0
2023-11-17,187,158,29,0,158,0,0,0.0
2023-11-19,17,0,17,0,0,0,0,0.0
2023-11-20,198,94,104,0,94,0,0,0.0
2023-11-21,266,150,116,0,150,0,0,0.0
2023-11-22,267,159,108,0,159,0,0,0.0
2023-11-23,213,103,110,0,103,0,0,0.0
2023-11-24,181,107,74,0,107,0,0,0.0
2023-11-26,12,0,12,0,0,0,0,0.0
2023-11-27,209,103,106,0,103,0,0,0.0
2023-11-28,236,128,108,0,128,0,0,0.0
2023-11-29,264,147,117,0,147,0,0,0.0
2023-11-30,267,159,108,0,159,0,0,0.0
2023-12-01,240,144,96,0,144,0,0,0.0
2023-12-03,13,0,13,0,0,0,0,0.0
2023-12-04,252,153,99,0,153,0,0,0.0
2023-12-05,238,155,83,0,155,0,0,0.0
2023-12-06,194,101,93,0,101,0,0,0.0
2023-12-07,277,152,125,0,152,0,0,0.0
2023-12-08,248,147,101,0,147,0,0,0.0
2023-12-10,6,0,6,0,0,0,0,0.0
2023-12-11,240,129,111,0,129,0,0,0.0
2023-12-12,264,148,116,0,148,0,0,0.0
2023-12-13,254,121,133,0,121,0,0,0.0
2023-12-14,206,91,115,0,91,0,0,0.0
2023-12-15,243,150,93,0,150,0,0,0.0
2023-12-17,18,0,18,0,0,0,0,0.0
2023-12-18,253,144,109,0,144,0,0,0.0
2023-12-19,269,154,115,0,154,0,0,0.0
2023-12-20,259,153,106,0,153,0,0,0.0
2023-12-21,250,155,95,0,155,0,0,0.0
2023-12-22,246,156,90,0,156,0,0,0.0
2023-12-24,0,0,0,0,0,0,0,0.0
2023-12-25,91,0,91,0,0,0,0,0.0
2023-12-26,222,150,72,0,150,0,0,0.0
2023-12-27,211,95,116,0,95,0,0,0.0
2023-12-28,240,134,106,0,134,0,0,0.0
2023-12-29,240,158,82,0,158,0,0,0.0
2024-01-01,15,0,15,0,0,0,0,0.0
2024-01-02,247,137,110,0,137,0,0,0.0
2024-01-03,249,160,89,0,160,0,0,0.0
2024-01-04,270,160,110,0,160,0,0,0.0
2024-01-05,251,155,96,0,155,0,0,0.0
2024-01-07,15,0,15,0,0,0,0,0.0
2024-01-08,201,135,66,0,135,0,0,0.0
2024-01-09,254,139,115,0,139,0,0,0.0
2024-01-10,236,134,102,0,134,0,0,0.0
2024-01-11,239,113,126,0,113,0,0,0.0
2024-01-12,233,137,96,0,137,0,0,0.0
2024-01-14,16,0,16,0,0,0,0,0.0
2024-01-15,270,153,117,0,153,0,0,0.0
2024-01-16,272,157,115,0,157,0,0,0.0
2024-01-17,242,145,97,0,145,0,0,0.0
2024-01-18,236,140,96,0,140,0,0,0.0
2024-01-19,223,128,95,0,128,0,0,0.0
2024-01-21,1,0,1,0,0,0,0,0.0
2024-01-22,208,139,69,0,139,0,0,0.0
2024-01-23,237,147,90,0,147,0,0,0.0
2024-01-24,254,147,107,0,147,0,0,0.0
2024-01-25,235,127,108,0,127,0,0,0.0
2024-01-26,220,150,70,0,150,0,0,0.0
2024-01-28,15,0,15,0,0,0,0,0.0
2024-01-29,238,128,110,0,128,0,0,0.0
2024-01-30,213,104,109,0,104,0,0,0.0
2024-01-31,268,160,108,0,160,0,0,0.0
2024-02-01,239,139,100,0,139,0,0,0.0
2024-02-02,186,153,33,0,153,0,0,0.0
2024-02-04,18,0,18,0,0,0,0,0.0
2024-02-05,200,114,86,0,114,0,0,0.0
2024-02-06,257,144,113,0,144,0,0,0.0
2024-02-07,238,133,105,0,133,0,0,0.0
2024-02-08,243,134,109,0,134,0,0,0.0
2024-02-09,217,127,90,0,127,0,0,0.0
2024-02-11,13,0,13,0,0,0,0,0.0
2024-02-12,216,131,85,0,131,0,0,0.0
2024-02-13,248,139,109,0,139,0,0,0.0
2024-02-14,240,127,113,0,127,0,0,0.0
2024-02-15,260,149,111,0,149,0,0,0.0
2024-02-16,237,141,96,0,141,0,0,0.0
2024-02-18,3,0,3,0,0,0,0,0.0
2024-02-19,211,103,108,0,103,0,0,0.0
2024-02-20,268,156,112,0,156,0,0,0.0
2024-02-21,259,158,101,0,158,0,0,0.0
2024-02-22,254,158,96,0,158,0,0,0.0
2024-02-23,185,112,73,0,112,0,0,0.0
2024-02-25,11,0,11,0,0,0,0,0.0
2024-02-26,182,158,24,0,158,0,0,0.0
2024-02-27,260,157,103,0,157,0,0,0.0
2024-02-28,191,85,106,0,85,0,0,0.0
2024-02-29,266,158,108,0,158,0,0,0.0
2024-03-01,248,152,96,0,152,0,0,0.0
2024-03-03,15,0,15,0,0,0,0,0.0
2024-03-04,204,102,102,0,102,0,0,0.0
2024-03-05,196,114,82,0,114,0,0,0.0
2024-03-06,263,154,109,0,154,0,0,0.0
2024-03-07,262,148,114,0,148,0,0,0.0
2024-03-08,242,154,88,0,154,0,0,0.0
2024-03-10,28,12,16,0,12,0,0,0.0
2024-03-11,217,145,72,0,145,0,0,0.0
2024-03-12,144,43,101,0,43,0,0,0.0
2024-03-13,258,160,98,0,160,0,0,0.0
2024-03-14,258,146,112,0,146,0,0,0.0
2024-03-15,206,113,93,0,113,0,0,0.0
2024-03-17,13,12,1,0,12,0,0,0.0
2024-03-18,212,114,98,0,114,0,0,0.0
2024-03-19,257,144,113,0,144,0,0,0.0
2024-03-20,271,151,120,0,151,0,0,0.0
2024-03-21,265,152,113,0,152,0,0,0.0
2024-03-22,228,132,96,0,132,0,0,0.0
2024-03-24,26,11,15,0,11,0,0,0.0
2024-03-25,241,137,104,0,137,0,0,0.0
2024-03-26,222,124,98,0,124,0,0,0.0
2024-03-27,233,131,102,0,131,0,0,0.0
2024-03-28,179,112,67,0,112,0,0,0.0
2024-03-29,202,109,93,0,109,0,0,0.0
2024-03-31,29,12,17,0,12,0,0,0.0
2024-04-01,250,154,96,0,154,0,0,0.0
2024-04-02,225,126,99,0,126,0,0,0.0
2024-04-03,235,153,82,0,153,0,0,0.0
2024-04-04,206,111,95,0,111,0,0,0.0
2024-04-05,179,102,77,0,102,0,0,0.0
2024-04-07,12,12,0,0,12,0,0,0.0
2024-04-08,210,110,100,0,110,0,0,0.0
2024-04-09,246,149,97,0,149,0,0,0.0
2024-04-10,217,147,70,0,147,0,0,0.0
2024-04-11,221,139,82,0,139,0,0,0.0
2024-04-12,211,141,70,0,141,0,0,0.0
2024-04-14,32,12,20,0,12,0,0,0.0
2024-04-15,134,36,98,0,36,0,0,0.0
2024-04-16,215,117,98,0,117,0,0,0.0
2024-04-17,225,129,96,0,129,0,0,0.0
2024-04-18,273,159,114,0,159,0,0,0.0
2024-04-19,167,76,91,0,76,0,0,0.0
2024-04-21,7,7,0,0,7,0,0,0.0
2024-04-22,213,153,60,0,153,0,0,0.0
2024-04-23,212,116,96,0,116,0,0,0.0
2024-04-24,242,145,97,0,145,0,0,0.0
2024-04-25,148,47,101,0,47,0,0,0.0
2024-04-26,205,121,84,0,121,0,0,0.0
2024-04-28,13,12,1,0,12,0,0,0.0
2024-04-29,227,138,89,0,138,0,0,0.0
2024-04-30,207,111,96,0,111,0,0,0.0
2024-05-01,229,108,121,0,108,0,0,0.0
2024-05-02,265,157,108,0,157,0,0,0.0
2024-05-03,241,145,96,0,145,0,0,0.0
2024-05-05,32,12,20,0,12,0,0,0.0
2024-05-06,269,155,114,0,155,0,0,0.0
2024-05-07,262,149,113,0,149,0,0,0.0
2024-05-08,229,114,115,0,114,0,0,0.0
2024-05-09,238,141,97,0,141,0,0,0.0
2024-05-10,173,78,95,0,78,0,0,0.0
2024-05-12,21,1,20,0,1,0,0,0.0
2024-05-13,227,115,112,0,115,0,0,0.0
2024-05-14,138,32,106,0,32,0,0,0.0
2024-05-15,259,160,99,0,160,0,0,0.0
2024-05-16,220,109,111,0,109,0,0,0.0
2024-05-17,205,109,96,0,109,0,0,0.0
2024-05-19,33,12,21,0,12,0,0,0.0
2024-05-20,227,115,112,0,115,0,0,0.0
2024-05-21,189,75,114,0,75,0,0,0.0
2024-05-22,264,158,106,0,158,0,0,0.0
2024-05-23,230,152,78,0,152,0,0,0.0
2024-05-24,241,146,95,0,146,0,0,0.0
2024-05-26,14,12,2,0,12,0,0,0.0
2024-05-27,230,144,86,0,144,0,0,0.0
2024-05-28,268,158,110,0,158,0,0,0.0
2024-05-29,246,150,96,0,150,0,0,0.0
2024-05-30,226,120,106,0,120,0,0,0.0
2024-05-31,202,125,77,0,125,0,0,0.0
2024-06-02,18,12,6,0,12,0,0,0.0
2024-06-03,226,154,72,0,154,0,0,0.0
2024-06-04,262,156,106,0,156,0,0,0.0
2024-06-05,198,86,112,0,86,0,0,0.0
2024-06-06,266,159,107,0,159,0,0,0.0
2024-06-07,199,103,96,0,103,0,0,0.0
2024-06-09,16,2,14,0,2,0,0,0.0
2024-06-10,202,96,106,0,96,0,0,0.0
2024-06-11,262,148,114,0,148,0,0,0.0
2024-06-12,269,149,120,0,149,0,0,0.0
2024-06-13,241,129,112,0,129,0,0,0.0
2024-06-14,167,71,96,0,71,0,0,0.0
2024-06-16,24,5,19,0,5,0,0,0.0
2024-06-17,180,129,51,0,129,0,0,0.0
2024-06-18,181,93,88,0,93,0,0,0.0
2024-06-19,215,143,72,0,143,0,0,0.0
2024-06-20,239,133,106,0,133,0,0,0.0
2024-06-21,222,140,82,0,140,0,0,0.0
2024-06-23,29,12,17,0,12,0,0,0.0
2024-06-24,219,154,65,0,154,0,0,0.0
2024-06-25,240,131,109,0,131,0,0,0.0
2024-06-26,266,159,107,0,159,0,0,0.0
2024-06-27,260,155,105,0,155,0,0,0.0
2024-06-28,236,141,95,0,141,0,0,0.0
2024-06-30,19,12,7,0,12,0,0,0.0
2024-07-01,220,139,81,0,139,0,0,0.0
2024-07-02,246,134,112,0,134,0,0,0.0
2024-07-03,229,123,106,0,123,0,0,0.0
2024-07-04,229,126,103,0,126,0,0,0.0
2024-07-05,197,101,96,0,101,0,0,0.0
2024-07-07,17,10,7,0,10,0,0,0.0
2024-07-08,259,154,105,0,154,0,0,0.0
2024-07-09,276,161,115,0,161,0,0,0.0
2024-07-10,246,144,102,0,144,0,0,0.0
2024-07-11,220,118,102,0,118,0,0,0.0
2024-07-12,77,37,40,0,37,0,0,0.0
2024-07-14,16,0,16,0,0,0,0,0.0
2024-07-15,204,147,57,0,147,0,0,0.0
2024-07-16,257,157,100,0,157,0,0,0.0
2024-07-17,233,128,105,0,128,0,0,0.0
2024-07-18,251,161,90,0,161,0,0,0.0
2024-07-19,229,134,95,0,134,0,0,0.0
2024-07-21,30,12,18,0,12,0,0,0.0
2024-07-22,233,149,84,0,149,0,0,0.0
2024-07-23,229,118,111,0,118,0,0,0.0
2024-07-24,224,122,102,0,122,0,0,0.0
2024-07-25,175,61,114,0,61,0,0,0.0
2024-07-26,166,70,96,0,70,0,0,0.0
2024-07-28,20,4,16,0,4,0,0,0.0
2024-07-29,214,105,109,0,105,0,0,0.0
2024-07-30,216,109,107,0,109,0,0,0.0
2024-07-31,213,106,107,0,106,0,0,0.0
2024-08-01,247,145,102,0,145,0,0,0.0
2024-08-02,202,126,76,0,126,0,0,0.0
2024-08-04,21,12,9,0,12,0,0,0.0
2024-08-05,268,155,113,0,155,0,0,0.0
2024-08-06,204,105,99,0,105,0,0,0.0
2024-08-07,254,148,106,0,148,0,0,0.0
2024-08-08,158,70,88,0,70,0,0,0.0
2024-08-09,160,71,89,0,71,0,0,0.0
2024-08-11,28,8,20,0,8,0,0,0.0
2024-08-12,217,135,82,0,135,0,0,0.0
2024-08-13,220,104,116,0,104,0,0,0.0
2024-08-14,218,106,112,0,106,0,0,0.0
2024-08-15,162,71,91,0,71,0,0,0.0
2024-08-16,204,115,89,0,115,0,0,0.0
2024-08-18,33,12,21,0,12,0,0,0.0
2024-08-19,187,81,106,0,81,0,0,0.0
2024-08-20,236,124,112,0,124,0,0,0.0
2024-08-21,241,136,105,0,136,0,0,0.0
2024-08-22,255,149,106,0,149,0,0,0.0
2024-08-23,244,149,95,0,149,0,0,0.0
2024-08-25,30,12,18,0,12,0,0,0.0
2024-08-26,258,150,108,0,150,0,0,0.0
2024-08-27,254,150,104,0,150,0,0,0.0
2024-08-28,247,140,107,0,140,0,0,0.0
2024-08-29,222,127,95,0,127,0,0,0.0
2024-08-30,218,141,77,0,141,0,0,0.0
2024-09-01,31,11,20,0,11,0,0,0.0
2024-09-02,211,141,70,0,141,0,0,0.0
2024-09-03,173,57,116,0,57,0,0,0.0
2024-09-04,235,141,94,0,141,0,0,0.0
2024-09-05,248,147,101,0,147,0,0,0.0
2024-09-06,234,138,96,0,138,0,0,0.0
2024-09-08,22,12,10,0,12,0,0,0.0
2024-09-09,242,132,110,0,132,0,0,0.0
2024-09-10,261,158,103,0,158,0,0,0.0
2024-09-11,200,85,115,0,85,0,0,0.0
2024-09-12,231,123,108,0,123,0,0,0.0
2024-09-13,176,80,96,0,80,0,0,0.0
2024-09-15,25,10,15,0,10,0,0,0.0
2024-09-16,257,145,112,0,145,0,0,0.0
2024-09-17,255,148,107,0,148,0,0,0.0
2024-09-18,239,124,115,0,124,0,0,0.0
2024-09-19,257,140,117,0,140,0,0,0.0
2024-09-20,240,144,96,0,144,0,0,0.0
2024-09-22,21,11,10,0,11,0,0,0.0
2024-09-23,251,147,104,0,147,0,0,0.0
2024-09-24,253,150,103,0,150,0,0,0.0
2024-09-25,249,146,103,0,146,0,0,0.0
2024-09-26,262,146,116,0,146,0,0,0.0
2024-09-27,194,98,96,0,98,0,0,0.0
2024-09-29,28,9,19,0,9,0,0,0.0
2024-09-30,230,152,78,0,152,0,0,0.0
2024-10-01,267,156,111,0,156,0,0,0.0
2024-10-02,274,159,115,0,159,0,0,0.0
2024-10-03,245,132,113,0,132,0,0,0.0
2024-10-04,213,117,96,0,117,0,0,0.0
2024-10-06,1,1,0,0,1,0,0,0.0
2024-10-07,169,54,115,0,54,0,0,0.0
2024-10-08,263,157,106,0,157,0,0,0.0
2024-10-09,236,148,88,0,148,0,0,0.0
2024-10-10,162,82,80,0,82,0,0,0.0
2024-10-11,180,88,92,0,88,0,0,0.0
2024-10-13,26,9,17,0,9,0,0,0.0
2024-10-14,172,108,64,0,108,0,0,0.0
2024-10-15,223,113,110,0,113,0,0,0.0
2024-10-16,252,144,108,0,144,0,0,0.0
2024-10-17,266,158,108,0,158,0,0,0.0
2024-10-18,244,148,96,0,148,0,0,0.0
2024-10-20,27,12,15,0,12,0,0,0.0
2024-10-21,264,156,108,0,156,0,0,0.0
2024-10-22,220,117,103,0,117,0,0,0.0
2024-10-23,239,136,103,0,136,0,0,0.0
2024-10-24,267,158,109,0,158,0,0,0.0
2024-10-25,187,97,90,0,97,0,0,0.0
2024-10-27,27,12,15,0,12,0,0,0.0
2024-10-28,258,153,105,0,153,0,0,0.0
2024-10-29,276,160,116,0,160,0,0,0.0
2024-10-30,235,125,110,0,125,0,0,0.0
2024-10-31,270,155,115,0,155,0,0,0.0
2024-11-01,227,131,96,0,131,0,0,0.0
2024-11-03,6,0,6,0,0,0,0,0.0
2024-11-04,264,154,110,0,154,0,0,0.0
2024-11-05,266,154,112,0,154,0,0,0.0
2024-11-06,217,109,108,0,109,0,0,0.0
2024-11-07,234,128,106,0,128,0,0,0.0
2024-11-08,231,143,88,0,143,0,0,0.0
2024-11-10,20,0,20,0,0,0,0,0.0
2024-11-11,169,55,114,0,55,0,0,0.0
2024-11-12,270,160,110,0,160,0,0,0.0
2024-11-13,257,155,102,0,155,0,0,0.0
2024-11-14,241,126,115,0,126,0,0,0.0
2024-11-15,246,150,96,0,150,0,0,0.0
2024-11-17,16,0,16,0,0,0,0,0.0
2024-11-18,248,146,102,0,146,0,0,0.0
2024-11-19,267,159,108,0,159,0,0,0.0
2024-11-20,261,153,108,0,153,0,0,0.0
2024-11-21,242,134,108,0,134,0,0,0.0
2024-11-22,238,160,78,0,160,0,0,0.0
2024-11-24,4,0,4,0,0,0,0,0.0
2024-11-25,195,111,84,0,111,0,0,0.0
2024-11-26,219,114,105,0,114,0,0,0.0
2024-11-27,251,136,115,0,136,0,0,0.0
2024-11-28,249,137,112,0,137,0,0,0.0
2024-11-29,219,123,96,0,123,0,0,0.0
2024-12-01,19,0,19,0,0,0,0,0.0
2024-12-02,258,147,111,0,147,0,0,0.0
2024-12-03,257,143,114,0,143,0,0,0.0
2024-12-04,266,153,113,0,153,0,0,0.0
2024-12-05,274,159,115,0,159,0,0,0.0
2024-12-06,248,160,88,0,160,0,0,0.0
2024-12-08,0,0,0,0,0,0,0,0.0
2024-12-09,197,138,59,0,138,0,0,0.0
2024-12-10,242,129,113,0,129,0,0,0.0
2024-12-11,247,143,104,0,143,0,0,0.0
2024-12-12,209,125,84,0,125,0,0,0.0
2024-12-13,256,160,96,0,160,0,0,0.0
2024-12-15,15,0,15,0,0,0,0,0.0
2024-12-16,240,147,93,0,147,0,0,0.0
2024-12-17,254,156,98,0,156,0,0,0.0
2024-12-18,222,137,85,0,137,0,0,0.0
2024-12-19,272,159,113,0,159,0,0,0.0
2024-12-20,238,143,95,0,143,0,0,0.0
2024-12-22,14,0,14,0,0,0,0,0.0
2024-12-23,200,96,104,0,96,0,0,0.0
2024-12-24,219,130,89,0,130,0,0,0.0
2024-12-25,119,0,119,0,0,0,0,0.0
2024-12-26,268,159,109,0,159,0,0,0.0
2024-12-27,227,131,96,0,131,0,0,0.0
2024-12-29,15,0,15,0,0,0,0,0.0
2024-12-30,270,157,113,0,157,0,0,0.0
2024-12-31,246,150,96,0,150,0,0,0.0
