date,breakouts,gate_pass,gate_block,ev_pass,ev_reject,fills,wins,pnl_pips
2018-01-01,9,0,9,0,0,0,0,0.0
2018-01-02,250,128,122,20,77,51,50,45.5400000000007
2018-01-03,172,128,44,0,128,0,0,0.0
2018-01-04,204,91,113,1,90,1,1,1.064285714286484
2018-01-05,245,106,139,0,106,0,0,0.0
2018-01-07,12,0,12,0,0,0,0,0.0
2018-01-08,203,86,117,0,86,0,0,0.0
2018-01-09,228,109,119,0,109,0,0,0.0
2018-01-10,186,81,105,10,71,1,0,-4.814285714285404
2018-01-11,205,103,102,15,88,1,1,2.764285714286075
2018-01-12,65,8,57,6,2,2,2,9.7142857142847
2018-01-14,16,0,16,0,0,0,0,0.0
2018-01-15,201,95,106,1,94,1,0,-5.845714285714109
2018-01-16,185,76,109,1,75,1,0,-5.594285714285718
2018-01-17,195,94,101,2,92,1,1,1.4428571428576902
2018-01-18,184,100,84,17,83,1,0,-4.379999999999484
2018-01-19,109,21,88,3,18,1,0,-5.019999999999413
2018-01-21,12,0,12,0,0,0,0,0.0
2018-01-22,204,94,110,1,93,1,0,-3.7457142857140298
2018-01-23,195,100,95,1,99,1,0,-4.705714285714635
2018-01-24,200,95,105,4,91,1,0,-6.531428571428421
2018-01-25,113,10,103,6,4,2,2,17.73571428571381
2018-01-26,89,12,77,2,10,2,0,-18.045714285714553
2018-01-28,10,0,10,0,0,0,0,0.0
2018-01-29,188,94,94,1,93,1,0,-5.2942857142857065
2018-01-30,223,125,98,1,124,1,1,2.6142857142853586
2018-01-31,160,65,95,2,63,2,1,5.202857142856999
2018-02-01,206,97,109,7,90,1,1,3.499999999999204
2018-02-02,103,9,94,8,1,2,2,12.11428571428479
2018-02-04,12,0,12,0,0,0,0,0.0
2018-02-05,176,65,111,3,62,2,1,4.095714285714337
2018-02-06,181,71,110,6,65,1,0,-9.028571428571752
2018-02-07,195,92,103,24,68,1,0,-6.474285714285088
2018-02-08,110,40,70,3,37,2,1,2.6385714285714243
2018-02-09,199,105,94,7,98,2,2,14.192857142857008
2018-02-11,14,0,14,0,0,0,0,0.0
2018-02-12,184,71,113,3,68,1,0,-6.377142857143269
2018-02-13,187,77,110,12,65,1,0,-8.260000000000389
2018-02-14,111,5,106,5,0,2,1,-5.575714285715549
2018-02-15,206,95,111,5,90,1,0,-6.677142857143281
2018-02-16,210,117,93,0,117,0,0,0.0
2018-02-18,17,0,17,0,0,0,0,0.0
2018-02-19,175,75,100,0,75,0,0,0.0
2018-02-20,242,104,138,0,104,0,0,0.0
2018-02-21,261,149,112,2,147,0,0,0.0
2018-02-22,254,140,114,4,136,0,0,0.0
2018-02-23,220,124,96,0,124,0,0,0.0
2018-02-25,5,0,5,0,0,0,0,0.0
2018-02-26,225,119,106,0,119,0,0,0.0
2018-02-27,184,111,73,6,105,0,0,0.0
2018-02-28,212,107,105,0,107,0,0,0.0
2018-03-01,233,126,107,23,103,1,1,8.23571428571438
2018-03-02,186,95,91,14,81,1,1,6.185714285714539
2018-03-04,6,0,6,0,0,0,0,0.0
2018-03-05,182,152,30,4,148,0,0,0.0
2018-03-06,235,122,113,14,108,0,0,0.0
2018-03-07,189,78,111,0,78,0,0,0.0
2018-03-08,194,87,107,0,87,0,0,0.0
2018-03-09,206,110,96,7,103,0,0,0.0
2018-03-11,26,12,14,0,12,0,0,0.0
2018-03-12,195,85,110,0,85,0,0,0.0
2018-03-13,162,47,115,1,46,1,0,-9.397142857142626
2018-03-14,242,149,93,0,149,0,0,0.0
2018-03-15,246,141,105,0,141,0,0,0.0
2018-03-16,214,118,96,0,118,0,0,0.0
2018-03-18,20,12,8,0,12,0,0,0.0
2018-03-19,254,144,110,0,144,0,0,0.0
2018-03-20,159,53,106,6,47,1,1,5.392857142856656
2018-03-21,207,81,126,6,75,1,1,8.978571428572025
2018-03-22,166,52,114,32,20,2,2,11.485714285713811
2018-03-23,167,71,96,1,70,1,0,-5.47142857142876
2018-03-25,20,12,8,0,12,0,0,0.0
2018-03-26,207,106,101,0,106,0,0,0.0
2018-03-27,247,142,105,11,131,0,0,0.0
2018-03-28,240,129,111,29,100,1,1,4.307142857143276
2018-03-29,246,138,108,0,138,0,0,0.0
2018-03-30,164,69,95,0,69,0,0,0.0
2018-04-01,8,6,2,0,6,0,0,0.0
2018-04-02,163,93,70,0,93,0,0,0.0
2018-04-03,198,94,104,0,94,0,0,0.0
2018-04-04,196,118,78,0,118,0,0,0.0
2018-04-05,261,151,110,0,151,0,0,0.0
2018-04-06,127,32,95,1,31,1,0,-8.368571428571158
2018-04-08,7,0,7,0,0,0,0,0.0
2018-04-09,182,117,65,0,117,0,0,0.0
2018-04-10,204,97,107,1,96,1,0,-5.59142857142848
2018-04-11,190,77,113,0,77,0,0,0.0
2018-04-12,192,75,117,0,75,0,0,0.0
2018-04-13,240,138,102,0,138,0,0,0.0
2018-04-15,12,12,0,0,12,0,0,0.0
2018-04-16,231,127,104,0,127,0,0,0.0
2018-04-17,251,133,118,0,133,0,0,0.0
2018-04-18,227,94,133,0,94,0,0,0.0
2018-04-19,228,108,120,0,108,0,0,0.0
2018-04-20,228,123,105,0,123,0,0,0.0
2018-04-22,22,8,14,0,8,0,0,0.0
2018-04-23,257,155,102,0,155,0,0,0.0
2018-04-24,223,116,107,0,116,0,0,0.0
2018-04-25,242,145,97,0,145,0,0,0.0
2018-04-26,248,143,105,0,143,0,0,0.0
2018-04-27,195,74,121,0,74,0,0,0.0
2018-04-29,28,12,16,0,12,0,0,0.0
2018-04-30,182,94,88,0,94,0,0,0.0
2018-05-01,258,115,143,0,115,0,0,0.0
2018-05-02,240,117,123,7,110,0,0,0.0
2018-05-03,263,140,123,0,140,0,0,0.0
2018-05-04,212,109,103,3,106,0,0,0.0
2018-05-06,25,12,13,0,12,0,0,0.0
2018-05-07,256,142,114,0,142,0,0,0.0
2018-05-08,212,100,112,11,89,0,0,0.0
2018-05-09,163,53,110,0,53,0,0,0.0
2018-05-10,204,91,113,3,88,0,0,0.0
2018-05-11,224,127,97,0,127,0,0,0.0
2018-05-13,13,9,4,0,9,0,0,0.0
2018-05-14,184,102,82,0,102,0,0,0.0
2018-05-15,246,121,125,1,120,0,0,0.0
2018-05-16,249,135,114,0,135,0,0,0.0
2018-05-17,182,86,96,0,86,0,0,0.0
2018-05-18,215,126,89,0,126,0,0,0.0
2018-05-20,15,12,3,0,12,0,0,0.0
2018-05-21,252,135,117,0,135,0,0,0.0
2018-05-22,184,80,104,0,80,0,0,0.0
2018-05-23,204,105,99,0,105,0,0,0.0
2018-05-24,231,120,111,22,98,0,0,0.0
2018-05-25,182,86,96,0,86,0,0,0.0
2018-05-27,19,12,7,7,5,0,0,0.0
2018-05-28,247,142,105,0,142,0,0,0.0
2018-05-29,210,85,125,12,73,1,1,8.314285714285575
2018-05-30,149,41,108,1,40,1,1,6.021428571429055
2018-05-31,130,22,108,22,0,2,0,-15.231428571429205
2018-06-01,230,137,93,0,137,0,0,0.0
2018-06-03,15,12,3,0,12,0,0,0.0
2018-06-04,236,119,117,0,119,0,0,0.0
2018-06-05,212,110,102,0,110,0,0,0.0
2018-06-06,229,133,96,0,133,0,0,0.0
2018-06-07,252,148,104,0,148,0,0,0.0
2018-06-08,209,123,86,0,123,0,0,0.0
2018-06-10,13,12,1,0,12,0,0,0.0
2018-06-11,230,137,93,0,137,0,0,0.0
2018-06-12,219,109,110,0,109,0,0,0.0
2018-06-13,235,135,100,0,135,0,0,0.0
2018-06-14,181,114,67,0,114,0,0,0.0
2018-06-15,203,106,97,0,106,0,0,0.0
2018-06-17,23,12,11,0,12,0,0,0.0
2018-06-18,206,97,109,0,97,0,0,0.0
2018-06-19,253,132,121,0,132,0,0,0.0
2018-06-20,253,139,114,0,139,0,0,0.0
2018-06-21,255,146,109,0,146,0,0,0.0
2018-06-22,199,103,96,0,103,0,0,0.0
2018-06-24,20,12,8,0,12,0,0,0.0
2018-06-25,244,129,115,7,122,0,0,0.0
2018-06-26,230,120,110,0,120,0,0,0.0
2018-06-27,223,114,109,0,114,0,0,0.0
2018-06-28,259,156,103,0,156,0,0,0.0
2018-06-29,207,111,96,0,111,0,0,0.0
2018-07-01,17,8,9,0,8,0,0,0.0
2018-07-02,177,86,91,0,86,0,0,0.0
2018-07-03,249,131,118,0,131,0,0,0.0
2018-07-04,185,83,102,0,83,0,0,0.0
2018-07-05,219,109,110,0,109,0,0,0.0
2018-07-06,170,77,93,0,77,0,0,0.0
2018-07-08,17,12,5,0,12,0,0,0.0
2018-07-09,196,129,67,0,129,0,0,0.0
2018-07-10,244,137,107,0,137,0,0,0.0
2018-07-11,232,140,92,0,140,0,0,0.0
2018-07-12,204,90,114,0,90,0,0,0.0
2018-07-13,230,130,100,0,130,0,0,0.0
2018-07-15,25,12,13,0,12,0,0,0.0
2018-07-16,235,111,124,0,111,0,0,0.0
2018-07-17,258,139,119,0,139,0,0,0.0
2018-07-18,205,119,86,0,119,0,0,0.0
2018-07-19,178,49,129,4,45,1,1,9.70714285714348
2018-07-20,210,117,93,15,102,0,0,0.0
2018-07-22,30,12,18,0,12,0,0,0.0
2018-07-23,259,145,114,0,145,0,0,0.0
2018-07-24,229,131,98,0,131,0,0,0.0
2018-07-25,208,110,98,8,102,0,0,0.0
2018-07-26,253,148,105,0,148,0,0,0.0
2018-07-27,178,78,100,1,77,0,0,0.0
2018-07-29,12,8,4,0,8,0,0,0.0
2018-07-30,210,103,107,0,103,0,0,0.0
2018-07-31,184,69,115,3,66,0,0,0.0
2018-08-01,244,139,105,0,139,0,0,0.0
2018-08-02,253,148,105,0,148,0,0,0.0
2018-08-03,209,83,126,0,83,0,0,0.0
2018-08-05,13,12,1,0,12,0,0,0.0
2018-08-06,227,112,115,0,112,0,0,0.0
2018-08-07,271,95,176,0,95,0,0,0.0
2018-08-08,211,85,126,0,85,0,0,0.0
2018-08-09,258,128,130,0,128,0,0,0.0
2018-08-10,206,107,99,8,99,0,0,0.0
2018-08-12,12,12,0,0,12,0,0,0.0
2018-08-13,230,132,98,3,129,1,1,5.985714285713584
2018-08-14,237,139,98,7,132,0,0,0.0
2018-08-15,249,126,123,0,126,0,0,0.0
2018-08-16,246,135,111,0,135,0,0,0.0
2018-08-17,203,65,138,0,65,0,0,0.0
2018-08-19,19,2,17,0,2,0,0,0.0
2018-08-20,203,99,104,0,99,0,0,0.0
2018-08-21,253,143,110,0,143,0,0,0.0
2018-08-22,249,151,98,0,151,0,0,0.0
2018-08-23,241,122,119,0,122,0,0,0.0
2018-08-24,180,108,72,0,108,0,0,0.0
2018-08-26,19,12,7,0,12,0,0,0.0
2018-08-27,242,122,120,0,122,0,0,0.0
2018-08-28,242,104,138,0,104,0,0,0.0
2018-08-29,252,128,124,1,127,0,0,0.0
2018-08-30,249,126,123,0,126,0,0,0.0
2018-08-31,177,109,68,0,109,0,0,0.0
2018-09-02,22,12,10,0,12,0,0,0.0
2018-09-03,221,115,106,0,115,0,0,0.0
2018-09-04,231,96,135,0,96,0,0,0.0
2018-09-05,133,56,77,0,56,0,0,0.0
2018-09-06,240,126,114,11,115,0,0,0.0
2018-09-07,214,116,98,9,107,0,0,0.0
2018-09-09,19,2,17,0,2,0,0,0.0
2018-09-10,208,105,103,0,105,0,0,0.0
2018-09-11,258,148,110,0,148,0,0,0.0
2018-09-12,207,97,110,0,97,0,0,0.0
2018-09-13,260,113,147,0,113,0,0,0.0
2018-09-14,166,70,96,0,70,0,0,0.0
2018-09-16,2,0,2,0,0,0,0,0.0
2018-09-17,177,92,85,0,92,0,0,0.0
2018-09-18,240,135,105,0,135,0,0,0.0
2018-09-19,134,37,97,0,37,0,0,0.0
2018-09-20,222,104,118,0,104,0,0,0.0
2018-09-21,207,107,100,0,107,0,0,0.0
2018-09-23,18,12,6,0,12,0,0,0.0
2018-09-24,223,78,145,0,78,0,0,0.0
2018-09-25,254,105,149,0,105,0,0,0.0
2018-09-26,255,80,175,3,77,0,0,0.0
2018-09-27,261,146,115,0,146,0,0,0.0
2018-09-28,213,107,106,0,107,0,0,0.0
2018-09-30,27,12,15,0,12,0,0,0.0
2018-10-01,248,115,133,0,115,0,0,0.0
2018-10-02,238,93,145,0,93,0,0,0.0
2018-10-03,256,145,111,0,145,0,0,0.0
2018-10-04,233,119,114,17,102,0,0,0.0
2018-10-05,202,134,68,3,131,0,0,0.0
2018-10-07,18,12,6,0,12,0,0,0.0
2018-10-08,229,111,118,0,111,0,0,0.0
2018-10-09,227,125,102,0,125,0,0,0.0
2018-10-10,256,149,107,13,136,0,0,0.0
2018-10-11,95,26,69,7,19,2,2,12.035714285713595
2018-10-12,229,134,95,0,134,0,0,0.0
2018-10-14,19,12,7,0,12,0,0,0.0
2018-10-15,225,125,100,0,125,0,0,0.0
2018-10-16,221,105,116,0,105,0,0,0.0
2018-10-17,225,121,104,0,121,0,0,0.0
2018-10-18,252,149,103,19,130,0,0,0.0
2018-10-19,223,127,96,0,127,0,0,0.0
2018-10-21,28,12,16,0,12,0,0,0.0
2018-10-22,220,106,114,0,106,0,0,0.0
2018-10-23,241,108,133,4,104,0,0,0.0
2018-10-24,251,137,114,9,128,0,0,0.0
2018-10-25,225,146,79,0,146,0,0,0.0
2018-10-26,151,58,93,7,51,1,1,6.2857142857135955
2018-10-28,9,0,9,0,0,0,0,0.0
2018-10-29,195,108,87,9,99,0,0,0.0
2018-10-30,234,100,134,5,95,0,0,0.0
2018-10-31,215,106,109,5,101,0,0,0.0
2018-11-01,248,124,124,0,124,0,0,0.0
2018-11-02,220,124,96,15,109,0,0,0.0
2018-11-04,15,0,15,0,0,0,0,0.0
2018-11-05,214,143,71,0,143,0,0,0.0
2018-11-06,250,114,136,0,114,0,0,0.0
2018-11-07,223,130,93,0,130,0,0,0.0
2018-11-08,239,132,107,0,132,0,0,0.0
2018-11-09,209,113,96,0,113,0,0,0.0
2018-11-11,8,0,8,0,0,0,0,0.0
2018-11-12,227,98,129,0,98,0,0,0.0
2018-11-13,234,131,103,4,127,0,0,0.0
2018-11-14,200,95,105,5,90,1,1,5.585714285714516
2018-11-15,226,140,86,41,99,0,0,0.0
2018-11-16,140,56,84,7,49,1,1,5.378571428570467
2018-11-18,14,0,14,0,0,0,0,0.0
2018-11-19,204,111,93,2,109,0,0,0.0
2018-11-20,129,53,76,4,49,1,1,4.392857142857565
2018-11-21,198,86,112,0,86,0,0,0.0
2018-11-22,144,111,33,0,111,0,0,0.0
2018-11-23,212,61,151,0,61,0,0,0.0
2018-11-25,11,0,11,0,0,0,0,0.0
2018-11-26,245,124,121,0,124,0,0,0.0
2018-11-27,155,42,113,3,39,1,1,3.9785714285708877
2018-11-28,192,76,116,2,74,1,1,3.871428571428737
2018-11-29,169,72,97,1,71,1,1,3.142857142857281
2018-11-30,112,106,6,0,106,0,0,0.0
2018-12-02,14,0,14,0,0,0,0,0.0
2018-12-03,160,71,89,2,69,1,0,-5.080000000001405
2018-12-04,215,104,111,2,102,1,1,4.950000000000443
2018-12-05,266,148,118,0,148,0,0,0.0
2018-12-06,172,50,122,1,49,1,1,3.61428571428587
2018-12-07,117,23,94,2,21,1,1,3.492857142857531
2018-12-09,14,0,14,0,0,0,0,0.0
2018-12-10,152,46,106,3,43,1,1,3.035714285713709
2018-12-11,158,48,110,2,46,1,1,2.364285714285586
2018-12-12,132,35,97,4,31,1,1,2.4285714285720132
2018-12-13,111,15,96,1,14,1,1,2.014285714285336
2018-12-14,132,60,72,4,56,1,1,1.8285714285719905
2018-12-16,18,0,18,0,0,0,0,0.0
2018-12-17,163,61,102,2,59,1,1,1.7999999999996135
2018-12-18,164,53,111,1,52,1,0,-4.442857142857292
2018-12-19,166,67,99,1,66,1,1,1.9642857142850971
2018-12-20,153,59,94,1,58,1,1,2.164285714286052
2018-12-21,94,17,77,7,10,2,1,-4.450000000000841
2018-12-23,5,0,5,0,0,0,0,0.0
2018-12-24,34,25,9,1,24,1,0,-3.9457142857149847
2018-12-25,117,0,117,0,0,0,0,0.0
2018-12-26,157,80,77,1,79,1,1,2.5285714285710696
2018-12-27,142,30,112,3,27,1,0,-5.59142857142848
2018-12-28,133,38,95,2,36,1,0,-4.088571428571186
2018-12-30,13,0,13,0,0,0,0,0.0
2018-12-31,149,53,96,7,46,1,1,2.6142857142853586
2019-01-01,16,0,16,0,0,0,0,0.0
2019-01-02,115,5,110,5,0,2,1,-1.2699999999990155
2019-01-03,118,7,111,7,0,2,0,-26.174285714284395
2019-01-04,109,13,96,2,11,2,2,14.935714285713232
2019-01-06,11,0,11,0,0,0,0,0.0
2019-01-07,168,80,88,2,78,1,1,3.8857142857135045
2019-01-08,157,49,108,1,48,1,1,3.1071428571432307
2019-01-09,128,25,103,1,24,1,1,2.4142857142858247
2019-01-10,166,61,105,5,56,1,1,2.099999999999625
2019-01-11,111,26,85,1,25,1,0,-5.491428571428003
2019-01-13,13,0,13,0,0,0,0,0.0
2019-01-14,155,38,117,6,32,1,1,2.7214285714289304
2019-01-15,147,50,97,1,49,1,0,-5.777142857143247
2019-01-16,150,48,102,2,46,1,0,-5.822857142857629
2019-01-17,134,29,105,3,26,1,1,3.1928571428575196
2019-01-18,149,54,95,2,52,1,1,3.007142857142753
2019-01-20,8,0,8,0,0,0,0,0.0
2019-01-21,182,76,106,0,76,0,0,0.0
2019-01-22,154,26,128,2,24,1,0,-4.859999999999786
2019-01-23,150,51,99,6,45,1,1,3.400000000000148
2019-01-24,135,48,87,1,47,1,1,2.9285714285715585
2019-01-25,154,59,95,3,56,1,1,2.8428571428572695
2019-01-27,17,0,17,0,0,0,0,0.0
2019-01-28,155,47,108,1,46,1,1,2.3785714285717745
2019-01-29,164,75,89,4,71,1,1,2.2999999999991587
2019-01-30,110,62,48,1,61,1,1,2.764285714286075
2019-01-31,154,54,100,2,52,1,1,1.9214285714279526
2019-02-01,138,45,93,1,44,1,1,1.699999999999136
2019-02-03,18,0,18,0,0,0,0,0.0
2019-02-04,142,37,105,1,36,1,1,1.900000000000091
2019-02-05,139,52,87,2,50,1,1,1.4142857142853131
2019-02-06,168,60,108,1,59,1,1,1.442857142856269
2019-02-07,123,32,91,1,31,1,1,3.635714285713732
2019-02-08,115,61,54,1,60,1,0,-3.5571428571434467
2019-02-10,8,0,8,0,0,0,0,0.0
2019-02-11,142,37,105,1,36,1,1,1.6571428571434126
2019-02-12,233,103,130,0,103,0,0,0.0
2019-02-13,149,21,128,1,20,1,1,2.3500000000008185
2019-02-14,148,26,122,1,25,1,1,2.5000000000001137
2019-02-15,137,53,84,1,52,1,0,-4.628571428570638
2019-02-17,13,0,13,0,0,0,0,0.0
2019-02-18,236,83,153,0,83,0,0,0.0
2019-02-19,159,13,146,1,12,1,1,1.5785714285707968
2019-02-20,186,73,113,1,72,1,1,1.4000000000005457
2019-02-21,115,17,98,1,16,1,0,-3.399999999998215
2019-02-22,151,54,97,1,53,1,1,1.5285714285719791
2019-02-24,17,0,17,0,0,0,0,0.0
2019-02-25,134,65,69,1,64,1,1,1.3642857142850744
2019-02-26,156,57,99,1,56,1,1,1.264285714286018
2019-02-27,135,48,87,1,47,1,1,1.5357142857136523
2019-02-28,148,28,120,1,27,1,1,3.664285714286109
2019-03-01,122,26,96,1,25,1,0,-4.134285714286989
2019-03-03,19,0,19,0,0,0,0,0.0
2019-03-04,154,58,96,1,57,1,0,-4.817142857142642
2019-03-05,178,31,147,1,30,1,0,-7.188571428571777
2019-03-06,144,43,101,1,42,1,1,1.842857142856758
2019-03-07,149,50,99,1,49,1,0,-5.202857142856942
2019-03-08,138,43,95,1,42,1,0,-5.634285714285625
2019-03-10,13,0,13,0,0,0,0,0.0
2019-03-11,205,123,82,0,123,0,0,0.0
2019-03-12,227,111,116,0,111,0,0,0.0
2019-03-13,209,91,118,1,90,1,1,2.4642857142860635
2019-03-14,214,99,115,0,99,0,0,0.0
2019-03-15,183,70,113,1,69,0,0,0.0
2019-03-17,23,12,11,0,12,0,0,0.0
2019-03-18,251,91,160,0,91,0,0,0.0
2019-03-19,178,45,133,1,44,1,1,2.2857142857143913
2019-03-20,198,58,140,1,57,1,1,3.835714285714687
2019-03-21,155,55,100,1,54,1,0,-5.257142857143037
2019-03-22,150,41,109,3,38,1,1,2.8714285714282255
2019-03-24,13,0,13,0,0,0,0,0.0
2019-03-25,139,55,84,3,52,1,0,-4.574285714284542
2019-03-26,140,50,90,1,49,1,0,-4.785714285714448
2019-03-27,64,49,15,1,48,1,0,-5.317142857142187
2019-03-28,160,55,105,5,50,1,0,-7.737142857142942
2019-03-29,132,32,100,5,27,0,0,0.0
2019-03-31,18,12,6,0,12,0,0,0.0
2019-04-01,248,136,112,0,136,0,0,0.0
2019-04-02,188,106,82,0,106,0,0,0.0
2019-04-03,196,58,138,0,58,0,0,0.0
2019-04-04,237,106,131,0,106,0,0,0.0
2019-04-05,119,17,102,1,16,1,0,-6.071428571428783
2019-04-07,12,0,12,0,0,0,0,0.0
2019-04-08,247,82,165,0,82,0,0,0.0
2019-04-09,251,85,166,0,85,0,0,0.0
2019-04-10,238,80,158,0,80,0,0,0.0
2019-04-11,237,96,141,0,96,0,0,0.0
2019-04-12,216,78,138,0,78,0,0,0.0
2019-04-14,31,11,20,0,11,0,0,0.0
2019-04-15,162,40,122,0,40,0,0,0.0
2019-04-16,148,44,104,0,44,0,0,0.0
2019-04-17,225,40,185,0,40,0,0,0.0
2019-04-18,196,64,132,0,64,0,0,0.0
2019-04-19,136,19,117,0,19,0,0,0.0
2019-04-21,27,0,27,0,0,0,0,0.0
2019-04-22,134,8,126,0,8,0,0,0.0
2019-04-23,242,56,186,0,56,0,0,0.0
2019-04-24,255,82,173,0,82,0,0,0.0
2019-04-25,249,139,110,3,136,0,0,0.0
2019-04-26,233,96,137,0,96,0,0,0.0
2019-04-28,23,12,11,0,12,0,0,0.0
2019-04-29,220,23,197,0,23,0,0,0.0
2019-04-30,211,56,155,0,56,0,0,0.0
2019-05-01,227,48,179,1,47,1,1,7.4714285714288735
2019-05-02,230,102,128,0,102,0,0,0.0
2019-05-03,214,59,155,0,59,0,0,0.0
2019-05-05,27,0,27,0,0,0,0,0.0
2019-05-06,202,96,106,0,96,0,0,0.0
2019-05-07,223,145,78,0,145,0,0,0.0
2019-05-08,205,106,99,7,99,0,0,0.0
2019-05-09,203,79,124,5,74,1,0,-8.040000000000191
2019-05-10,215,117,98,0,117,0,0,0.0
2019-05-12,17,12,5,0,12,0,0,0.0
2019-05-13,174,103,71,1,102,1,1,5.064285714285688
2019-05-14,256,144,112,0,144,0,0,0.0
2019-05-15,260,116,144,0,116,0,0,0.0
2019-05-16,263,145,118,0,145,0,0,0.0
2019-05-17,229,98,131,0,98,0,0,0.0
2019-05-19,22,12,10,0,12,0,0,0.0
2019-05-20,268,126,142,0,126,0,0,0.0
2019-05-21,233,94,139,0,94,0,0,0.0
2019-05-22,230,111,119,0,111,0,0,0.0
2019-05-23,258,107,151,2,105,0,0,0.0
2019-05-24,224,126,98,0,126,0,0,0.0
2019-05-26,31,12,19,0,12,0,0,0.0
2019-05-27,255,111,144,0,111,0,0,0.0
2019-05-28,207,94,113,0,94,0,0,0.0
2019-05-29,227,127,100,0,127,0,0,0.0
2019-05-30,228,120,108,0,120,0,0,0.0
2019-05-31,215,108,107,5,103,0,0,0.0
2019-06-02,18,12,6,0,12,0,0,0.0
2019-06-03,219,142,77,0,142,0,0,0.0
2019-06-04,212,123,89,7,116,0,0,0.0
2019-06-05,227,134,93,5,129,0,0,0.0
2019-06-06,199,103,96,0,103,0,0,0.0
2019-06-07,134,38,96,2,36,2,1,-4.578571428570854
2019-06-09,3,0,3,0,0,0,0,0.0
2019-06-10,204,119,85,0,119,0,0,0.0
2019-06-11,253,121,132,0,121,0,0,0.0
2019-06-12,143,37,106,0,37,0,0,0.0
2019-06-13,259,141,118,0,141,0,0,0.0
2019-06-14,218,86,132,0,86,0,0,0.0
2019-06-16,11,4,7,0,4,0,0,0.0
2019-06-17,229,84,145,0,84,0,0,0.0
2019-06-18,219,93,126,0,93,0,0,0.0
2019-06-19,235,100,135,0,100,0,0,0.0
2019-06-20,248,146,102,0,146,0,0,0.0
2019-06-21,205,127,78,0,127,0,0,0.0
2019-06-23,30,12,18,0,12,0,0,0.0
2019-06-24,242,145,97,0,145,0,0,0.0
2019-06-25,192,88,104,1,87,1,1,7.421428571428635
2019-06-26,198,93,105,10,83,1,1,3.9928571428570763
2019-06-27,263,150,113,0,150,0,0,0.0
2019-06-28,219,123,96,0,123,0,0,0.0
2019-06-30,29,12,17,0,12,0,0,0.0
2019-07-01,157,117,40,0,117,0,0,0.0
2019-07-02,163,107,56,0,107,0,0,0.0
2019-07-03,263,146,117,0,146,0,0,0.0
2019-07-04,164,50,114,0,50,0,0,0.0
2019-07-05,197,47,150,1,46,0,0,0.0
2019-07-07,0,0,0,0,0,0,0,0.0
2019-07-08,243,151,92,0,151,0,0,0.0
2019-07-09,198,78,120,0,78,0,0,0.0
2019-07-10,250,85,165,3,82,0,0,0.0
2019-07-11,246,137,109,0,137,0,0,0.0
2019-07-12,215,96,119,0,96,0,0,0.0
2019-07-14,19,12,7,0,12,0,0,0.0
2019-07-15,194,103,91,0,103,0,0,0.0
2019-07-16,228,86,142,0,86,0,0,0.0
2019-07-17,215,96,119,0,96,0,0,0.0
2019-07-18,236,123,113,5,118,0,0,0.0
2019-07-19,121,90,31,0,90,0,0,0.0
2019-07-21,21,5,16,0,5,0,0,0.0
2019-07-22,195,84,111,0,84,0,0,0.0
2019-07-23,241,115,126,0,115,0,0,0.0
2019-07-24,239,107,132,0,107,0,0,0.0
2019-07-25,198,83,115,1,82,0,0,0.0
2019-07-26,130,49,81,0,49,0,0,0.0
2019-07-28,6,0,6,0,0,0,0,0.0
2019-07-29,232,114,118,0,114,0,0,0.0
2019-07-30,236,115,121,0,115,0,0,0.0
2019-07-31,171,51,120,3,48,1,1,6.8071428571424235
2019-08-01,209,98,111,13,85,1,1,5.457142857143083
2019-08-02,136,41,95,15,26,2,2,15.135714285714187
2019-08-04,7,0,7,0,0,0,0,0.0
2019-08-05,156,56,100,3,53,1,0,-5.577142857143713
2019-08-06,131,26,105,1,25,1,0,-5.882857142856778
2019-08-07,136,32,104,1,31,1,0,-7.945714285714189
2019-08-08,153,104,49,4,100,0,0,0.0
2019-08-09,176,83,93,17,66,1,1,6.942857142856951
2019-08-11,15,0,15,0,0,0,0,0.0
2019-08-12,209,101,108,1,100,1,1,4.071428571428271
2019-08-13,162,48,114,2,46,1,1,8.714285714286063
2019-08-14,158,45,113,1,44,1,0,-8.228571428572195
2019-08-15,113,9,104,4,5,2,1,-5.352857142858113
2019-08-16,111,30,81,1,29,1,1,3.9071428571427873
2019-08-18,16,1,15,0,1,0,0,0.0
2019-08-19,99,70,29,0,70,0,0,0.0
2019-08-20,177,78,99,3,75,0,0,0.0
2019-08-21,252,109,143,0,109,0,0,0.0
2019-08-22,253,137,116,2,135,0,0,0.0
2019-08-23,169,37,132,4,33,1,1,8.699999999999875
2019-08-25,10,0,10,0,0,0,0,0.0
2019-08-26,154,50,104,1,49,1,1,5.499999999998806
2019-08-27,196,91,105,1,90,1,0,-6.171428571427839
2019-08-28,235,119,116,1,118,0,0,0.0
2019-08-29,263,156,107,0,156,0,0,0.0
2019-08-30,226,122,104,0,122,0,0,0.0
2019-09-01,13,12,1,0,12,0,0,0.0
2019-09-02,236,149,87,0,149,0,0,0.0
2019-09-03,148,15,133,4,11,1,1,6.657142857143128
2019-09-04,189,95,94,0,95,0,0,0.0
2019-09-05,173,62,111,5,57,1,1,5.578571428571422
2019-09-06,116,37,79,1,36,1,1,5.592857142857611
2019-09-08,7,0,7,0,0,0,0,0.0
2019-09-09,174,114,60,0,114,0,0,0.0
2019-09-10,238,111,127,0,111,0,0,0.0
2019-09-11,220,114,106,0,114,0,0,0.0
2019-09-12,144,30,114,1,29,1,0,-6.145714285714121
2019-09-13,98,48,50,0,48,0,0,0.0
2019-09-15,8,7,1,7,0,1,1,5.692857142856667
2019-09-16,176,142,34,0,142,0,0,0.0
2019-09-17,119,21,98,4,17,1,1,5.585714285713095
2019-09-18,220,83,137,0,83,0,0,0.0
2019-09-19,245,137,108,0,137,0,0,0.0
2019-09-20,218,107,111,4,103,0,0,0.0
2019-09-22,18,12,6,0,12,0,0,0.0
2019-09-23,117,70,47,6,64,0,0,0.0
2019-09-24,211,99,112,25,74,1,1,5.149999999999977
2019-09-25,133,29,104,4,25,1,1,4.15714285714256
2019-09-26,164,49,115,3,46,1,1,3.5142857142853927
2019-09-27,160,63,97,1,62,1,0,-6.174285714286498
2019-09-29,17,0,17,0,0,0,0,0.0
2019-09-30,218,144,74,3,141,0,0,0.0
2019-10-01,134,38,96,1,37,1,0,-7.291428571428071
2019-10-02,244,130,114,6,124,0,0,0.0
2019-10-03,162,57,105,1,56,1,1,6.614285714285984
2019-10-04,142,42,100,1,41,1,0,-6.5942857142862294
2019-10-06,14,0,14,0,0,0,0,0.0
2019-10-07,217,100,117,9,91,0,0,0.0
2019-10-08,220,102,118,2,100,1,1,5.292857142857599
2019-10-09,244,117,127,0,117,0,0,0.0
2019-10-10,102,17,85,3,14,1,1,4.47142857142876
2019-10-11,152,62,90,10,52,2,2,7.207142857143879
2019-10-13,16,0,16,0,0,0,0,0.0
2019-10-14,239,128,111,0,128,0,0,0.0
2019-10-15,166,39,127,4,35,1,1,4.207142857142799
2019-10-16,245,107,138,3,104,0,0,0.0
2019-10-17,232,71,161,4,67,0,0,0.0
2019-10-18,162,58,104,0,58,0,0,0.0
2019-10-20,4,3,1,0,3,0,0,0.0
2019-10-21,229,104,125,0,104,0,0,0.0
2019-10-22,255,72,183,0,72,0,0,0.0
2019-10-23,240,123,117,0,123,0,0,0.0
2019-10-24,186,53,133,0,53,0,0,0.0
2019-10-25,232,76,156,0,76,0,0,0.0
2019-10-27,14,0,14,0,0,0,0,0.0
2019-10-28,258,82,176,0,82,0,0,0.0
2019-10-29,172,61,111,0,61,0,0,0.0
2019-10-30,218,47,171,0,47,0,0,0.0
2019-10-31,128,24,104,6,18,2,2,7.278571428570558
2019-11-01,136,39,97,1,38,1,1,3.757142857142071
2019-11-03,2,0,2,0,0,0,0,0.0
2019-11-04,155,45,110,0,45,0,0,0.0
2019-11-05,135,34,101,1,33,1,1,4.642857142857338
2019-11-06,134,34,100,1,33,1,1,2.657142857142503
2019-11-07,124,27,97,2,25,2,1,-3.797142857141921
2019-11-08,147,59,88,2,57,1,1,2.885714285715835
2019-11-10,17,0,17,0,0,0,0,0.0
2019-11-11,215,111,104,0,111,0,0,0.0
2019-11-12,238,87,151,0,87,0,0,0.0
2019-11-13,169,63,106,2,61,1,1,2.507142857143208
2019-11-14,169,80,89,1,79,1,1,1.7999999999996135
2019-11-15,238,100,138,0,100,0,0,0.0
2019-11-17,13,0,13,0,0,0,0,0.0
2019-11-18,147,34,113,1,33,1,0,-5.1428571428577925
2019-11-19,190,68,122,2,66,1,1,2.157142857142958
2019-11-20,146,23,123,1,22,1,1,1.98571428571438
2019-11-21,100,42,58,1,41,1,0,-4.274285714284531
2019-11-22,220,97,123,3,94,0,0,0.0
2019-11-24,13,0,13,0,0,0,0,0.0
2019-11-25,204,41,163,0,41,0,0,0.0
2019-11-26,136,13,123,1,12,1,1,2.1499999999998636
2019-11-27,257,93,164,0,93,0,0,0.0
2019-11-28,240,100,140,0,100,0,0,0.0
2019-11-29,236,27,209,0,27,0,0,0.0
2019-12-01,11,0,11,0,0,0,0,0.0
2019-12-02,148,30,118,1,29,1,0,-5.514285714285904
2019-12-03,162,56,106,3,53,1,1,2.9071428571422757
2019-12-04,153,50,103,1,49,1,1,2.485714285713925
2019-12-05,125,21,104,1,20,1,1,2.014285714285336
2019-12-06,145,45,100,1,44,1,0,-5.577142857142292
2019-12-08,14,0,14,0,0,0,0,0.0
2019-12-09,231,97,134,0,97,0,0,0.0
2019-12-10,166,42,124,2,40,1,0,-5.291428571428469
2019-12-11,159,63,96,0,63,0,0,0.0
2019-12-12,139,43,96,1,42,1,1,5.485714285714039
2019-12-13,99,40,59,1,39,1,0,-4.588571428570731
2019-12-15,17,0,17,0,0,0,0,0.0
2019-12-16,221,57,164,0,57,0,0,0.0
2019-12-17,154,64,90,0,64,0,0,0.0
2019-12-18,154,42,112,0,42,0,0,0.0
2019-12-19,195,43,152,0,43,0,0,0.0
2019-12-20,157,81,76,0,81,0,0,0.0
2019-12-22,19,0,19,0,0,0,0,0.0
2019-12-23,178,78,100,0,78,0,0,0.0
2019-12-24,211,27,184,0,27,0,0,0.0
2019-12-25,98,0,98,0,0,0,0,0.0
2019-12-26,240,39,201,0,39,0,0,0.0
2019-12-27,196,45,151,0,45,0,0,0.0
2019-12-29,4,0,4,0,0,0,0,0.0
2019-12-30,150,39,111,1,38,1,1,2.8357142857141753
2019-12-31,228,58,170,6,52,0,0,0.0
2020-01-01,0,0,0,0,0,0,0,0.0
2020-01-02,63,38,25,1,37,1,1,2.5785714285713084
2020-01-03,101,15,86,3,12,2,0,-12.0285714285709
2020-01-05,14,0,14,0,0,0,0,0.0
2020-01-06,236,124,112,5,119,0,0,0.0
2020-01-07,143,36,107,1,35,1,1,3.1285714285710924
2020-01-08,228,113,115,9,104,1,1,2.707142857142742
2020-01-09,241,121,120,0,121,0,0,0.0
2020-01-10,102,51,51,3,48,1,1,2.485714285713925
2020-01-12,15,0,15,0,0,0,0,0.0
2020-01-13,244,69,175,0,69,0,0,0.0
2020-01-14,168,26,142,2,24,1,1,2.5000000000001137
2020-01-15,208,101,107,0,101,0,0,0.0
2020-01-16,172,49,123,2,47,1,1,2.3428571428577243
2020-01-17,161,26,135,1,25,1,0,-4.1942857142861385
2020-01-19,5,0,5,0,0,0,0,0.0
2020-01-20,204,51,153,0,51,0,0,0.0
2020-01-21,239,60,179,0,60,0,0,0.0
2020-01-22,251,96,155,0,96,0,0,0.0
2020-01-23,153,26,127,1,25,1,1,3.121428571429419
2020-01-24,157,46,111,2,44,1,1,2.157142857142958
2020-01-26,13,0,13,0,0,0,0,0.0
2020-01-27,127,63,64,1,62,1,0,-4.291428571429378
2020-01-28,178,66,112,2,64,1,1,2.4714285714277366
2020-01-29,98,31,67,1,30,1,1,2.392857142856542
2020-01-30,145,28,117,1,27,1,0,-5.497142857142478
2020-01-31,166,73,93,2,71,1,1,2.4285714285720132
2020-02-02,0,0,0,0,0,0,0,0.0
2020-02-03,122,16,106,1,15,1,1,2.5857142857144026
2020-02-04,133,37,96,2,35,1,1,2.0285714285715244
2020-02-05,128,59,69,2,57,1,0,-5.148571428572268
2020-02-06,238,116,122,0,116,0,0,0.0
2020-02-07,150,33,117,1,32,1,1,2.5285714285710696
2020-02-09,18,0,18,0,0,0,0,0.0
2020-02-10,181,72,109,0,72,0,0,0.0
2020-02-11,193,66,127,0,66,0,0,0.0
2020-02-12,257,112,145,0,112,0,0,0.0
2020-02-13,179,39,140,1,38,1,1,2.157142857142958
2020-02-14,214,125,89,0,125,0,0,0.0
2020-02-16,0,0,0,0,0,0,0,0.0
2020-02-17,173,98,75,0,98,0,0,0.0
2020-02-18,214,78,136,1,77,0,0,0.0
2020-02-19,173,46,127,1,45,1,1,3.4142857142849152
2020-02-20,106,2,104,2,0,2,0,-9.874285714286145
2020-02-21,111,17,94,5,12,2,1,-3.0614285714273706
2020-02-23,13,0,13,0,0,0,0,0.0
2020-02-24,175,69,106,1,68,1,1,5.614285714285472
2020-02-25,163,48,115,12,36,1,0,-5.839999999999634
2020-02-26,118,12,106,7,5,2,1,0.944285714284888
2020-02-27,108,2,106,2,0,2,1,-0.4614285714291668
2020-02-28,119,51,68,9,42,2,2,14.778571428570842
2020-03-01,3,0,3,0,0,0,0,0.0
2020-03-02,181,84,97,1,83,1,0,-7.242857142857872
2020-03-03,113,3,110,2,1,2,0,-16.297142857143342
2020-03-04,205,100,105,3,97,0,0,0.0
2020-03-05,122,16,106,7,9,2,2,10.007142857143037
2020-03-06,101,10,91,2,8,2,1,-6.207142857142344
2020-03-08,15,0,15,0,0,0,0,0.0
2020-03-09,123,11,112,8,3,2,1,-16.337142857141828
2020-03-10,190,89,101,1,88,1,0,-15.105714285714555
2020-03-11,178,65,113,1,64,1,0,-10.465714285714
2020-03-12,207,103,104,1,102,1,0,-11.422857142857367
2020-03-13,176,81,95,1,80,1,0,-12.660000000000082
2020-03-15,18,12,6,0,12,0,0,0.0
2020-03-16,140,101,39,1,100,1,0,-12.402857142857215
2020-03-17,242,127,115,29,98,0,0,0.0
2020-03-18,216,114,102,4,110,1,1,9.70714285714348
2020-03-19,242,133,109,52,81,0,0,0.0
2020-03-20,223,130,93,45,85,0,0,0.0
2020-03-22,6,0,6,0,0,0,0,0.0
2020-03-23,244,136,108,22,114,1,1,15.41428571428537
2020-03-24,263,149,114,46,103,0,0,0.0
2020-03-25,202,95,107,3,92,1,1,5.4357142857138
2020-03-26,207,96,111,43,53,1,1,13.12142857142885
2020-03-27,128,32,96,29,3,1,1,9.071428571427987
2020-03-29,12,0,12,0,0,0,0,0.0
2020-03-30,163,71,92,27,44,0,0,0.0
2020-03-31,160,46,114,5,41,1,1,7.857142857143174
2020-04-01,161,50,111,12,38,1,1,5.600000000000705
2020-04-02,134,23,111,1,22,1,0,-8.49999999999983
2020-04-03,85,53,32,1,52,1,0,-9.962857142857217
2020-04-05,11,0,11,0,0,0,0,0.0
2020-04-06,207,94,113,2,92,0,0,0.0
2020-04-07,160,45,115,1,44,1,1,4.414285714285427
2020-04-08,151,55,96,1,54,1,1,5.778571428570956
2020-04-09,175,61,114,3,58,1,1,3.5142857142853927
2020-04-10,204,115,89,0,115,0,0,0.0
2020-04-12,11,10,1,0,10,0,0,0.0
2020-04-13,216,104,112,3,101,0,0,0.0
2020-04-14,148,58,90,9,49,1,1,3.171428571428237
2020-04-15,138,33,105,1,32,1,0,-7.065714285713398
2020-04-16,149,49,100,1,48,1,0,-6.671428571428805
2020-04-17,151,55,96,1,54,1,1,5.971428571428817
2020-04-19,18,0,18,0,0,0,0,0.0
2020-04-20,244,134,110,2,132,0,0,0.0
2020-04-21,141,33,108,1,32,1,0,-5.9199999999994475
2020-04-22,165,65,100,7,58,0,0,0.0
2020-04-23,88,35,53,1,34,1,1,5.71428571428595
2020-04-24,230,134,96,0,134,0,0,0.0
2020-04-26,23,5,18,0,5,0,0,0.0
2020-04-27,249,149,100,14,135,0,0,0.0
2020-04-28,263,106,157,3,103,0,0,0.0
2020-04-29,146,41,105,1,40,1,1,4.69999999999925
2020-04-30,146,43,103,3,40,1,0,-6.577142857142803
2020-05-01,105,65,40,1,64,1,1,5.47142857142785
2020-05-03,6,0,6,0,0,0,0,0.0
2020-05-04,238,121,117,0,121,0,0,0.0
2020-05-05,242,115,127,1,114,0,0,0.0
2020-05-06,252,131,121,2,129,0,0,0.0
2020-05-07,258,148,110,15,133,0,0,0.0
2020-05-08,189,86,103,0,86,0,0,0.0
2020-05-10,26,9,17,2,7,1,0,-6.908571428571008
2020-05-11,230,141,89,0,141,0,0,0.0
2020-05-12,229,119,110,0,119,0,0,0.0
2020-05-13,138,34,104,1,33,1,1,6.849999999999568
2020-05-14,241,118,123,1,117,0,0,0.0
2020-05-15,208,134,74,7,127,0,0,0.0
2020-05-17,28,12,16,0,12,0,0,0.0
2020-05-18,162,128,34,1,127,0,0,0.0
2020-05-19,263,137,126,7,130,0,0,0.0
2020-05-20,191,110,81,0,110,0,0,0.0
2020-05-21,200,94,106,0,94,0,0,0.0
2020-05-22,170,88,82,0,88,0,0,0.0
2020-05-24,16,6,10,0,6,0,0,0.0
2020-05-25,165,76,89,0,76,0,0,0.0
2020-05-26,201,40,161,0,40,0,0,0.0
2020-05-27,216,138,78,0,138,0,0,0.0
2020-05-28,244,142,102,0,142,0,0,0.0
2020-05-29,127,36,91,5,31,1,1,4.54285714285686
2020-05-31,12,0,12,0,0,0,0,0.0
2020-06-01,245,141,104,0,141,0,0,0.0
2020-06-02,138,31,107,1,30,1,0,-6.722857142857663
2020-06-03,248,137,111,0,137,0,0,0.0
2020-06-04,167,42,125,1,41,1,0,-7.69142857142856
2020-06-05,140,55,85,1,54,1,0,-7.688571428571322
2020-06-07,3,0,3,0,0,0,0,0.0
2020-06-08,167,57,110,9,48,1,1,7.735714285714835
2020-06-09,175,64,111,9,55,1,1,6.60714285714289
2020-06-10,209,102,107,6,96,1,1,5.9357142857147664
2020-06-11,133,44,89,4,40,1,1,5.335714285714744
2020-06-12,142,62,80,4,58,1,0,-7.411428571429212
2020-06-14,4,0,4,0,0,0,0,0.0
2020-06-15,221,120,101,0,120,0,0,0.0
2020-06-16,137,51,86,6,45,1,1,5.542857142857372
2020-06-17,199,96,103,0,96,0,0,0.0
2020-06-18,155,48,107,10,38,1,0,-7.502857142856556
2020-06-19,146,61,85,0,61,0,0,0.0
2020-06-21,14,12,2,0,12,0,0,0.0
2020-06-22,212,105,107,0,105,0,0,0.0
2020-06-23,151,38,113,1,37,1,1,7.207142857142912
2020-06-24,205,115,90,1,114,0,0,0.0
2020-06-25,208,141,67,0,141,0,0,0.0
2020-06-26,224,106,118,0,106,0,0,0.0
2020-06-28,14,12,2,0,12,0,0,0.0
2020-06-29,108,30,78,1,29,1,1,5.4357142857138
2020-06-30,157,56,101,4,52,1,0,-7.5428571428578834
2020-07-01,157,53,104,0,53,0,0,0.0
2020-07-02,213,109,104,0,109,0,0,0.0
2020-07-03,164,71,93,0,71,0,0,0.0
2020-07-05,19,4,15,0,4,0,0,0.0
2020-07-06,231,91,140,0,91,0,0,0.0
2020-07-07,248,137,111,0,137,0,0,0.0
2020-07-08,259,118,141,0,118,0,0,0.0
2020-07-09,225,98,127,0,98,0,0,0.0
2020-07-10,229,116,113,0,116,0,0,0.0
2020-07-12,25,10,15,0,10,0,0,0.0
2020-07-13,179,72,107,0,72,0,0,0.0
2020-07-14,240,148,92,0,148,0,0,0.0
2020-07-15,204,118,86,0,118,0,0,0.0
2020-07-16,244,106,138,0,106,0,0,0.0
2020-07-17,206,78,128,0,78,0,0,0.0
2020-07-19,11,10,1,0,10,0,0,0.0
2020-07-20,248,111,137,0,111,0,0,0.0
2020-07-21,259,122,137,0,122,0,0,0.0
2020-07-22,221,138,83,0,138,0,0,0.0
2020-07-23,198,54,144,0,54,0,0,0.0
2020-07-24,140,44,96,5,39,1,1,5.8214285714281
2020-07-26,7,0,7,0,0,0,0,0.0
2020-07-27,208,113,95,7,106,0,0,0.0
2020-07-28,209,113,96,12,101,0,0,0.0
2020-07-29,184,86,98,9,77,1,1,5.192857142857122
2020-07-30,156,44,112,1,43,1,0,-9.131428571428046
2020-07-31,146,50,96,1,49,1,1,6.599999999999795
2020-08-02,4,0,4,0,0,0,0,0.0
2020-08-03,151,65,86,2,63,1,1,5.892857142857622
2020-08-04,172,60,112,3,57,1,1,4.521428571428999
2020-08-05,124,24,100,1,23,1,1,4.514285714285904
2020-08-06,149,50,99,7,43,1,1,3.692857142857065
2020-08-07,117,23,94,1,22,1,0,-7.10000000000025
2020-08-09,6,0,6,0,0,0,0,0.0
2020-08-10,207,91,116,6,85,0,0,0.0
2020-08-11,244,102,142,0,102,0,0,0.0
2020-08-12,139,39,100,1,38,1,0,-5.574285714285054
2020-08-13,220,106,114,0,106,0,0,0.0
2020-08-14,193,107,86,0,107,0,0,0.0
2020-08-16,20,10,10,0,10,0,0,0.0
2020-08-17,243,151,92,0,151,0,0,0.0
2020-08-18,186,72,114,3,69,0,0,0.0
2020-08-19,172,53,119,8,45,1,1,4.7785714285718655
2020-08-20,229,130,99,2,128,0,0,0.0
2020-08-21,169,39,130,1,38,1,1,4.414285714285427
2020-08-23,18,0,18,0,0,0,0,0.0
2020-08-24,199,135,64,0,135,0,0,0.0
2020-08-25,202,59,143,0,59,0,0,0.0
2020-08-26,234,107,127,0,107,0,0,0.0
2020-08-27,87,2,85,1,1,1,0,-11.79428571428548
2020-08-28,157,56,101,1,55,1,1,6.9214285714290895
2020-08-30,2,0,2,0,0,0,0,0.0
2020-08-31,174,147,27,0,147,0,0,0.0
2020-09-01,170,59,111,3,56,1,1,4.15714285714256
2020-09-02,152,37,115,0,37,0,0,0.0
2020-09-03,172,62,110,2,60,1,1,3.7142857142863477
2020-09-04,190,113,77,12,101,0,0,0.0
2020-09-06,26,12,14,0,12,0,0,0.0
2020-09-07,246,110,136,0,110,0,0,0.0
2020-09-08,156,7,149,1,6,1,0,-6.245714285714598
2020-09-09,110,78,32,0,78,0,0,0.0
2020-09-10,232,115,117,0,115,0,0,0.0
2020-09-11,199,83,116,0,83,0,0,0.0
2020-09-13,24,1,23,0,1,0,0,0.0
2020-09-14,253,122,131,1,121,0,0,0.0
2020-09-15,230,107,123,0,107,0,0,0.0
2020-09-16,155,40,115,1,39,1,0,-5.391428571428946
2020-09-17,268,155,113,5,150,0,0,0.0
2020-09-18,197,83,114,0,83,0,0,0.0
2020-09-20,12,8,4,0,8,0,0,0.0
2020-09-21,98,11,87,1,10,1,1,8.414285714286052
2020-09-22,170,69,101,5,64,1,1,4.5499999999999545
2020-09-23,231,130,101,0,130,0,0,0.0
2020-09-24,199,86,113,0,86,0,0,0.0
2020-09-25,227,118,109,0,118,0,0,0.0
2020-09-27,22,12,10,0,12,0,0,0.0
2020-09-28,211,97,114,0,97,0,0,0.0
2020-09-29,181,75,106,0,75,0,0,0.0
2020-09-30,254,120,134,5,115,0,0,0.0
2020-10-01,221,121,100,0,121,0,0,0.0
2020-10-02,201,75,126,4,71,0,0,0.0
2020-10-04,20,8,12,0,8,0,0,0.0
2020-10-05,211,83,128,0,83,0,0,0.0
2020-10-06,210,74,136,0,74,0,0,0.0
2020-10-07,246,106,140,0,106,0,0,0.0
2020-10-08,176,70,106,0,70,0,0,0.0
2020-10-09,213,67,146,0,67,0,0,0.0
2020-10-11,31,6,25,0,6,0,0,0.0
2020-10-12,188,71,117,0,71,0,0,0.0
2020-10-13,186,52,134,0,52,0,0,0.0
2020-10-14,240,81,159,0,81,0,0,0.0
2020-10-15,256,109,147,0,109,0,0,0.0
2020-10-16,208,89,119,0,89,0,0,0.0
2020-10-18,11,0,11,0,0,0,0,0.0
2020-10-19,214,87,127,0,87,0,0,0.0
2020-10-20,252,103,149,0,103,0,0,0.0
2020-10-21,241,112,129,2,110,0,0,0.0
2020-10-22,256,132,124,0,132,0,0,0.0
2020-10-23,160,53,107,0,53,0,0,0.0
2020-10-25,29,7,22,0,7,0,0,0.0
2020-10-26,246,115,131,0,115,0,0,0.0
2020-10-27,246,92,154,0,92,0,0,0.0
2020-10-28,219,107,112,0,107,0,0,0.0
2020-10-29,251,143,108,0,143,0,0,0.0
2020-10-30,160,56,104,3,53,1,0,-6.880000000000052
2020-11-01,8,0,8,0,0,0,0,0.0
2020-11-02,244,137,107,0,137,0,0,0.0
2020-11-03,188,98,90,0,98,0,0,0.0
2020-11-04,163,50,113,1,49,1,1,5.428571428570706
2020-11-05,164,49,115,1,48,1,0,-7.391428571428548
2020-11-06,137,49,88,5,44,1,0,-7.891428571428094
2020-11-08,10,0,10,0,0,0,0,0.0
2020-11-09,148,47,101,1,46,1,0,-12.73428571428542
2020-11-10,162,66,96,0,66,0,0,0.0
2020-11-11,176,77,99,0,77,0,0,0.0
2020-11-12,248,143,105,0,143,0,0,0.0
2020-11-13,240,139,101,0,139,0,0,0.0
2020-11-15,0,0,0,0,0,0,0,0.0
2020-11-16,233,146,87,0,146,0,0,0.0
2020-11-17,205,74,131,0,74,0,0,0.0
2020-11-18,231,103,128,0,103,0,0,0.0
2020-11-19,216,120,96,0,120,0,0,0.0
2020-11-20,160,68,92,0,68,0,0,0.0
2020-11-22,16,0,16,0,0,0,0,0.0
2020-11-23,174,53,121,2,51,0,0,0.0
2020-11-24,198,104,94,0,104,0,0,0.0
2020-11-25,191,72,119,0,72,0,0,0.0
2020-11-26,207,79,128,0,79,0,0,0.0
2020-11-27,224,102,122,0,102,0,0,0.0
2020-11-29,11,0,11,0,0,0,0,0.0
2020-11-30,232,97,135,0,97,0,0,0.0
2020-12-01,220,106,114,0,106,0,0,0.0
2020-12-02,250,124,126,0,124,0,0,0.0
2020-12-03,211,83,128,0,83,0,0,0.0
2020-12-04,175,114,61,5,109,0,0,0.0
2020-12-06,17,0,17,0,0,0,0,0.0
2020-12-07,211,142,69,0,142,0,0,0.0
2020-12-08,152,34,118,0,34,0,0,0.0
2020-12-09,261,71,190,0,71,0,0,0.0
2020-12-10,228,118,110,0,118,0,0,0.0
2020-12-11,219,105,114,0,105,0,0,0.0
2020-12-13,0,0,0,0,0,0,0,0.0
2020-12-14,182,132,50,0,132,0,0,0.0
2020-12-15,229,117,112,0,117,0,0,0.0
2020-12-16,257,141,116,2,139,0,0,0.0
2020-12-17,189,87,102,0,87,0,0,0.0
2020-12-18,168,71,97,0,71,0,0,0.0
2020-12-20,0,0,0,0,0,0,0,0.0
2020-12-21,148,128,20,0,128,0,0,0.0
2020-12-22,224,109,115,0,109,0,0,0.0
2020-12-23,168,40,128,0,40,0,0,0.0
2020-12-24,224,98,126,0,98,0,0,0.0
2020-12-25,58,0,58,0,0,0,0,0.0
2020-12-27,17,0,17,0,0,0,0,0.0
2020-12-28,223,92,131,0,92,0,0,0.0
2020-12-29,212,101,111,0,101,0,0,0.0
2020-12-30,244,114,130,0,114,0,0,0.0
2020-12-31,132,119,13,0,119,0,0,0.0
2021-01-03,10,0,10,0,0,0,0,0.0
2021-01-04,245,133,112,0,133,0,0,0.0
2021-01-05,245,136,109,0,136,0,0,0.0
2021-01-06,222,130,92,0,130,0,0,0.0
2021-01-07,245,142,103,0,142,0,0,0.0
2021-01-08,232,141,91,14,127,0,0,0.0
2021-01-10,18,0,18,0,0,0,0,0.0
2021-01-11,219,111,108,0,111,0,0,0.0
2021-01-12,182,103,79,0,103,0,0,0.0
2021-01-13,201,90,111,0,90,0,0,0.0
2021-01-14,207,105,102,0,105,0,0,0.0
2021-01-15,160,120,40,0,120,0,0,0.0
2021-01-17,5,0,5,0,0,0,0,0.0
2021-01-18,231,127,104,0,127,0,0,0.0
2021-01-19,201,82,119,0,82,0,0,0.0
2021-01-20,247,123,124,0,123,0,0,0.0
2021-01-21,252,116,136,0,116,0,0,0.0
2021-01-22,198,55,143,0,55,0,0,0.0
2021-01-24,1,0,1,0,0,0,0,0.0
2021-01-25,185,69,116,0,69,0,0,0.0
2021-01-26,177,47,130,0,47,0,0,0.0
2021-01-27,247,66,181,0,66,0,0,0.0
2021-01-28,218,107,111,0,107,0,0,0.0
2021-01-29,191,87,104,0,87,0,0,0.0
2021-01-31,18,0,18,0,0,0,0,0.0
2021-02-01,183,84,99,0,84,0,0,0.0
2021-02-02,220,120,100,0,120,0,0,0.0
2021-02-03,132,33,99,0,33,0,0,0.0
2021-02-04,254,97,157,0,97,0,0,0.0
2021-02-05,209,121,88,10,111,0,0,0.0
2021-02-07,17,0,17,0,0,0,0,0.0
2021-02-08,258,149,109,0,149,0,0,0.0
2021-02-09,191,62,129,0,62,0,0,0.0
2021-02-10,249,127,122,0,127,0,0,0.0
2021-02-11,158,60,98,0,60,0,0,0.0
2021-02-12,230,106,124,0,106,0,0,0.0
2021-02-14,11,0,11,0,0,0,0,0.0
2021-02-15,218,73,145,0,73,0,0,0.0
2021-02-16,265,110,155,0,110,0,0,0.0
2021-02-17,219,121,98,1,120,0,0,0.0
2021-02-18,176,60,116,0,60,0,0,0.0
2021-02-19,247,126,121,0,126,0,0,0.0
2021-02-21,14,0,14,0,0,0,0,0.0
2021-02-22,245,141,104,0,141,0,0,0.0
2021-02-23,242,128,114,0,128,0,0,0.0
2021-02-24,222,99,123,0,99,0,0,0.0
2021-02-25,239,130,109,3,127,0,0,0.0
2021-02-26,232,148,84,0,148,0,0,0.0
2021-02-28,6,0,6,0,0,0,0,0.0
2021-03-01,233,142,91,0,142,0,0,0.0
2021-03-02,238,129,109,0,129,0,0,0.0
2021-03-03,261,128,133,0,128,0,0,0.0
2021-03-04,265,137,128,0,137,0,0,0.0
2021-03-05,148,57,91,8,49,1,0,-9.571428571429863
2021-03-07,13,0,13,0,0,0,0,0.0
2021-03-08,236,140,96,0,140,0,0,0.0
2021-03-09,257,141,116,0,141,0,0,0.0
2021-03-10,209,100,109,11,89,0,0,0.0
2021-03-11,214,106,108,0,106,0,0,0.0
2021-03-12,149,48,101,0,48,0,0,0.0
2021-03-14,22,4,18,0,4,0,0,0.0
2021-03-15,209,116,93,0,116,0,0,0.0
2021-03-16,178,60,118,0,60,0,0,0.0
2021-03-17,255,118,137,3,115,0,0,0.0
2021-03-18,237,145,92,0,145,0,0,0.0
2021-03-19,156,60,96,0,60,0,0,0.0
2021-03-21,21,12,9,0,12,0,0,0.0
2021-03-22,105,66,39,0,66,0,0,0.0
2021-03-23,220,82,138,0,82,0,0,0.0
2021-03-24,184,75,109,0,75,0,0,0.0
2021-03-25,229,103,126,0,103,0,0,0.0
2021-03-26,233,126,107,0,126,0,0,0.0
2021-03-28,28,11,17,0,11,0,0,0.0
2021-03-29,236,138,98,0,138,0,0,0.0
2021-03-30,179,65,114,0,65,0,0,0.0
2021-03-31,208,76,132,0,76,0,0,0.0
2021-04-01,215,102,113,0,102,0,0,0.0
2021-04-02,147,35,112,0,35,0,0,0.0
2021-04-04,12,0,12,0,0,0,0,0.0
2021-04-05,195,89,106,0,89,0,0,0.0
2021-04-06,177,70,107,2,68,0,0,0.0
2021-04-07,168,64,104,0,64,0,0,0.0
2021-04-08,240,118,122,0,118,0,0,0.0
2021-04-09,190,136,54,0,136,0,0,0.0
2021-04-11,30,11,19,0,11,0,0,0.0
2021-04-12,258,121,137,0,121,0,0,0.0
2021-04-13,254,90,164,0,90,0,0,0.0
2021-04-14,202,91,111,0,91,0,0,0.0
2021-04-15,220,95,125,0,95,0,0,0.0
2021-04-16,223,121,102,0,121,0,0,0.0
2021-04-18,29,12,17,0,12,0,0,0.0
2021-04-19,143,34,109,0,34,0,0,0.0
2021-04-20,242,119,123,0,119,0,0,0.0
2021-04-21,263,135,128,0,135,0,0,0.0
2021-04-22,240,67,173,0,67,0,0,0.0
2021-04-23,199,101,98,0,101,0,0,0.0
2021-04-25,29,1,28,0,1,0,0,0.0
2021-04-26,240,117,123,0,117,0,0,0.0
2021-04-27,252,103,149,0,103,0,0,0.0
2021-04-28,225,93,132,0,93,0,0,0.0
2021-04-29,210,92,118,0,92,0,0,0.0
2021-04-30,229,128,101,0,128,0,0,0.0
2021-05-02,13,12,1,0,12,0,0,0.0
2021-05-03,265,141,124,0,141,0,0,0.0
2021-05-04,253,142,111,0,142,0,0,0.0
2021-05-05,220,74,146,0,74,0,0,0.0
2021-05-06,265,125,140,0,125,0,0,0.0
2021-05-07,128,24,104,1,23,1,0,-14.188571428571095
2021-05-09,0,0,0,0,0,0,0,0.0
2021-05-10,210,111,99,0,111,0,0,0.0
2021-05-11,223,118,105,0,118,0,0,0.0
2021-05-12,249,135,114,2,133,0,0,0.0
2021-05-13,178,85,93,0,85,0,0,0.0
2021-05-14,152,37,115,0,37,0,0,0.0
2021-05-16,31,11,20,0,11,0,0,0.0
2021-05-17,148,65,83,0,65,0,0,0.0
2021-05-18,176,57,119,0,57,0,0,0.0
2021-05-19,235,85,150,0,85,0,0,0.0
2021-05-20,253,100,153,0,100,0,0,0.0
2021-05-21,211,65,146,0,65,0,0,0.0
2021-05-23,16,12,4,0,12,0,0,0.0
2021-05-24,240,134,106,0,134,0,0,0.0
2021-05-25,224,74,150,0,74,0,0,0.0
2021-05-26,222,111,111,0,111,0,0,0.0
2021-05-27,263,104,159,0,104,0,0,0.0
2021-05-28,225,103,122,0,103,0,0,0.0
2021-05-30,23,12,11,0,12,0,0,0.0
2021-05-31,249,90,159,0,90,0,0,0.0
2021-06-01,217,96,121,0,96,0,0,0.0
2021-06-02,264,125,139,0,125,0,0,0.0
2021-06-03,262,79,183,0,79,0,0,0.0
2021-06-04,231,113,118,0,113,0,0,0.0
2021-06-06,29,12,17,0,12,0,0,0.0
2021-06-07,98,29,69,0,29,0,0,0.0
2021-06-08,253,59,194,0,59,0,0,0.0
2021-06-09,243,59,184,0,59,0,0,0.0
2021-06-10,254,108,146,0,108,0,0,0.0
2021-06-11,192,63,129,0,63,0,0,0.0
2021-06-13,3,0,3,0,0,0,0,0.0
2021-06-14,229,101,128,0,101,0,0,0.0
2021-06-15,169,32,137,0,32,0,0,0.0
2021-06-16,224,42,182,0,42,0,0,0.0
2021-06-17,246,143,103,0,143,0,0,0.0
2021-06-18,232,114,118,0,114,0,0,0.0
2021-06-20,12,12,0,0,12,0,0,0.0
2021-06-21,232,127,105,0,127,0,0,0.0
2021-06-22,184,78,106,0,78,0,0,0.0
2021-06-23,242,117,125,0,117,0,0,0.0
2021-06-24,229,115,114,0,115,0,0,0.0
2021-06-25,215,79,136,0,79,0,0,0.0
2021-06-27,12,12,0,0,12,0,0,0.0
2021-06-28,246,130,116,0,130,0,0,0.0
2021-06-29,251,108,143,0,108,0,0,0.0
2021-06-30,224,78,146,0,78,0,0,0.0
2021-07-01,244,95,149,0,95,0,0,0.0
2021-07-02,179,42,137,0,42,0,0,0.0
2021-07-04,31,3,28,0,3,0,0,0.0
2021-07-05,163,73,90,0,73,0,0,0.0
2021-07-06,246,98,148,0,98,0,0,0.0
2021-07-07,174,51,123,0,51,0,0,0.0
2021-07-08,244,123,121,0,123,0,0,0.0
2021-07-09,232,122,110,0,122,0,0,0.0
2021-07-11,20,12,8,0,12,0,0,0.0
2021-07-12,187,135,52,0,135,0,0,0.0
2021-07-13,233,89,144,0,89,0,0,0.0
2021-07-14,249,92,157,0,92,0,0,0.0
2021-07-15,215,73,142,0,73,0,0,0.0
2021-07-16,226,120,106,0,120,0,0,0.0
2021-07-18,26,12,14,0,12,0,0,0.0
2021-07-19,209,79,130,0,79,0,0,0.0
2021-07-20,259,149,110,0,149,0,0,0.0
2021-07-21,154,50,104,0,50,0,0,0.0
2021-07-22,173,34,139,0,34,0,0,0.0
2021-07-23,175,54,121,0,54,0,0,0.0
2021-07-25,4,0,4,0,0,0,0,0.0
2021-07-26,176,38,138,0,38,0,0,0.0
2021-07-27,227,81,146,0,81,0,0,0.0
2021-07-28,240,128,112,0,128,0,0,0.0
2021-07-29,219,91,128,0,91,0,0,0.0
2021-07-30,176,73,103,0,73,0,0,0.0
2021-08-01,16,6,10,0,6,0,0,0.0
2021-08-02,180,109,71,0,109,0,0,0.0
2021-08-03,255,123,132,0,123,0,0,0.0
2021-08-04,210,73,137,0,73,0,0,0.0
2021-08-05,246,94,152,0,94,0,0,0.0
2021-08-06,240,62,178,0,62,0,0,0.0
2021-08-08,18,0,18,0,0,0,0,0.0
2021-08-09,218,73,145,0,73,0,0,0.0
2021-08-10,216,109,107,0,109,0,0,0.0
2021-08-11,208,22,186,0,22,0,0,0.0
2021-08-12,247,101,146,0,101,0,0,0.0
2021-08-13,195,35,160,0,35,0,0,0.0
2021-08-15,13,0,13,0,0,0,0,0.0
2021-08-16,164,49,115,0,49,0,0,0.0
2021-08-17,208,71,137,0,71,0,0,0.0
2021-08-18,212,77,135,0,77,0,0,0.0
2021-08-19,150,38,112,0,38,0,0,0.0
2021-08-20,142,32,110,0,32,0,0,0.0
2021-08-22,30,12,18,0,12,0,0,0.0
2021-08-23,217,48,169,0,48,0,0,0.0
2021-08-24,255,73,182,0,73,0,0,0.0
2021-08-25,226,70,156,0,70,0,0,0.0
2021-08-26,241,132,109,0,132,0,0,0.0
2021-08-27,213,84,129,0,84,0,0,0.0
2021-08-29,18,12,6,0,12,0,0,0.0
2021-08-30,193,81,112,0,81,0,0,0.0
2021-08-31,247,71,176,0,71,0,0,0.0
2021-09-01,178,34,144,0,34,0,0,0.0
2021-09-02,235,76,159,0,76,0,0,0.0
2021-09-03,235,56,179,0,56,0,0,0.0
2021-09-05,11,7,4,0,7,0,0,0.0
2021-09-06,168,33,135,0,33,0,0,0.0
2021-09-07,217,72,145,0,72,0,0,0.0
2021-09-08,170,29,141,0,29,0,0,0.0
2021-09-09,211,65,146,0,65,0,0,0.0
2021-09-10,154,63,91,0,63,0,0,0.0
2021-09-12,10,4,6,0,4,0,0,0.0
2021-09-13,219,82,137,0,82,0,0,0.0
2021-09-14,247,49,198,0,49,0,0,0.0
2021-09-15,205,52,153,0,52,0,0,0.0
2021-09-16,185,38,147,0,38,0,0,0.0
2021-09-17,236,72,164,0,72,0,0,0.0
2021-09-19,13,12,1,0,12,0,0,0.0
2021-09-20,228,83,145,0,83,0,0,0.0
2021-09-21,224,103,121,0,103,0,0,0.0
2021-09-22,225,92,133,0,92,0,0,0.0
2021-09-23,245,121,124,0,121,0,0,0.0
2021-09-24,209,101,108,0,101,0,0,0.0
2021-09-26,12,12,0,0,12,0,0,0.0
2021-09-27,235,103,132,0,103,0,0,0.0
2021-09-28,207,57,150,0,57,0,0,0.0
2021-09-29,249,123,126,0,123,0,0,0.0
2021-09-30,262,116,146,0,116,0,0,0.0
2021-10-01,148,58,90,0,58,0,0,0.0
2021-10-03,12,12,0,0,12,0,0,0.0
2021-10-04,233,144,89,0,144,0,0,0.0
2021-10-05,265,145,120,0,145,0,0,0.0
2021-10-06,210,98,112,0,98,0,0,0.0
2021-10-07,237,96,141,0,96,0,0,0.0
2021-10-08,241,100,141,0,100,0,0,0.0
2021-10-10,15,12,3,0,12,0,0,0.0
2021-10-11,228,125,103,0,125,0,0,0.0
2021-10-12,142,44,98,0,44,0,0,0.0
2021-10-13,236,103,133,1,102,0,0,0.0
2021-10-14,244,126,118,0,126,0,0,0.0
2021-10-15,238,118,120,0,118,0,0,0.0
2021-10-17,14,12,2,0,12,0,0,0.0
2021-10-18,109,42,67,0,42,0,0,0.0
2021-10-19,223,111,112,0,111,0,0,0.0
2021-10-20,172,43,129,0,43,0,0,0.0
2021-10-21,207,99,108,0,99,0,0,0.0
2021-10-22,223,127,96,0,127,0,0,0.0
2021-10-24,27,12,15,0,12,0,0,0.0
2021-10-25,220,118,102,0,118,0,0,0.0
2021-10-26,207,79,128,0,79,0,0,0.0
2021-10-27,225,92,133,0,92,0,0,0.0
2021-10-28,195,92,103,0,92,0,0,0.0
2021-10-29,201,90,111,0,90,0,0,0.0
2021-10-31,19,12,7,0,12,0,0,0.0
2021-11-01,221,131,90,0,131,0,0,0.0
2021-11-02,230,130,100,0,130,0,0,0.0
2021-11-03,243,109,134,4,105,0,0,0.0
2021-11-04,266,141,125,0,141,0,0,0.0
2021-11-05,201,108,93,1,107,0,0,0.0
2021-11-07,19,0,19,0,0,0,0,0.0
2021-11-08,263,133,130,0,133,0,0,0.0
2021-11-09,244,107,137,0,107,0,0,0.0
2021-11-10,248,153,95,0,153,0,0,0.0
2021-11-11,225,114,111,0,114,0,0,0.0
2021-11-12,225,98,127,0,98,0,0,0.0
2021-11-14,17,0,17,0,0,0,0,0.0
2021-11-15,239,140,99,0,140,0,0,0.0
2021-11-16,250,112,138,0,112,0,0,0.0
2021-11-17,254,149,105,0,149,0,0,0.0
2021-11-18,132,69,63,0,69,0,0,0.0
2021-11-19,233,101,132,0,101,0,0,0.0
2021-11-21,18,0,18,0,0,0,0,0.0
2021-11-22,220,109,111,2,107,0,0,0.0
2021-11-23,182,75,107,0,75,0,0,0.0
2021-11-24,242,149,93,0,149,0,0,0.0
2021-11-25,147,48,99,0,48,0,0,0.0
2021-11-26,203,102,101,6,96,0,0,0.0
2021-11-28,11,0,11,0,0,0,0,0.0
2021-11-29,138,82,56,3,79,0,0,0.0
2021-11-30,266,153,113,21,132,0,0,0.0
2021-12-01,231,122,109,0,122,0,0,0.0
2021-12-02,247,135,112,0,135,0,0,0.0
2021-12-03,226,152,74,1,151,0,0,0.0
2021-12-05,14,0,14,0,0,0,0,0.0
2021-12-06,247,124,123,0,124,0,0,0.0
2021-12-07,164,49,115,0,49,0,0,0.0
2021-12-08,227,139,88,0,139,0,0,0.0
2021-12-09,241,131,110,0,131,0,0,0.0
2021-12-10,250,153,97,0,153,0,0,0.0
2021-12-12,17,0,17,0,0,0,0,0.0
2021-12-13,249,121,128,0,121,0,0,0.0
2021-12-14,248,119,129,0,119,0,0,0.0
2021-12-15,228,98,130,0,98,0,0,0.0
2021-12-16,247,128,119,0,128,0,0,0.0
2021-12-17,249,156,93,0,156,0,0,0.0
2021-12-19,11,0,11,0,0,0,0,0.0
2021-12-20,218,126,92,0,126,0,0,0.0
2021-12-21,241,136,105,0,136,0,0,0.0
2021-12-22,157,66,91,0,66,0,0,0.0
2021-12-23,238,80,158,0,80,0,0,0.0
2021-12-24,216,70,146,0,70,0,0,0.0
2021-12-26,2,0,2,0,0,0,0,0.0
2021-12-27,224,86,138,0,86,0,0,0.0
2021-12-28,245,111,134,0,111,0,0,0.0
2021-12-29,202,58,144,0,58,0,0,0.0
2021-12-30,193,58,135,0,58,0,0,0.0
2021-12-31,219,49,170,0,49,0,0,0.0
2022-01-02,18,0,18,0,0,0,0,0.0
2022-01-03,264,104,160,0,104,0,0,0.0
2022-01-04,267,148,119,0,148,0,0,0.0
2022-01-05,240,124,116,0,124,0,0,0.0
2022-01-06,206,91,115,0,91,0,0,0.0
2022-01-07,253,122,131,0,122,0,0,0.0
2022-01-09,6,0,6,0,0,0,0,0.0
2022-01-10,237,131,106,0,131,0,0,0.0
2022-01-11,258,133,125,0,133,0,0,0.0
2022-01-12,248,122,126,0,122,0,0,0.0
2022-01-13,238,137,101,0,137,0,0,0.0
2022-01-14,241,141,100,0,141,0,0,0.0
2022-01-16,18,0,18,0,0,0,0,0.0
2022-01-17,213,106,107,0,106,0,0,0.0
2022-01-18,237,88,149,0,88,0,0,0.0
2022-01-19,254,131,123,0,131,0,0,0.0
2022-01-20,251,131,120,0,131,0,0,0.0
2022-01-21,230,134,96,0,134,0,0,0.0
2022-01-23,16,0,16,0,0,0,0,0.0
2022-01-24,217,103,114,0,103,0,0,0.0
2022-01-25,260,151,109,0,151,0,0,0.0
2022-01-26,244,120,124,2,118,0,0,0.0
2022-01-27,218,114,104,0,114,0,0,0.0
2022-01-28,205,111,94,0,111,0,0,0.0
2022-01-30,17,0,17,0,0,0,0,0.0
2022-01-31,235,123,112,0,123,0,0,0.0
2022-02-01,226,104,122,0,104,0,0,0.0
2022-02-02,254,118,136,0,118,0,0,0.0
2022-02-03,203,102,101,0,102,0,0,0.0
2022-02-04,246,131,115,0,131,0,0,0.0
2022-02-06,3,0,3,0,0,0,0,0.0
2022-02-07,211,155,56,0,155,0,0,0.0
2022-02-08,250,130,120,0,130,0,0,0.0
2022-02-09,208,90,118,0,90,0,0,0.0
2022-02-10,269,122,147,0,122,0,0,0.0
2022-02-11,165,69,96,13,56,0,0,0.0
2022-02-13,18,0,18,0,0,0,0,0.0
2022-02-14,209,136,73,0,136,0,0,0.0
2022-02-15,214,87,127,0,87,0,0,0.0
2022-02-16,215,61,154,0,61,0,0,0.0
2022-02-17,164,47,117,0,47,0,0,0.0
2022-02-18,169,73,96,0,73,0,0,0.0
2022-02-20,17,0,17,0,0,0,0,0.0
2022-02-21,241,118,123,0,118,0,0,0.0
2022-02-22,233,108,125,0,108,0,0,0.0
2022-02-23,213,75,138,0,75,0,0,0.0
2022-02-24,217,103,114,0,103,0,0,0.0
2022-02-25,229,133,96,0,133,0,0,0.0
2022-02-27,0,0,0,0,0,0,0,0.0
2022-02-28,146,127,19,0,127,0,0,0.0
2022-03-01,195,87,108,0,87,0,0,0.0
2022-03-02,241,126,115,0,126,0,0,0.0
2022-03-03,230,102,128,0,102,0,0,0.0
2022-03-04,235,118,117,0,118,0,0,0.0
2022-03-06,2,0,2,0,0,0,0,0.0
2022-03-07,193,137,56,0,137,0,0,0.0
2022-03-08,234,128,106,0,128,0,0,0.0
2022-03-09,193,79,114,0,79,0,0,0.0
2022-03-10,256,139,117,0,139,0,0,0.0
2022-03-11,249,142,107,0,142,0,0,0.0
2022-03-13,31,12,19,0,12,0,0,0.0
2022-03-14,192,92,100,0,92,0,0,0.0
2022-03-15,205,103,102,0,103,0,0,0.0
2022-03-16,210,70,140,0,70,0,0,0.0
2022-03-17,204,141,63,0,141,0,0,0.0
2022-03-18,201,97,104,0,97,0,0,0.0
2022-03-20,24,12,12,0,12,0,0,0.0
2022-03-21,155,109,46,0,109,0,0,0.0
2022-03-22,246,121,125,0,121,0,0,0.0
2022-03-23,210,112,98,0,112,0,0,0.0
2022-03-24,208,113,95,0,113,0,0,0.0
2022-03-25,131,35,96,9,26,0,0,0.0
2022-03-27,17,0,17,0,0,0,0,0.0
2022-03-28,211,101,110,13,88,1,0,-16.165714285714216
2022-03-29,168,63,105,6,57,0,0,0.0
2022-03-30,156,49,107,11,38,0,0,0.0
2022-03-31,169,65,104,3,62,0,0,0.0
2022-04-01,215,119,96,2,117,0,0,0.0
2022-04-03,14,12,2,0,12,0,0,0.0
2022-04-04,170,126,44,0,126,0,0,0.0
2022-04-05,217,114,103,7,107,0,0,0.0
2022-04-06,222,124,98,0,124,0,0,0.0
2022-04-07,145,38,107,0,38,0,0,0.0
2022-04-08,167,82,85,0,82,0,0,0.0
2022-04-10,27,12,15,0,12,0,0,0.0
2022-04-11,216,99,117,0,99,0,0,0.0
2022-04-12,220,116,104,9,107,0,0,0.0
2022-04-13,215,108,107,0,108,0,0,0.0
2022-04-14,243,134,109,0,134,0,0,0.0
2022-04-15,185,85,100,0,85,0,0,0.0
2022-04-17,11,10,1,0,10,0,0,0.0
2022-04-18,174,133,41,0,133,0,0,0.0
2022-04-19,216,114,102,0,114,0,0,0.0
2022-04-20,206,119,87,5,114,0,0,0.0
2022-04-21,195,114,81,0,114,0,0,0.0
2022-04-22,230,139,91,10,129,0,0,0.0
2022-04-24,4,3,1,0,3,0,0,0.0
2022-04-25,186,103,83,3,100,0,0,0.0
2022-04-26,207,114,93,3,111,0,0,0.0
2022-04-27,225,118,107,0,118,0,0,0.0
2022-04-28,215,113,102,26,87,0,0,0.0
2022-04-29,229,133,96,27,106,0,0,0.0
2022-05-01,14,12,2,0,12,0,0,0.0
2022-05-02,212,149,63,0,149,0,0,0.0
2022-05-03,228,131,97,0,131,0,0,0.0
2022-05-04,178,104,74,3,101,0,0,0.0
2022-05-05,193,129,64,0,129,0,0,0.0
2022-05-06,185,89,96,9,80,0,0,0.0
2022-05-08,0,0,0,0,0,0,0,0.0
2022-05-09,227,126,101,5,121,0,0,0.0
2022-05-10,211,139,72,0,139,0,0,0.0
2022-05-11,103,53,50,1,52,1,0,-16.454285714286698
2022-05-12,182,85,97,14,71,0,0,0.0
2022-05-13,224,134,90,0,134,0,0,0.0
2022-05-15,23,11,12,0,11,0,0,0.0
2022-05-16,127,30,97,0,30,0,0,0.0
2022-05-17,253,144,109,0,144,0,0,0.0
2022-05-18,262,144,118,0,144,0,0,0.0
2022-05-19,244,149,95,10,139,0,0,0.0
2022-05-20,165,87,78,0,87,0,0,0.0
2022-05-22,2,2,0,0,2,0,0,0.0
2022-05-23,189,96,93,0,96,0,0,0.0
2022-05-24,220,117,103,8,109,0,0,0.0
2022-05-25,218,107,111,0,107,0,0,0.0
2022-05-26,206,95,111,0,95,0,0,0.0
2022-05-27,211,113,98,0,113,0,0,0.0
2022-05-29,24,8,16,0,8,0,0,0.0
2022-05-30,243,131,112,0,131,0,0,0.0
2022-05-31,188,38,150,0,38,0,0,0.0
2022-06-01,245,135,110,0,135,0,0,0.0
2022-06-02,253,146,107,0,146,0,0,0.0
2022-06-03,204,115,89,0,115,0,0,0.0
2022-06-05,22,12,10,0,12,0,0,0.0
2022-06-06,232,121,111,0,121,0,0,0.0
2022-06-07,223,115,108,0,115,0,0,0.0
2022-06-08,239,116,123,0,116,0,0,0.0
2022-06-09,219,133,86,0,133,0,0,0.0
2022-06-10,213,117,96,1,116,0,0,0.0
2022-06-12,21,12,9,0,12,0,0,0.0
2022-06-13,211,107,104,5,102,0,0,0.0
2022-06-14,232,120,112,0,120,0,0,0.0
2022-06-15,255,138,117,7,131,0,0,0.0
2022-06-16,202,96,106,2,94,1,1,21.707142857143936
2022-06-17,188,92,96,1,91,1,0,-13.711428571429451
2022-06-19,20,12,8,0,12,0,0,0.0
2022-06-20,145,54,91,0,54,0,0,0.0
2022-06-21,206,104,102,0,104,0,0,0.0
2022-06-22,216,107,109,0,107,0,0,0.0
2022-06-23,184,74,110,14,60,0,0,0.0
2022-06-24,216,115,101,0,115,0,0,0.0
2022-06-26,12,1,11,0,1,0,0,0.0
2022-06-27,203,104,99,0,104,0,0,0.0
2022-06-28,171,68,103,0,68,0,0,0.0
2022-06-29,171,72,99,0,72,0,0,0.0
2022-06-30,203,127,76,0,127,0,0,0.0
2022-07-01,170,74,96,0,74,0,0,0.0
2022-07-03,12,0,12,0,0,0,0,0.0
2022-07-04,217,117,100,0,117,0,0,0.0
2022-07-05,178,51,127,0,51,0,0,0.0
2022-07-06,233,121,112,8,113,0,0,0.0
2022-07-07,238,132,106,0,132,0,0,0.0
2022-07-08,223,119,104,0,119,0,0,0.0
2022-07-10,31,12,19,0,12,0,0,0.0
2022-07-11,256,144,112,0,144,0,0,0.0
2022-07-12,226,120,106,0,120,0,0,0.0
2022-07-13,224,108,116,0,108,0,0,0.0
2022-07-14,239,138,101,22,116,0,0,0.0
2022-07-15,188,114,74,0,114,0,0,0.0
2022-07-17,23,10,13,0,10,0,0,0.0
2022-07-18,268,139,129,0,139,0,0,0.0
2022-07-19,231,128,103,0,128,0,0,0.0
2022-07-20,248,120,128,0,120,0,0,0.0
2022-07-21,259,144,115,0,144,0,0,0.0
2022-07-22,221,136,85,7,129,0,0,0.0
2022-07-24,25,12,13,0,12,0,0,0.0
2022-07-25,219,129,90,0,129,0,0,0.0
2022-07-26,234,123,111,0,123,0,0,0.0
2022-07-27,236,129,107,14,115,0,0,0.0
2022-07-28,176,73,103,2,71,0,0,0.0
2022-07-29,208,136,72,4,132,0,0,0.0
2022-07-31,25,12,13,0,12,0,0,0.0
2022-08-01,233,121,112,0,121,0,0,0.0
2022-08-02,219,113,106,2,111,0,0,0.0
2022-08-03,217,142,75,0,142,0,0,0.0
2022-08-04,245,135,110,0,135,0,0,0.0
2022-08-05,219,126,93,4,122,0,0,0.0
2022-08-07,16,6,10,0,6,0,0,0.0
2022-08-08,180,121,59,0,121,0,0,0.0
2022-08-09,175,71,104,0,71,0,0,0.0
2022-08-10,124,21,103,1,20,1,1,38.63571428571743
2022-08-11,219,126,93,12,114,0,0,0.0
2022-08-12,199,103,96,6,97,0,0,0.0
2022-08-14,23,11,12,0,11,0,0,0.0
2022-08-15,245,140,105,0,140,0,0,0.0
2022-08-16,253,143,110,3,140,0,0,0.0
2022-08-17,201,97,104,9,88,0,0,0.0
2022-08-18,227,130,97,2,128,0,0,0.0
2022-08-19,169,52,117,0,52,0,0,0.0
2022-08-21,10,0,10,0,0,0,0,0.0
2022-08-22,252,142,110,0,142,0,0,0.0
2022-08-23,168,47,121,1,46,1,1,20.9785714285739
2022-08-24,166,61,105,5,56,0,0,0.0
2022-08-25,205,92,113,3,89,0,0,0.0
2022-08-26,151,49,102,3,46,1,0,-22.0228571428554
2022-08-28,13,0,13,0,0,0,0,0.0
2022-08-29,255,155,100,4,151,0,0,0.0
2022-08-30,218,110,108,0,110,0,0,0.0
2022-08-31,202,83,119,0,83,0,0,0.0
2022-09-01,221,112,109,9,103,0,0,0.0
2022-09-02,144,48,96,1,47,0,0,0.0
2022-09-04,17,0,17,0,0,0,0,0.0
2022-09-05,178,96,82,0,96,0,0,0.0
2022-09-06,247,107,140,14,93,0,0,0.0
2022-09-07,255,139,116,0,139,0,0,0.0
2022-09-08,127,42,85,15,27,0,0,0.0
2022-09-09,202,104,98,18,86,0,0,0.0
2022-09-11,18,4,14,0,4,0,0,0.0
2022-09-12,197,106,91,9,97,0,0,0.0
2022-09-13,130,44,86,1,43,1,0,-34.85714285714084
2022-09-14,173,73,100,10,63,0,0,0.0
2022-09-15,159,70,89,0,70,0,0,0.0
2022-09-16,206,129,77,0,129,0,0,0.0
2022-09-18,27,11,16,0,11,0,0,0.0
2022-09-19,205,101,104,0,101,0,0,0.0
2022-09-20,129,18,111,0,18,0,0,0.0
2022-09-21,245,115,130,0,115,0,0,0.0
2022-09-22,198,101,97,5,96,1,0,-46.47428571428566
2022-09-23,233,141,92,7,134,0,0,0.0
2022-09-25,20,12,8,0,12,0,0,0.0
2022-09-26,257,148,109,0,148,0,0,0.0
2022-09-27,230,126,104,0,126,0,0,0.0
2022-09-28,237,125,112,0,125,0,0,0.0
2022-09-29,184,86,98,0,86,0,0,0.0
2022-09-30,210,124,86,0,124,0,0,0.0
2022-10-02,25,9,16,0,9,0,0,0.0
2022-10-03,259,135,124,0,135,0,0,0.0
2022-10-04,249,141,108,0,141,0,0,0.0
2022-10-05,170,92,78,0,92,0,0,0.0
2022-10-06,214,149,65,0,149,0,0,0.0
2022-10-07,176,101,75,0,101,0,0,0.0
2022-10-09,15,6,9,0,6,0,0,0.0
2022-10-10,223,108,115,0,108,0,0,0.0
2022-10-11,215,114,101,0,114,0,0,0.0
2022-10-12,240,125,115,0,125,0,0,0.0
2022-10-13,101,43,58,0,43,0,0,0.0
2022-10-14,230,140,90,0,140,0,0,0.0
2022-10-16,18,12,6,0,12,0,0,0.0
2022-10-17,176,101,75,0,101,0,0,0.0
2022-10-18,245,138,107,0,138,0,0,0.0
2022-10-19,207,109,98,0,109,0,0,0.0
2022-10-20,231,47,184,0,47,0,0,0.0
2022-10-21,158,62,96,6,56,1,1,58.714285714287485
2022-10-23,14,0,14,0,0,0,0,0.0
2022-10-24,181,150,31,0,150,0,0,0.0
2022-10-25,154,126,28,6,120,0,0,0.0
2022-10-26,161,119,42,1,118,0,0,0.0
2022-10-27,174,84,90,4,80,0,0,0.0
2022-10-28,148,71,77,0,71,0,0,0.0
2022-10-30,9,6,3,0,6,0,0,0.0
2022-10-31,226,113,113,0,113,0,0,0.0
2022-11-01,249,145,104,7,138,0,0,0.0
2022-11-02,149,34,115,3,31,1,0,-29.68571428571397
2022-11-03,183,81,102,0,81,0,0,0.0
2022-11-04,115,59,56,0,59,0,0,0.0
2022-11-06,0,0,0,0,0,0,0,0.0
2022-11-07,148,81,67,0,81,0,0,0.0
2022-11-08,251,140,111,0,140,0,0,0.0
2022-11-09,190,86,104,0,86,0,0,0.0
2022-11-10,266,152,114,8,144,0,0,0.0
2022-11-11,228,132,96,25,107,0,0,0.0
2022-11-13,0,0,0,0,0,0,0,0.0
2022-11-14,171,137,34,0,137,0,0,0.0
2022-11-15,219,110,109,3,107,0,0,0.0
2022-11-16,185,73,112,0,73,0,0,0.0
2022-11-17,203,105,98,0,105,0,0,0.0
2022-11-18,186,90,96,0,90,0,0,0.0
2022-11-20,15,0,15,0,0,0,0,0.0
2022-11-21,232,137,95,0,137,0,0,0.0
2022-11-22,231,118,113,0,118,0,0,0.0
2022-11-23,249,137,112,0,137,0,0,0.0
2022-11-24,244,135,109,0,135,0,0,0.0
2022-11-25,236,144,92,0,144,0,0,0.0
2022-11-27,10,0,10,0,0,0,0,0.0
2022-11-28,220,118,102,0,118,0,0,0.0
2022-11-29,230,122,108,0,122,0,0,0.0
2022-11-30,238,140,98,0,140,0,0,0.0
2022-12-01,239,124,115,0,124,0,0,0.0
2022-12-02,253,150,103,0,150,0,0,0.0
2022-12-04,2,0,2,0,0,0,0,0.0
2022-12-05,219,157,62,0,157,0,0,0.0
2022-12-06,251,145,106,0,145,0,0,0.0
2022-12-07,214,109,105,0,109,0,0,0.0
2022-12-08,180,74,106,0,74,0,0,0.0
2022-12-09,244,148,96,0,148,0,0,0.0
2022-12-11,17,0,17,0,0,0,0,0.0
2022-12-12,201,104,97,0,104,0,0,0.0
2022-12-13,217,124,93,6,118,0,0,0.0
2022-12-14,228,120,108,0,120,0,0,0.0
2022-12-15,265,151,114,0,151,0,0,0.0
2022-12-16,218,121,97,0,121,0,0,0.0
2022-12-18,12,0,12,0,0,0,0,0.0
2022-12-19,174,142,32,0,142,0,0,0.0
2022-12-20,230,121,109,1,120,0,0,0.0
2022-12-21,237,141,96,0,141,0,0,0.0
2022-12-22,236,126,110,0,126,0,0,0.0
2022-12-23,202,106,96,0,106,0,0,0.0
2022-12-25,11,0,11,0,0,0,0,0.0
2022-12-26,263,150,113,0,150,0,0,0.0
2022-12-27,208,75,133,0,75,0,0,0.0
2022-12-28,248,133,115,0,133,0,0,0.0
2022-12-29,229,120,109,0,120,0,0,0.0
2022-12-30,192,96,96,0,96,0,0,0.0
2023-01-01,8,0,8,0,0,0,0,0.0
2023-01-02,155,116,39,0,116,0,0,0.0
2023-01-03,180,56,124,0,56,0,0,0.0
2023-01-04,262,151,111,0,151,0,0,0.0
2023-01-05,154,51,103,0,51,0,0,0.0
2023-01-06,226,129,97,0,129,0,0,0.0
2023-01-08,17,0,17,0,0,0,0,0.0
2023-01-09,219,119,100,0,119,0,0,0.0
2023-01-10,179,107,72,0,107,0,0,0.0
2023-01-11,213,110,103,0,110,0,0,0.0
2023-01-12,254,147,107,3,144,0,0,0.0
2023-01-13,208,126,82,0,126,0,0,0.0
2023-01-15,15,0,15,0,0,0,0,0.0
2023-01-16,161,47,114,0,47,0,0,0.0
2023-01-17,247,132,115,0,132,0,0,0.0
2023-01-18,192,91,101,0,91,0,0,0.0
2023-01-19,180,81,99,0,81,0,0,0.0
2023-01-20,252,155,97,0,155,0,0,0.0
2023-01-22,16,0,16,0,0,0,0,0.0
2023-01-23,256,148,108,0,148,0,0,0.0
2023-01-24,262,153,109,0,153,0,0,0.0
2023-01-25,253,142,111,0,142,0,0,0.0
2023-01-26,252,139,113,0,139,0,0,0.0
2023-01-27,142,46,96,0,46,0,0,0.0
2023-01-29,6,0,6,0,0,0,0,0.0
2023-01-30,249,134,115,0,134,0,0,0.0
2023-01-31,257,141,116,0,141,0,0,0.0
2023-02-01,258,145,113,0,145,0,0,0.0
2023-02-02,230,120,110,0,120,0,0,0.0
2023-02-03,233,144,89,0,144,0,0,0.0
2023-02-05,4,0,4,0,0,0,0,0.0
2023-02-06,158,141,17,0,141,0,0,0.0
2023-02-07,218,125,93,0,125,0,0,0.0
2023-02-08,198,107,91,0,107,0,0,0.0
2023-02-09,233,134,99,0,134,0,0,0.0
2023-02-10,233,139,94,16,123,0,0,0.0
2023-02-12,13,0,13,0,0,0,0,0.0
2023-02-13,204,99,105,0,99,0,0,0.0
2023-02-14,242,136,106,0,136,0,0,0.0
2023-02-15,239,132,107,0,132,0,0,0.0
2023-02-16,219,114,105,0,114,0,0,0.0
2023-02-17,226,130,96,0,130,0,0,0.0
2023-02-19,15,0,15,0,0,0,0,0.0
2023-02-20,186,86,100,0,86,0,0,0.0
2023-02-21,191,67,124,0,67,0,0,0.0
2023-02-22,250,148,102,0,148,0,0,0.0
2023-02-23,232,129,103,0,129,0,0,0.0
2023-02-24,227,146,81,0,146,0,0,0.0
2023-02-26,12,0,12,0,0,0,0,0.0
2023-02-27,238,140,98,0,140,0,0,0.0
2023-02-28,206,107,99,0,107,0,0,0.0
2023-03-01,267,155,112,0,155,0,0,0.0
2023-03-02,188,90,98,0,90,0,0,0.0
2023-03-03,181,118,63,0,118,0,0,0.0
2023-03-05,16,0,16,0,0,0,0,0.0
2023-03-06,208,97,111,0,97,0,0,0.0
2023-03-07,248,138,110,0,138,0,0,0.0
2023-03-08,180,73,107,0,73,0,0,0.0
2023-03-09,240,129,111,0,129,0,0,0.0
2023-03-10,253,156,97,0,156,0,0,0.0
2023-03-12,16,12,4,0,12,0,0,0.0
2023-03-13,174,147,27,31,116,0,0,0.0
2023-03-14,184,76,108,0,76,0,0,0.0
2023-03-15,249,145,104,0,145,0,0,0.0
2023-03-16,206,98,108,0,98,0,0,0.0
2023-03-17,192,96,96,0,96,0,0,0.0
2023-03-19,30,12,18,0,12,0,0,0.0
2023-03-20,159,78,81,0,78,0,0,0.0
2023-03-21,232,136,96,0,136,0,0,0.0
2023-03-22,216,122,94,0,122,0,0,0.0
2023-03-23,243,135,108,0,135,0,0,0.0
2023-03-24,211,116,95,0,116,0,0,0.0
2023-03-26,15,12,3,0,12,0,0,0.0
2023-03-27,185,125,60,0,125,0,0,0.0
2023-03-28,216,102,114,0,102,0,0,0.0
2023-03-29,259,145,114,0,145,0,0,0.0
2023-03-30,253,140,113,0,140,0,0,0.0
2023-03-31,206,110,96,0,110,0,0,0.0
2023-04-02,13,12,1,0,12,0,0,0.0
2023-04-03,247,147,100,0,147,0,0,0.0
2023-04-04,258,153,105,0,153,0,0,0.0
2023-04-05,205,107,98,0,107,0,0,0.0
2023-04-06,183,88,95,0,88,0,0,0.0
2023-04-07,129,59,70,0,59,0,0,0.0
2023-04-09,5,0,5,0,0,0,0,0.0
2023-04-10,242,142,100,0,142,0,0,0.0
2023-04-11,239,123,116,0,123,0,0,0.0
2023-04-12,242,136,106,0,136,0,0,0.0
2023-04-13,166,115,51,0,115,0,0,0.0
2023-04-14,236,136,100,0,136,0,0,0.0
2023-04-16,27,10,17,0,10,0,0,0.0
2023-04-17,206,123,83,0,123,0,0,0.0
2023-04-18,228,140,88,0,140,0,0,0.0
2023-04-19,230,128,102,0,128,0,0,0.0
2023-04-20,170,91,79,0,91,0,0,0.0
2023-04-21,236,136,100,0,136,0,0,0.0
2023-04-23,29,12,17,0,12,0,0,0.0
2023-04-24,232,141,91,0,141,0,0,0.0
2023-04-25,199,111,88,0,111,0,0,0.0
2023-04-26,204,96,108,0,96,0,0,0.0
2023-04-27,134,56,78,0,56,0,0,0.0
2023-04-28,219,131,88,0,131,0,0,0.0
2023-04-30,23,12,11,0,12,0,0,0.0
2023-05-01,243,136,107,0,136,0,0,0.0
2023-05-02,243,139,104,0,139,0,0,0.0
2023-05-03,206,110,96,0,110,0,0,0.0
2023-05-04,181,141,40,0,141,0,0,0.0
2023-05-05,162,66,96,0,66,0,0,0.0
2023-05-07,18,0,18,0,0,0,0,0.0
2023-05-08,221,132,89,0,132,0,0,0.0
2023-05-09,178,82,96,0,82,0,0,0.0
2023-05-10,172,71,101,0,71,0,0,0.0
2023-05-11,245,144,101,0,144,0,0,0.0
2023-05-12,190,111,79,0,111,0,0,0.0
2023-05-14,18,12,6,0,12,0,0,0.0
2023-05-15,166,51,115,0,51,0,0,0.0
2023-05-16,250,136,114,0,136,0,0,0.0
2023-05-17,225,128,97,0,128,0,0,0.0
2023-05-18,200,116,84,0,116,0,0,0.0
2023-05-19,223,119,104,0,119,0,0,0.0
2023-05-21,31,12,19,0,12,0,0,0.0
2023-05-22,195,124,71,0,124,0,0,0.0
2023-05-23,140,28,112,0,28,0,0,0.0
2023-05-24,248,130,118,0,130,0,0,0.0
2023-05-25,234,133,101,0,133,0,0,0.0
2023-05-26,217,127,90,0,127,0,0,0.0
2023-05-28,14,12,2,0,12,0,0,0.0
2023-05-29,261,155,106,0,155,0,0,0.0
2023-05-30,163,46,117,0,46,0,0,0.0
2023-05-31,217,129,88,0,129,0,0,0.0
2023-06-01,234,144,90,0,144,0,0,0.0
2023-06-02,228,144,84,0,144,0,0,0.0
2023-06-04,24,12,12,0,12,0,0,0.0
2023-06-05,198,105,93,0,105,0,0,0.0
2023-06-06,158,84,74,0,84,0,0,0.0
2023-06-07,264,141,123,0,141,0,0,0.0
2023-06-08,247,138,109,0,138,0,0,0.0
2023-06-09,186,78,108,0,78,0,0,0.0
2023-06-11,13,4,9,0,4,0,0,0.0
2023-06-12,241,155,86,0,155,0,0,0.0
2023-06-13,225,109,116,0,109,0,0,0.0
2023-06-14,236,124,112,0,124,0,0,0.0
2023-06-15,246,133,113,0,133,0,0,0.0
2023-06-16,234,133,101,0,133,0,0,0.0
2023-06-18,20,12,8,0,12,0,0,0.0
2023-06-19,208,143,65,0,143,0,0,0.0
2023-06-20,258,108,150,0,108,0,0,0.0
2023-06-21,246,132,114,0,132,0,0,0.0
2023-06-22,224,140,84,0,140,0,0,0.0
2023-06-23,233,143,90,0,143,0,0,0.0
2023-06-25,24,11,13,0,11,0,0,0.0
2023-06-26,233,126,107,0,126,0,0,0.0
2023-06-27,233,130,103,0,130,0,0,0.0
2023-06-28,181,85,96,0,85,0,0,0.0
2023-06-29,130,48,82,0,48,0,0,0.0
2023-06-30,219,122,97,0,122,0,0,0.0
2023-07-02,24,12,12,0,12,0,0,0.0
2023-07-03,226,124,102,0,124,0,0,0.0
2023-07-04,233,112,121,0,112,0,0,0.0
2023-07-05,237,95,142,0,95,0,0,0.0
2023-07-06,198,74,124,0,74,0,0,0.0
2023-07-07,227,135,92,0,135,0,0,0.0
2023-07-09,10,10,0,0,10,0,0,0.0
2023-07-10,240,140,100,0,140,0,0,0.0
2023-07-11,216,97,119,0,97,0,0,0.0
2023-07-12,238,125,113,0,125,0,0,0.0
2023-07-13,240,137,103,0,137,0,0,0.0
2023-07-14,207,112,95,0,112,0,0,0.0
2023-07-16,14,11,3,0,11,0,0,0.0
2023-07-17,242,137,105,0,137,0,0,0.0
2023-07-18,244,136,108,0,136,0,0,0.0
2023-07-19,221,104,117,0,104,0,0,0.0
2023-07-20,258,148,110,0,148,0,0,0.0
2023-07-21,190,96,94,0,96,0,0,0.0
2023-07-23,23,12,11,0,12,0,0,0.0
2023-07-24,266,151,115,0,151,0,0,0.0
2023-07-25,195,111,84,0,111,0,0,0.0
2023-07-26,248,139,109,0,139,0,0,0.0
2023-07-27,238,139,99,0,139,0,0,0.0
2023-07-28,171,122,49,0,122,0,0,0.0
2023-07-30,28,12,16,0,12,0,0,0.0
2023-07-31,199,96,103,0,96,0,0,0.0
2023-08-01,224,125,99,0,125,0,0,0.0
2023-08-02,219,130,89,0,130,0,0,0.0
2023-08-03,199,95,104,0,95,0,0,0.0
2023-08-04,214,119,95,0,119,0,0,0.0
2023-08-06,26,12,14,0,12,0,0,0.0
2023-08-07,228,123,105,0,123,0,0,0.0
2023-08-08,217,100,117,0,100,0,0,0.0
2023-08-09,247,140,107,0,140,0,0,0.0
2023-08-10,230,116,114,0,116,0,0,0.0
2023-08-11,154,83,71,0,83,0,0,0.0
2023-08-13,20,2,18,0,2,0,0,0.0
2023-08-14,185,107,78,0,107,0,0,0.0
2023-08-15,168,62,106,0,62,0,0,0.0
2023-08-16,226,116,110,0,116,0,0,0.0
2023-08-17,246,119,127,0,119,0,0,0.0
2023-08-18,223,125,98,0,125,0,0,0.0
2023-08-20,19,12,7,0,12,0,0,0.0
2023-08-21,176,117,59,0,117,0,0,0.0
2023-08-22,246,141,105,0,141,0,0,0.0
2023-08-23,256,143,113,0,143,0,0,0.0
2023-08-24,193,74,119,0,74,0,0,0.0
2023-08-25,221,125,96,0,125,0,0,0.0
2023-08-27,28,12,16,0,12,0,0,0.0
2023-08-28,159,56,103,0,56,0,0,0.0
2023-08-29,243,139,104,0,139,0,0,0.0
2023-08-30,234,119,115,0,119,0,0,0.0
2023-08-31,220,116,104,0,116,0,0,0.0
2023-09-01,185,107,78,0,107,0,0,0.0
2023-09-03,26,12,14,0,12,0,0,0.0
2023-09-04,183,93,90,0,93,0,0,0.0
2023-09-05,264,82,182,0,82,0,0,0.0
2023-09-06,249,137,112,0,137,0,0,0.0
2023-09-07,157,56,101,0,56,0,0,0.0
2023-09-08,214,116,98,0,116,0,0,0.0
2023-09-10,12,12,0,0,12,0,0,0.0
2023-09-11,168,68,100,0,68,0,0,0.0
2023-09-12,189,82,107,0,82,0,0,0.0
2023-09-13,175,69,106,0,69,0,0,0.0
2023-09-14,197,94,103,0,94,0,0,0.0
2023-09-15,127,43,84,0,43,0,0,0.0
2023-09-17,30,12,18,0,12,0,0,0.0
2023-09-18,236,84,152,0,84,0,0,0.0
2023-09-19,240,67,173,0,67,0,0,0.0
2023-09-20,261,125,136,0,125,0,0,0.0
2023-09-21,241,138,103,0,138,0,0,0.0
2023-09-22,207,98,109,0,98,0,0,0.0
2023-09-24,20,7,13,0,7,0,0,0.0
2023-09-25,202,105,97,0,105,0,0,0.0
2023-09-26,195,85,110,0,85,0,0,0.0
2023-09-27,211,135,76,0,135,0,0,0.0
2023-09-28,191,87,104,0,87,0,0,0.0
2023-09-29,233,125,108,0,125,0,0,0.0
2023-10-01,29,12,17,0,12,0,0,0.0
2023-10-02,240,121,119,0,121,0,0,0.0
2023-10-03,256,78,178,0,78,0,0,0.0
2023-10-04,228,127,101,0,127,0,0,0.0
2023-10-05,246,133,113,0,133,0,0,0.0
2023-10-06,166,58,108,0,58,0,0,0.0
2023-10-08,17,12,5,0,12,0,0,0.0
2023-10-09,152,100,52,0,100,0,0,0.0
2023-10-10,243,139,104,0,139,0,0,0.0
2023-10-11,218,117,101,0,117,0,0,0.0
2023-10-12,219,120,99,0,120,0,0,0.0
2023-10-13,167,32,135,0,32,0,0,0.0
2023-10-15,25,11,14,0,11,0,0,0.0
2023-10-16,155,103,52,0,103,0,0,0.0
2023-10-17,136,37,99,0,37,0,0,0.0
2023-10-18,256,86,170,0,86,0,0,0.0
2023-10-19,174,56,118,0,56,0,0,0.0
2023-10-20,182,28,154,0,28,0,0,0.0
2023-10-22,14,0,14,0,0,0,0,0.0
2023-10-23,232,51,181,0,51,0,0,0.0
2023-10-24,221,108,113,0,108,0,0,0.0
2023-10-25,206,41,165,0,41,0,0,0.0
2023-10-26,229,115,114,0,115,0,0,0.0
2023-10-27,221,105,116,0,105,0,0,0.0
2023-10-29,29,12,17,0,12,0,0,0.0
2023-10-30,214,136,78,0,136,0,0,0.0
2023-10-31,261,141,120,0,141,0,0,0.0
2023-11-01,261,145,116,0,145,0,0,0.0
2023-11-02,252,146,106,0,146,0,0,0.0
2023-11-03,157,58,99,0,58,0,0,0.0
2023-11-05,13,0,13,0,0,0,0,0.0
2023-11-06,181,72,109,0,72,0,0,0.0
2023-11-07,185,72,113,0,72,0,0,0.0
2023-11-08,232,116,116,0,116,0,0,0.0
2023-11-09,175,87,88,0,87,0,0,0.0
2023-11-10,229,115,114,0,115,0,0,0.0
2023-11-12,18,0,18,0,0,0,0,0.0
2023-11-13,216,68,148,0,68,0,0,0.0
2023-11-14,210,58,152,0,58,0,0,0.0
2023-11-15,257,158,99,0,158,0,0,0.0
2023-11-16,210,145,65,0,145,0,0,0.0
2023-11-17,186,149,37,0,149,0,0,0.0
2023-11-19,17,0,17,0,0,0,0,0.0
2023-11-20,187,86,101,0,86,0,0,0.0
2023-11-21,251,142,109,0,142,0,0,0.0
2023-11-22,234,139,95,0,139,0,0,0.0
2023-11-23,210,91,119,0,91,0,0,0.0
2023-11-24,177,94,83,0,94,0,0,0.0
2023-11-26,12,0,12,0,0,0,0,0.0
2023-11-27,209,88,121,0,88,0,0,0.0
2023-11-28,230,122,108,0,122,0,0,0.0
2023-11-29,253,137,116,0,137,0,0,0.0
2023-11-30,239,152,87,0,152,0,0,0.0
2023-12-01,223,127,96,0,127,0,0,0.0
2023-12-03,13,0,13,0,0,0,0,0.0
2023-12-04,249,150,99,0,150,0,0,0.0
2023-12-05,233,151,82,0,151,0,0,0.0
2023-12-06,192,96,96,0,96,0,0,0.0
2023-12-07,269,139,130,0,139,0,0,0.0
2023-12-08,244,138,106,0,138,0,0,0.0
2023-12-10,6,0,6,0,0,0,0,0.0
2023-12-11,186,77,109,0,77,0,0,0.0
2023-12-12,253,133,120,0,133,0,0,0.0
2023-12-13,237,118,119,0,118,0,0,0.0
2023-12-14,188,78,110,0,78,0,0,0.0
2023-12-15,239,146,93,0,146,0,0,0.0
2023-12-17,18,0,18,0,0,0,0,0.0
2023-12-18,249,140,109,0,140,0,0,0.0
2023-12-19,266,151,115,0,151,0,0,0.0
2023-12-20,241,135,106,0,135,0,0,0.0
2023-12-21,247,153,94,0,153,0,0,0.0
2023-12-22,244,149,95,0,149,0,0,0.0
2023-12-24,0,0,0,0,0,0,0,0.0
2023-12-25,91,0,91,0,0,0,0,0.0
2023-12-26,209,126,83,0,126,0,0,0.0
2023-12-27,198,93,105,0,93,0,0,0.0
2023-12-28,231,125,106,0,125,0,0,0.0
2023-12-29,231,149,82,0,149,0,0,0.0
2024-01-01,12,0,12,0,0,0,0,0.0
2024-01-02,236,126,110,0,126,0,0,0.0
2024-01-03,234,149,85,0,149,0,0,0.0
2024-01-04,265,154,111,0,154,0,0,0.0
2024-01-05,248,152,96,0,152,0,0,0.0
2024-01-07,12,0,12,0,0,0,0,0.0
2024-01-08,194,130,64,0,130,0,0,0.0
2024-01-09,247,135,112,0,135,0,0,0.0
2024-01-10,235,133,102,0,133,0,0,0.0
2024-01-11,236,103,133,0,103,0,0,0.0
2024-01-12,231,135,96,0,135,0,0,0.0
2024-01-14,16,0,16,0,0,0,0,0.0
2024-01-15,262,151,111,0,151,0,0,0.0
2024-01-16,266,119,147,0,119,0,0,0.0
2024-01-17,230,132,98,0,132,0,0,0.0
2024-01-18,232,137,95,0,137,0,0,0.0
2024-01-19,221,126,95,0,126,0,0,0.0
2024-01-21,1,0,1,0,0,0,0,0.0
2024-01-22,200,131,69,0,131,0,0,0.0
2024-01-23,235,145,90,0,145,0,0,0.0
2024-01-24,238,130,108,0,130,0,0,0.0
2024-01-25,232,124,108,0,124,0,0,0.0
2024-01-26,212,141,71,0,141,0,0,0.0
2024-01-28,15,0,15,0,0,0,0,0.0
2024-01-29,222,109,113,0,109,0,0,0.0
2024-01-30,204,101,103,0,101,0,0,0.0
2024-01-31,262,152,110,0,152,0,0,0.0
2024-02-01,232,133,99,0,133,0,0,0.0
2024-02-02,179,146,33,0,146,0,0,0.0
2024-02-04,12,0,12,0,0,0,0,0.0
2024-02-05,162,101,61,0,101,0,0,0.0
2024-02-06,250,140,110,0,140,0,0,0.0
2024-02-07,189,84,105,0,84,0,0,0.0
2024-02-08,229,115,114,0,115,0,0,0.0
2024-02-09,210,114,96,0,114,0,0,0.0
2024-02-11,12,0,12,0,0,0,0,0.0
2024-02-12,212,92,120,0,92,0,0,0.0
2024-02-13,245,113,132,0,113,0,0,0.0
2024-02-14,222,107,115,0,107,0,0,0.0
2024-02-15,191,81,110,0,81,0,0,0.0
2024-02-16,211,103,108,0,103,0,0,0.0
2024-02-18,3,0,3,0,0,0,0,0.0
2024-02-19,209,90,119,0,90,0,0,0.0
2024-02-20,258,96,162,0,96,0,0,0.0
2024-02-21,238,147,91,0,147,0,0,0.0
2024-02-22,248,140,108,0,140,0,0,0.0
2024-02-23,179,78,101,0,78,0,0,0.0
2024-02-25,11,0,11,0,0,0,0,0.0
2024-02-26,177,118,59,0,118,0,0,0.0
2024-02-27,243,109,134,0,109,0,0,0.0
2024-02-28,188,55,133,0,55,0,0,0.0
2024-02-29,261,148,113,0,148,0,0,0.0
2024-03-01,234,122,112,0,122,0,0,0.0
2024-03-03,15,0,15,0,0,0,0,0.0
2024-03-04,156,43,113,0,43,0,0,0.0
2024-03-05,180,92,88,0,92,0,0,0.0
2024-03-06,249,147,102,0,147,0,0,0.0
2024-03-07,240,126,114,0,126,0,0,0.0
2024-03-08,164,74,90,0,74,0,0,0.0
2024-03-10,17,5,12,0,5,0,0,0.0
2024-03-11,197,123,74,0,123,0,0,0.0
2024-03-12,132,28,104,0,28,0,0,0.0
2024-03-13,249,139,110,0,139,0,0,0.0
2024-03-14,243,129,114,0,129,0,0,0.0
2024-03-15,201,97,104,0,97,0,0,0.0
2024-03-17,13,12,1,0,12,0,0,0.0
2024-03-18,208,105,103,0,105,0,0,0.0
2024-03-19,250,110,140,0,110,0,0,0.0
2024-03-20,260,109,151,0,109,0,0,0.0
2024-03-21,241,133,108,0,133,0,0,0.0
2024-03-22,223,105,118,0,105,0,0,0.0
2024-03-24,25,11,14,0,11,0,0,0.0
2024-03-25,229,128,101,0,128,0,0,0.0
2024-03-26,221,99,122,0,99,0,0,0.0
2024-03-27,227,107,120,0,107,0,0,0.0
2024-03-28,151,87,64,0,87,0,0,0.0
2024-03-29,177,39,138,0,39,0,0,0.0
2024-03-31,22,5,17,0,5,0,0,0.0
2024-04-01,244,118,126,0,118,0,0,0.0
2024-04-02,196,62,134,0,62,0,0,0.0
2024-04-03,233,68,165,0,68,0,0,0.0
2024-04-04,188,33,155,0,33,0,0,0.0
2024-04-05,159,88,71,0,88,0,0,0.0
2024-04-07,12,12,0,0,12,0,0,0.0
2024-04-08,198,64,134,0,64,0,0,0.0
2024-04-09,234,41,193,0,41,0,0,0.0
2024-04-10,207,37,170,0,37,0,0,0.0
2024-04-11,220,129,91,0,129,0,0,0.0
2024-04-12,204,109,95,0,109,0,0,0.0
2024-04-14,23,12,11,0,12,0,0,0.0
2024-04-15,124,26,98,0,26,0,0,0.0
2024-04-16,205,92,113,0,92,0,0,0.0
2024-04-17,203,87,116,0,87,0,0,0.0
2024-04-18,243,150,93,0,150,0,0,0.0
2024-04-19,164,48,116,0,48,0,0,0.0
2024-04-21,7,7,0,0,7,0,0,0.0
2024-04-22,205,67,138,0,67,0,0,0.0
2024-04-23,206,25,181,0,25,0,0,0.0
2024-04-24,231,53,178,0,53,0,0,0.0
2024-04-25,144,42,102,0,42,0,0,0.0
2024-04-26,204,99,105,0,99,0,0,0.0
2024-04-28,12,12,0,0,12,0,0,0.0
2024-04-29,211,122,89,0,122,0,0,0.0
2024-04-30,205,109,96,0,109,0,0,0.0
2024-05-01,206,86,120,0,86,0,0,0.0
2024-05-02,260,152,108,0,152,0,0,0.0
2024-05-03,235,139,96,3,136,0,0,0.0
2024-05-05,30,12,18,0,12,0,0,0.0
2024-05-06,257,143,114,0,143,0,0,0.0
2024-05-07,259,131,128,0,131,0,0,0.0
2024-05-08,207,94,113,0,94,0,0,0.0
2024-05-09,231,96,135,0,96,0,0,0.0
2024-05-10,172,73,99,0,73,0,0,0.0
2024-05-12,19,1,18,0,1,0,0,0.0
2024-05-13,220,102,118,0,102,0,0,0.0
2024-05-14,133,13,120,0,13,0,0,0.0
2024-05-15,245,100,145,0,100,0,0,0.0
2024-05-16,177,66,111,0,66,0,0,0.0
2024-05-17,204,101,103,0,101,0,0,0.0
2024-05-19,31,12,19,0,12,0,0,0.0
2024-05-20,220,111,109,0,111,0,0,0.0
2024-05-21,187,53,134,0,53,0,0,0.0
2024-05-22,191,64,127,0,64,0,0,0.0
2024-05-23,207,140,67,0,140,0,0,0.0
2024-05-24,229,104,125,0,104,0,0,0.0
2024-05-26,14,8,6,0,8,0,0,0.0
2024-05-27,199,103,96,0,103,0,0,0.0
2024-05-28,247,86,161,0,86,0,0,0.0
2024-05-29,233,105,128,0,105,0,0,0.0
2024-05-30,226,89,137,0,89,0,0,0.0
2024-05-31,196,106,90,0,106,0,0,0.0
2024-06-02,17,12,5,0,12,0,0,0.0
2024-06-03,221,143,78,0,143,0,0,0.0
2024-06-04,250,138,112,0,138,0,0,0.0
2024-06-05,189,74,115,0,74,0,0,0.0
2024-06-06,255,130,125,0,130,0,0,0.0
2024-06-07,165,70,95,0,70,0,0,0.0
2024-06-09,3,2,1,0,2,0,0,0.0
2024-06-10,190,93,97,0,93,0,0,0.0
2024-06-11,255,107,148,0,107,0,0,0.0
2024-06-12,240,105,135,0,105,0,0,0.0
2024-06-13,208,96,112,0,96,0,0,0.0
2024-06-14,167,65,102,0,65,0,0,0.0
2024-06-16,21,5,16,0,5,0,0,0.0
2024-06-17,154,125,29,0,125,0,0,0.0
2024-06-18,130,28,102,0,28,0,0,0.0
2024-06-19,210,99,111,0,99,0,0,0.0
2024-06-20,229,92,137,0,92,0,0,0.0
2024-06-21,221,100,121,0,100,0,0,0.0
2024-06-23,25,12,13,0,12,0,0,0.0
2024-06-24,203,147,56,0,147,0,0,0.0
2024-06-25,193,76,117,0,76,0,0,0.0
2024-06-26,257,102,155,0,102,0,0,0.0
2024-06-27,256,142,114,0,142,0,0,0.0
2024-06-28,231,98,133,0,98,0,0,0.0
2024-06-30,19,12,7,0,12,0,0,0.0
2024-07-01,210,136,74,0,136,0,0,0.0
2024-07-02,227,105,122,0,105,0,0,0.0
2024-07-03,216,71,145,0,71,0,0,0.0
2024-07-04,227,111,116,0,111,0,0,0.0
2024-07-05,195,86,109,0,86,0,0,0.0
2024-07-07,17,10,7,0,10,0,0,0.0
2024-07-08,233,116,117,0,116,0,0,0.0
2024-07-09,265,128,137,0,128,0,0,0.0
2024-07-10,229,96,133,0,96,0,0,0.0
2024-07-11,149,18,131,2,16,1,0,19.800000000000296
2024-07-12,76,31,45,0,31,0,0,0.0
2024-07-14,16,0,16,0,0,0,0,0.0
2024-07-15,190,133,57,0,133,0,0,0.0
2024-07-16,243,146,97,0,146,0,0,0.0
2024-07-17,224,124,100,0,124,0,0,0.0
2024-07-18,238,148,90,0,148,0,0,0.0
2024-07-19,197,94,103,0,94,0,0,0.0
2024-07-21,28,12,16,0,12,0,0,0.0
2024-07-22,217,124,93,0,124,0,0,0.0
2024-07-23,216,99,117,0,99,0,0,0.0
2024-07-24,221,106,115,0,106,0,0,0.0
2024-07-25,166,55,111,0,55,0,0,0.0
2024-07-26,154,58,96,0,58,0,0,0.0
2024-07-28,20,4,16,0,4,0,0,0.0
2024-07-29,161,52,109,0,52,0,0,0.0
2024-07-30,211,105,106,0,105,0,0,0.0
2024-07-31,212,105,107,0,105,0,0,0.0
2024-08-01,241,139,102,0,139,0,0,0.0
2024-08-02,196,124,72,5,119,0,0,0.0
2024-08-04,21,12,9,0,12,0,0,0.0
2024-08-05,262,149,113,17,132,0,0,0.0
2024-08-06,178,80,98,0,80,0,0,0.0
2024-08-07,253,147,106,0,147,0,0,0.0
2024-08-08,156,68,88,0,68,0,0,0.0
2024-08-09,128,39,89,0,39,0,0,0.0
2024-08-11,20,7,13,0,7,0,0,0.0
2024-08-12,187,121,66,0,121,0,0,0.0
2024-08-13,210,99,111,0,99,0,0,0.0
2024-08-14,215,99,116,0,99,0,0,0.0
2024-08-15,132,44,88,0,44,0,0,0.0
2024-08-16,193,109,84,0,109,0,0,0.0
2024-08-18,24,12,12,0,12,0,0,0.0
2024-08-19,180,80,100,0,80,0,0,0.0
2024-08-20,224,115,109,0,115,0,0,0.0
2024-08-21,233,129,104,0,129,0,0,0.0
2024-08-22,251,148,103,0,148,0,0,0.0
2024-08-23,240,145,95,0,145,0,0,0.0
2024-08-25,28,12,16,0,12,0,0,0.0
2024-08-26,250,147,103,0,147,0,0,0.0
2024-08-27,244,146,98,0,146,0,0,0.0
2024-08-28,243,138,105,0,138,0,0,0.0
2024-08-29,215,121,94,0,121,0,0,0.0
2024-08-30,212,135,77,0,135,0,0,0.0
2024-09-01,30,11,19,0,11,0,0,0.0
2024-09-02,177,115,62,0,115,0,0,0.0
2024-09-03,171,40,131,0,40,0,0,0.0
2024-09-04,215,126,89,0,126,0,0,0.0
2024-09-05,245,144,101,0,144,0,0,0.0
2024-09-06,231,135,96,0,135,0,0,0.0
2024-09-08,22,12,10,0,12,0,0,0.0
2024-09-09,220,112,108,0,112,0,0,0.0
2024-09-10,250,150,100,0,150,0,0,0.0
2024-09-11,184,70,114,0,70,0,0,0.0
2024-09-12,216,108,108,0,108,0,0,0.0
2024-09-13,168,72,96,0,72,0,0,0.0
2024-09-15,21,10,11,0,10,0,0,0.0
2024-09-16,218,134,84,0,134,0,0,0.0
2024-09-17,242,134,108,0,134,0,0,0.0
2024-09-18,234,119,115,0,119,0,0,0.0
2024-09-19,250,137,113,0,137,0,0,0.0
2024-09-20,215,119,96,0,119,0,0,0.0
2024-09-22,12,2,10,0,2,0,0,0.0
2024-09-23,223,120,103,0,120,0,0,0.0
2024-09-24,248,146,102,0,146,0,0,0.0
2024-09-25,243,140,103,0,140,0,0,0.0
2024-09-26,243,136,107,0,136,0,0,0.0
2024-09-27,172,76,96,0,76,0,0,0.0
2024-09-29,28,9,19,0,9,0,0,0.0
2024-09-30,224,147,77,0,147,0,0,0.0
2024-10-01,256,147,109,0,147,0,0,0.0
2024-10-02,259,157,102,0,157,0,0,0.0
2024-10-03,225,130,95,0,130,0,0,0.0
2024-10-04,206,110,96,1,109,0,0,0.0
2024-10-06,1,1,0,0,1,0,0,0.0
2024-10-07,165,50,115,0,50,0,0,0.0
2024-10-08,259,154,105,0,154,0,0,0.0
2024-10-09,232,142,90,0,142,0,0,0.0
2024-10-10,157,81,76,0,81,0,0,0.0
2024-10-11,172,80,92,0,80,0,0,0.0
2024-10-13,26,9,17,0,9,0,0,0.0
2024-10-14,163,88,75,0,88,0,0,0.0
2024-10-15,211,92,119,0,92,0,0,0.0
2024-10-16,233,121,112,0,121,0,0,0.0
2024-10-17,255,144,111,0,144,0,0,0.0
2024-10-18,231,129,102,0,129,0,0,0.0
2024-10-20,18,12,6,0,12,0,0,0.0
2024-10-21,258,153,105,0,153,0,0,0.0
2024-10-22,215,107,108,0,107,0,0,0.0
2024-10-23,226,119,107,0,119,0,0,0.0
2024-10-24,256,148,108,0,148,0,0,0.0
2024-10-25,184,93,91,0,93,0,0,0.0
2024-10-27,12,12,0,0,12,0,0,0.0
2024-10-28,251,151,100,0,151,0,0,0.0
2024-10-29,271,147,124,0,147,0,0,0.0
2024-10-30,155,83,72,0,83,0,0,0.0
2024-10-31,263,152,111,0,152,0,0,0.0
2024-11-01,220,126,94,0,126,0,0,0.0
2024-11-03,4,0,4,0,0,0,0,0.0
2024-11-04,236,127,109,0,127,0,0,0.0
2024-11-05,256,141,115,0,141,0,0,0.0
2024-11-06,215,107,108,0,107,0,0,0.0
2024-11-07,222,117,105,0,117,0,0,0.0
2024-11-08,181,99,82,0,99,0,0,0.0
2024-11-10,18,0,18,0,0,0,0,0.0
2024-11-11,161,47,114,0,47,0,0,0.0
2024-11-12,264,141,123,0,141,0,0,0.0
2024-11-13,252,153,99,0,153,0,0,0.0
2024-11-14,233,120,113,0,120,0,0,0.0
2024-11-15,245,149,96,0,149,0,0,0.0
2024-11-17,16,0,16,0,0,0,0,0.0
2024-11-18,242,146,96,0,146,0,0,0.0
2024-11-19,261,154,107,3,151,0,0,0.0
2024-11-20,246,136,110,0,136,0,0,0.0
2024-11-21,210,101,109,0,101,0,0,0.0
2024-11-22,231,153,78,0,153,0,0,0.0
2024-11-24,4,0,4,0,0,0,0,0.0
2024-11-25,181,97,84,0,97,0,0,0.0
2024-11-26,191,86,105,0,86,0,0,0.0
2024-11-27,243,130,113,0,130,0,0,0.0
2024-11-28,246,137,109,0,137,0,0,0.0
2024-11-29,215,99,116,0,99,0,0,0.0
2024-12-01,16,0,16,0,0,0,0,0.0
2024-12-02,254,143,111,0,143,0,0,0.0
2024-12-03,228,113,115,0,113,0,0,0.0
2024-12-04,258,143,115,0,143,0,0,0.0
2024-12-05,268,153,115,0,153,0,0,0.0
2024-12-06,239,157,82,0,157,0,0,0.0
2024-12-08,0,0,0,0,0,0,0,0.0
2024-12-09,170,118,52,0,118,0,0,0.0
2024-12-10,206,117,89,0,117,0,0,0.0
2024-12-11,245,134,111,0,134,0,0,0.0
2024-12-12,199,116,83,0,116,0,0,0.0
2024-12-13,253,157,96,0,157,0,0,0.0
2024-12-15,15,0,15,0,0,0,0,0.0
2024-12-16,239,141,98,0,141,0,0,0.0
2024-12-17,250,152,98,0,152,0,0,0.0
2024-12-18,208,131,77,0,131,0,0,0.0
2024-12-19,266,153,113,0,153,0,0,0.0
2024-12-20,234,139,95,0,139,0,0,0.0
2024-12-22,13,0,13,0,0,0,0,0.0
2024-12-23,188,92,96,0,92,0,0,0.0
2024-12-24,180,104,76,0,104,0,0,0.0
2024-12-25,119,0,119,0,0,0,0,0.0
2024-12-26,265,146,119,0,146,0,0,0.0
2024-12-27,204,106,98,0,106,0,0,0.0
2024-12-29,12,0,12,0,0,0,0,0.0
2024-12-30,248,118,130,0,118,0,0,0.0
2024-12-31,242,146,96,0,146,0,0,0.0
