date,breakouts,gate_pass,gate_block,ev_pass,ev_reject,fills,wins,pnl_pips
2018-01-01,9,0,9,0,0,0,0,0.0
2018-01-02,150,52,98,44,1,51,44,38.480000000002235
2018-01-03,34,2,32,2,0,2,0,-4.421428571428464
2018-01-04,106,2,104,2,0,2,0,-6.322857142856208
2018-01-05,97,1,96,1,0,1,0,-2.0985714285719155
2018-01-07,12,0,12,0,0,0,0,0.0
2018-01-08,141,53,88,1,52,1,0,-2.2228571428574924
2018-01-09,112,4,108,2,2,2,0,-7.424285714285816
2018-01-10,147,48,99,1,47,1,0,-3.761428571428837
2018-01-11,184,82,102,1,81,1,1,3.7171428571435854
2018-01-12,113,56,57,1,55,1,0,-3.96285714285699
2018-01-14,8,0,8,0,0,0,0,0.0
2018-01-15,193,89,104,1,88,1,0,-4.884285714286307
2018-01-16,197,88,109,0,88,0,0,0.0
2018-01-17,174,73,101,1,72,1,1,-0.5956499040313474
2018-01-18,180,96,84,1,95,1,0,-3.459999999998786
2018-01-19,109,21,88,1,20,1,0,-4.994285714285695
2018-01-21,12,0,12,0,0,0,0,0.0
2018-01-22,232,123,109,0,123,0,0,0.0
2018-01-23,168,74,94,1,73,1,0,-4.828571428571593
2018-01-24,197,92,105,1,91,1,1,0.33845332539880246
2018-01-25,201,99,102,1,98,1,0,-6.512857142857797
2018-01-26,177,100,77,1,99,1,0,-5.210000000000036
2018-01-28,10,0,10,0,0,0,0,0.0
2018-01-29,177,91,86,1,90,1,0,-4.841428571427741
2018-01-30,222,124,98,1,123,1,1,3.5371428571432943
2018-01-31,178,83,95,1,82,1,0,-4.944285714285456
2018-02-01,195,86,109,1,85,1,0,-4.8199999999998795
2018-02-02,137,43,94,1,42,1,0,-5.377142857142758
2018-02-04,10,0,10,0,0,0,0,0.0
2018-02-05,191,86,105,1,85,1,0,-5.308571428571895
2018-02-06,174,69,105,1,68,1,0,-6.932857142857529
2018-02-07,187,85,102,1,84,1,0,-4.012857142857229
2018-02-08,168,101,67,1,100,1,0,-4.680000000000916
2018-02-09,177,84,93,1,83,1,1,3.654285714285777
2018-02-11,12,0,12,0,0,0,0,0.0
2018-02-12,170,60,110,1,59,1,1,0.25354266657399194
2018-02-13,158,60,98,0,60,0,0,0.0
2018-02-14,190,91,99,1,90,1,0,-4.190000000000282
2018-02-15,204,93,111,1,92,1,0,-4.944285714285456
2018-02-16,175,82,93,1,81,1,0,-4.458571428570679
2018-02-18,15,0,15,0,0,0,0,0.0
2018-02-19,122,23,99,1,22,1,0,-4.254285714285288
2018-02-20,232,125,107,0,125,0,0,0.0
2018-02-21,204,97,107,1,96,1,0,-4.03571428571513
2018-02-22,212,104,108,1,103,1,1,-0.7229171975130839
2018-02-23,179,83,96,1,82,1,0,-3.7957142857142685
2018-02-25,5,0,5,0,0,0,0,0.0
2018-02-26,206,101,105,1,100,1,0,-3.11857142857167
2018-02-27,176,103,73,0,103,0,0,0.0
2018-02-28,186,81,105,1,80,1,0,-3.6542857142852654
2018-03-01,246,140,106,0,140,0,0,0.0
2018-03-02,175,84,91,1,83,1,1,5.277142857142792
2018-03-04,6,0,6,0,0,0,0,0.0
2018-03-05,128,98,30,1,97,1,1,0.3224808759479174
2018-03-06,180,74,106,1,73,1,0,-3.8057142857146005
2018-03-07,88,55,33,1,54,1,1,3.588571428572152
2018-03-08,134,29,105,1,28,1,1,2.619999999999834
2018-03-09,130,34,96,0,34,0,0,0.0
2018-03-11,19,6,13,0,6,0,0,0.0
2018-03-12,117,9,108,1,8,1,0,-4.0614285714288485
2018-03-13,210,102,108,1,101,1,1,3.7257142857138774
2018-03-14,201,108,93,1,107,1,1,2.080000000000382
2018-03-15,198,93,105,1,92,1,0,-4.382857142856722
2018-03-16,187,91,96,1,90,1,0,-4.438571428571436
2018-03-18,16,11,5,0,11,0,0,0.0
2018-03-19,189,84,105,1,83,1,1,3.1857142857144254
2018-03-20,139,35,104,1,34,1,0,-4.0142857142858475
2018-03-21,245,134,111,0,134,0,0,0.0
2018-03-22,178,66,112,1,65,1,0,-3.69714285714241
2018-03-23,140,66,74,1,65,1,1,5.362857142857081
2018-03-25,20,12,8,0,12,0,0,0.0
2018-03-26,173,72,101,1,71,1,0,-3.1142857142858134
2018-03-27,238,139,99,0,139,0,0,0.0
2018-03-28,199,95,104,1,94,1,0,-5.197142857142467
2018-03-29,211,110,101,0,110,0,0,0.0
2018-03-30,145,52,93,0,52,0,0,0.0
2018-04-01,8,6,2,0,6,0,0,0.0
2018-04-02,156,130,26,0,130,0,0,0.0
2018-04-03,183,81,102,0,81,0,0,0.0
2018-04-04,169,103,66,0,103,0,0,0.0
2018-04-05,248,138,110,0,138,0,0,0.0
2018-04-06,173,80,93,0,80,0,0,0.0
2018-04-08,19,12,7,0,12,0,0,0.0
2018-04-09,176,115,61,0,115,0,0,0.0
2018-04-10,205,104,101,0,104,0,0,0.0
2018-04-11,176,69,107,0,69,0,0,0.0
2018-04-12,182,69,113,0,69,0,0,0.0
2018-04-13,216,122,94,0,122,0,0,0.0
2018-04-15,12,12,0,0,12,0,0,0.0
2018-04-16,206,102,104,0,102,0,0,0.0
2018-04-17,234,133,101,0,133,0,0,0.0
2018-04-18,206,101,105,0,101,0,0,0.0
2018-04-19,155,50,105,0,50,0,0,0.0
2018-04-20,225,130,95,0,130,0,0,0.0
2018-04-22,22,12,10,0,12,0,0,0.0
2018-04-23,250,152,98,0,152,0,0,0.0
2018-04-24,211,113,98,0,113,0,0,0.0
2018-04-25,224,131,93,0,131,0,0,0.0
2018-04-26,243,139,104,0,139,0,0,0.0
2018-04-27,183,89,94,0,89,0,0,0.0
2018-04-29,22,12,10,0,12,0,0,0.0
2018-04-30,172,100,72,0,100,0,0,0.0
2018-05-01,254,142,112,0,142,0,0,0.0
2018-05-02,226,115,111,0,115,0,0,0.0
2018-05-03,255,144,111,0,144,0,0,0.0
2018-05-04,206,112,94,0,112,0,0,0.0
2018-05-06,24,12,12,0,12,0,0,0.0
2018-05-07,248,141,107,0,141,0,0,0.0
2018-05-08,186,88,98,0,88,0,0,0.0
2018-05-09,156,50,106,0,50,0,0,0.0
2018-05-10,195,90,105,0,90,0,0,0.0
2018-05-11,217,125,92,0,125,0,0,0.0
2018-05-13,13,12,1,0,12,0,0,0.0
2018-05-14,180,110,70,0,110,0,0,0.0
2018-05-15,188,76,112,0,76,0,0,0.0
2018-05-16,216,120,96,0,120,0,0,0.0
2018-05-17,161,69,92,0,69,0,0,0.0
2018-05-18,178,92,86,0,92,0,0,0.0
2018-05-20,6,3,3,0,3,0,0,0.0
2018-05-21,238,132,106,0,132,0,0,0.0
2018-05-22,176,81,95,0,81,0,0,0.0
2018-05-23,177,79,98,0,79,0,0,0.0
2018-05-24,222,112,110,0,112,0,0,0.0
2018-05-25,165,69,96,0,69,0,0,0.0
2018-05-27,19,12,7,0,12,0,0,0.0
2018-05-28,229,127,102,0,127,0,0,0.0
2018-05-29,227,120,107,1,119,1,1,5.354285714285368
2018-05-30,126,41,85,1,40,1,0,-4.442857142857292
2018-05-31,146,38,108,1,37,1,0,-4.541428571429151
2018-06-01,227,134,93,0,134,0,0,0.0
2018-06-03,15,12,3,0,12,0,0,0.0
2018-06-04,225,116,109,0,116,0,0,0.0
2018-06-05,147,98,49,0,98,0,0,0.0
2018-06-06,226,133,93,0,133,0,0,0.0
2018-06-07,236,134,102,0,134,0,0,0.0
2018-06-08,201,115,86,0,115,0,0,0.0
2018-06-10,12,12,0,0,12,0,0,0.0
2018-06-11,220,131,89,0,131,0,0,0.0
2018-06-12,198,99,99,0,99,0,0,0.0
2018-06-13,233,149,84,0,149,0,0,0.0
2018-06-14,169,102,67,0,102,0,0,0.0
2018-06-15,168,73,95,0,73,0,0,0.0
2018-06-17,23,12,11,0,12,0,0,0.0
2018-06-18,205,99,106,0,99,0,0,0.0
2018-06-19,234,128,106,0,128,0,0,0.0
2018-06-20,243,139,104,0,139,0,0,0.0
2018-06-21,248,148,100,0,148,0,0,0.0
2018-06-22,195,100,95,0,100,0,0,0.0
2018-06-24,20,12,8,0,12,0,0,0.0
2018-06-25,237,127,110,0,127,0,0,0.0
2018-06-26,223,119,104,0,119,0,0,0.0
2018-06-27,221,119,102,0,119,0,0,0.0
2018-06-28,242,140,102,0,140,0,0,0.0
2018-06-29,171,76,95,0,76,0,0,0.0
2018-07-01,13,5,8,0,5,0,0,0.0
2018-07-02,174,83,91,0,83,0,0,0.0
2018-07-03,235,134,101,0,134,0,0,0.0
2018-07-04,184,84,100,0,84,0,0,0.0
2018-07-05,183,87,96,0,87,0,0,0.0
2018-07-06,161,93,68,0,93,0,0,0.0
2018-07-08,16,12,4,0,12,0,0,0.0
2018-07-09,194,136,58,0,136,0,0,0.0
2018-07-10,236,140,96,0,140,0,0,0.0
2018-07-11,220,146,74,0,146,0,0,0.0
2018-07-12,201,88,113,0,88,0,0,0.0
2018-07-13,228,133,95,0,133,0,0,0.0
2018-07-15,25,12,13,0,12,0,0,0.0
2018-07-16,235,139,96,0,139,0,0,0.0
2018-07-17,246,138,108,0,138,0,0,0.0
2018-07-18,178,95,83,0,95,0,0,0.0
2018-07-19,220,118,102,0,118,0,0,0.0
2018-07-20,199,108,91,0,108,0,0,0.0
2018-07-22,29,12,17,0,12,0,0,0.0
2018-07-23,252,140,112,0,140,0,0,0.0
2018-07-24,208,132,76,0,132,0,0,0.0
2018-07-25,204,114,90,0,114,0,0,0.0
2018-07-26,242,139,103,0,139,0,0,0.0
2018-07-27,153,57,96,0,57,0,0,0.0
2018-07-29,4,0,4,0,0,0,0,0.0
2018-07-30,192,89,103,0,89,0,0,0.0
2018-07-31,184,74,110,0,74,0,0,0.0
2018-08-01,237,137,100,0,137,0,0,0.0
2018-08-02,244,148,96,0,148,0,0,0.0
2018-08-03,209,122,87,0,122,0,0,0.0
2018-08-05,13,12,1,0,12,0,0,0.0
2018-08-06,226,125,101,0,125,0,0,0.0
2018-08-07,262,149,113,0,149,0,0,0.0
2018-08-08,205,105,100,0,105,0,0,0.0
2018-08-09,238,129,109,0,129,0,0,0.0
2018-08-10,203,107,96,0,107,0,0,0.0
2018-08-12,12,12,0,0,12,0,0,0.0
2018-08-13,226,128,98,1,127,1,1,7.582857142856881
2018-08-14,188,91,97,1,90,1,0,-5.449999999999477
2018-08-15,246,137,109,0,137,0,0,0.0
2018-08-16,242,136,106,0,136,0,0,0.0
2018-08-17,174,78,96,0,78,0,0,0.0
2018-08-19,9,2,7,0,2,0,0,0.0
2018-08-20,196,100,96,0,100,0,0,0.0
2018-08-21,239,137,102,0,137,0,0,0.0
2018-08-22,232,138,94,0,138,0,0,0.0
2018-08-23,217,120,97,0,120,0,0,0.0
2018-08-24,178,123,55,0,123,0,0,0.0
2018-08-26,19,12,7,0,12,0,0,0.0
2018-08-27,232,125,107,0,125,0,0,0.0
2018-08-28,226,120,106,0,120,0,0,0.0
2018-08-29,244,146,98,0,146,0,0,0.0
2018-08-30,237,141,96,0,141,0,0,0.0
2018-08-31,170,108,62,0,108,0,0,0.0
2018-09-02,21,12,9,0,12,0,0,0.0
2018-09-03,203,111,92,0,111,0,0,0.0
2018-09-04,222,132,90,0,132,0,0,0.0
2018-09-05,133,58,75,0,58,0,0,0.0
2018-09-06,224,116,108,0,116,0,0,0.0
2018-09-07,210,115,95,0,115,0,0,0.0
2018-09-09,18,2,16,0,2,0,0,0.0
2018-09-10,199,107,92,0,107,0,0,0.0
2018-09-11,251,152,99,0,152,0,0,0.0
2018-09-12,197,97,100,0,97,0,0,0.0
2018-09-13,257,144,113,0,144,0,0,0.0
2018-09-14,151,70,81,0,70,0,0,0.0
2018-09-16,0,0,0,0,0,0,0,0.0
2018-09-17,151,123,28,0,123,0,0,0.0
2018-09-18,219,138,81,0,138,0,0,0.0
2018-09-19,122,33,89,0,33,0,0,0.0
2018-09-20,211,112,99,0,112,0,0,0.0
2018-09-21,207,114,93,0,114,0,0,0.0
2018-09-23,18,12,6,0,12,0,0,0.0
2018-09-24,194,98,96,0,98,0,0,0.0
2018-09-25,246,144,102,0,144,0,0,0.0
2018-09-26,246,138,108,0,138,0,0,0.0
2018-09-27,252,149,103,0,149,0,0,0.0
2018-09-28,202,108,94,0,108,0,0,0.0
2018-09-30,25,12,13,0,12,0,0,0.0
2018-10-01,219,108,111,0,108,0,0,0.0
2018-10-02,202,100,102,0,100,0,0,0.0
2018-10-03,226,122,104,0,122,0,0,0.0
2018-10-04,227,119,108,0,119,0,0,0.0
2018-10-05,189,124,65,0,124,0,0,0.0
2018-10-07,12,11,1,0,11,0,0,0.0
2018-10-08,166,58,108,0,58,0,0,0.0
2018-10-09,218,116,102,0,116,0,0,0.0
2018-10-10,252,152,100,0,152,0,0,0.0
2018-10-11,174,105,69,0,105,0,0,0.0
2018-10-12,189,94,95,0,94,0,0,0.0
2018-10-14,19,12,7,0,12,0,0,0.0
2018-10-15,174,74,100,0,74,0,0,0.0
2018-10-16,213,105,108,0,105,0,0,0.0
2018-10-17,216,118,98,0,118,0,0,0.0
2018-10-18,244,142,102,0,142,0,0,0.0
2018-10-19,184,88,96,0,88,0,0,0.0
2018-10-21,20,12,8,0,12,0,0,0.0
2018-10-22,168,70,98,0,70,0,0,0.0
2018-10-23,226,122,104,0,122,0,0,0.0
2018-10-24,242,140,102,0,140,0,0,0.0
2018-10-25,187,115,72,0,115,0,0,0.0
2018-10-26,213,121,92,0,121,0,0,0.0
2018-10-28,17,9,8,0,9,0,0,0.0
2018-10-29,180,93,87,0,93,0,0,0.0
2018-10-30,222,113,109,0,113,0,0,0.0
2018-10-31,210,103,107,0,103,0,0,0.0
2018-11-01,239,135,104,0,135,0,0,0.0
2018-11-02,219,123,96,0,123,0,0,0.0
2018-11-04,10,0,10,0,0,0,0,0.0
2018-11-05,206,149,57,0,149,0,0,0.0
2018-11-06,248,145,103,0,145,0,0,0.0
2018-11-07,214,122,92,0,122,0,0,0.0
2018-11-08,227,124,103,0,124,0,0,0.0
2018-11-09,204,108,96,0,108,0,0,0.0
2018-11-11,7,0,7,0,0,0,0,0.0
2018-11-12,175,74,101,0,74,0,0,0.0
2018-11-13,227,124,103,0,124,0,0,0.0
2018-11-14,226,121,105,0,121,0,0,0.0
2018-11-15,219,133,86,0,133,0,0,0.0
2018-11-16,218,135,83,0,135,0,0,0.0
2018-11-18,12,0,12,0,0,0,0,0.0
2018-11-19,200,117,83,0,117,0,0,0.0
2018-11-20,201,126,75,0,126,0,0,0.0
2018-11-21,166,70,96,0,70,0,0,0.0
2018-11-22,121,106,15,0,106,0,0,0.0
2018-11-23,207,129,78,0,129,0,0,0.0
2018-11-25,10,0,10,0,0,0,0,0.0
2018-11-26,243,138,105,0,138,0,0,0.0
2018-11-27,233,132,101,0,132,0,0,0.0
2018-11-28,250,143,107,0,143,0,0,0.0
2018-11-29,232,136,96,0,136,0,0,0.0
2018-11-30,109,109,0,0,109,0,0,0.0
2018-12-02,14,0,14,0,0,0,0,0.0
2018-12-03,201,113,88,0,113,0,0,0.0
2018-12-04,241,135,106,0,135,0,0,0.0
2018-12-05,257,149,108,0,149,0,0,0.0
2018-12-06,259,152,107,0,152,0,0,0.0
2018-12-07,129,41,88,0,41,0,0,0.0
2018-12-09,13,0,13,0,0,0,0,0.0
2018-12-10,243,137,106,0,137,0,0,0.0
2018-12-11,240,131,109,0,131,0,0,0.0
2018-12-12,217,121,96,0,121,0,0,0.0
2018-12-13,177,81,96,0,81,0,0,0.0
2018-12-14,198,126,72,0,126,0,0,0.0
2018-12-16,16,0,16,0,0,0,0,0.0
2018-12-17,241,146,95,0,146,0,0,0.0
2018-12-18,253,149,104,0,149,0,0,0.0
2018-12-19,227,115,112,0,115,0,0,0.0
2018-12-20,234,142,92,0,142,0,0,0.0
2018-12-21,171,94,77,0,94,0,0,0.0
2018-12-23,5,0,5,0,0,0,0,0.0
2018-12-24,131,122,9,0,122,0,0,0.0
2018-12-25,117,0,117,0,0,0,0,0.0
2018-12-26,222,145,77,0,145,0,0,0.0
2018-12-27,227,118,109,0,118,0,0,0.0
2018-12-28,165,70,95,0,70,0,0,0.0
2018-12-30,12,0,12,0,0,0,0,0.0
2018-12-31,215,123,92,0,123,0,0,0.0
2019-01-01,16,0,16,0,0,0,0,0.0
2019-01-02,194,102,92,0,102,0,0,0.0
2019-01-03,58,46,12,0,46,0,0,0.0
2019-01-04,207,111,96,0,111,0,0,0.0
2019-01-06,11,0,11,0,0,0,0,0.0
2019-01-07,225,137,88,0,137,0,0,0.0
2019-01-08,216,124,92,0,124,0,0,0.0
2019-01-09,189,117,72,0,117,0,0,0.0
2019-01-10,246,141,105,0,141,0,0,0.0
2019-01-11,184,99,85,0,99,0,0,0.0
2019-01-13,12,0,12,0,0,0,0,0.0
2019-01-14,222,110,112,0,110,0,0,0.0
2019-01-15,213,116,97,0,116,0,0,0.0
2019-01-16,218,116,102,0,116,0,0,0.0
2019-01-17,210,105,105,0,105,0,0,0.0
2019-01-18,213,118,95,0,118,0,0,0.0
2019-01-20,3,0,3,0,0,0,0,0.0
2019-01-21,181,79,102,0,79,0,0,0.0
2019-01-22,202,117,85,0,117,0,0,0.0
2019-01-23,236,137,99,0,137,0,0,0.0
2019-01-24,178,91,87,0,91,0,0,0.0
2019-01-25,239,144,95,0,144,0,0,0.0
2019-01-27,10,0,10,0,0,0,0,0.0
2019-01-28,232,129,103,0,129,0,0,0.0
2019-01-29,243,154,89,0,154,0,0,0.0
2019-01-30,174,131,43,0,131,0,0,0.0
2019-01-31,238,139,99,0,139,0,0,0.0
2019-02-01,224,137,87,0,137,0,0,0.0
2019-02-03,17,0,17,0,0,0,0,0.0
2019-02-04,174,71,103,0,71,0,0,0.0
2019-02-05,135,62,73,0,62,0,0,0.0
2019-02-06,210,106,104,0,106,0,0,0.0
2019-02-07,207,120,87,0,120,0,0,0.0
2019-02-08,141,87,54,0,87,0,0,0.0
2019-02-10,5,0,5,0,0,0,0,0.0
2019-02-11,229,152,77,0,152,0,0,0.0
2019-02-12,231,132,99,0,132,0,0,0.0
2019-02-13,221,113,108,0,113,0,0,0.0
2019-02-14,225,144,81,0,144,0,0,0.0
2019-02-15,210,126,84,0,126,0,0,0.0
2019-02-17,13,0,13,0,0,0,0,0.0
2019-02-18,231,132,99,0,132,0,0,0.0
2019-02-19,233,138,95,0,138,0,0,0.0
2019-02-20,251,144,107,0,144,0,0,0.0
2019-02-21,154,60,94,0,60,0,0,0.0
2019-02-22,240,151,89,0,151,0,0,0.0
2019-02-24,17,0,17,0,0,0,0,0.0
2019-02-25,201,136,65,0,136,0,0,0.0
2019-02-26,209,113,96,0,113,0,0,0.0
2019-02-27,207,128,79,0,128,0,0,0.0
2019-02-28,231,130,101,0,130,0,0,0.0
2019-03-01,212,116,96,0,116,0,0,0.0
2019-03-03,13,0,13,0,0,0,0,0.0
2019-03-04,225,129,96,0,129,0,0,0.0
2019-03-05,235,129,106,0,129,0,0,0.0
2019-03-06,227,128,99,0,128,0,0,0.0
2019-03-07,237,149,88,0,149,0,0,0.0
2019-03-08,151,56,95,0,56,0,0,0.0
2019-03-10,3,0,3,0,0,0,0,0.0
2019-03-11,175,142,33,0,142,0,0,0.0
2019-03-12,226,134,92,0,134,0,0,0.0
2019-03-13,229,123,106,0,123,0,0,0.0
2019-03-14,209,96,113,0,96,0,0,0.0
2019-03-15,118,34,84,0,34,0,0,0.0
2019-03-17,11,0,11,0,0,0,0,0.0
2019-03-18,249,136,113,0,136,0,0,0.0
2019-03-19,230,121,109,0,121,0,0,0.0
2019-03-20,218,115,103,0,115,0,0,0.0
2019-03-21,241,152,89,0,152,0,0,0.0
2019-03-22,220,140,80,0,140,0,0,0.0
2019-03-24,24,12,12,0,12,0,0,0.0
2019-03-25,191,107,84,0,107,0,0,0.0
2019-03-26,176,86,90,0,86,0,0,0.0
2019-03-27,110,97,13,0,97,0,0,0.0
2019-03-28,159,57,102,0,57,0,0,0.0
2019-03-29,127,34,93,0,34,0,0,0.0
2019-03-31,18,12,6,0,12,0,0,0.0
2019-04-01,247,140,107,0,140,0,0,0.0
2019-04-02,147,76,71,0,76,0,0,0.0
2019-04-03,187,81,106,0,81,0,0,0.0
2019-04-04,198,104,94,0,104,0,0,0.0
2019-04-05,126,30,96,0,30,0,0,0.0
2019-04-07,12,0,12,0,0,0,0,0.0
2019-04-08,239,127,112,0,127,0,0,0.0
2019-04-09,241,135,106,0,135,0,0,0.0
2019-04-10,207,124,83,0,124,0,0,0.0
2019-04-11,232,123,109,0,123,0,0,0.0
2019-04-12,216,120,96,0,120,0,0,0.0
2019-04-14,29,12,17,0,12,0,0,0.0
2019-04-15,146,57,89,0,57,0,0,0.0
2019-04-16,142,58,84,0,58,0,0,0.0
2019-04-17,191,85,106,0,85,0,0,0.0
2019-04-18,181,85,96,0,85,0,0,0.0
2019-04-19,136,49,87,0,49,0,0,0.0
2019-04-21,27,12,15,0,12,0,0,0.0
2019-04-22,128,50,78,0,50,0,0,0.0
2019-04-23,227,127,100,0,127,0,0,0.0
2019-04-24,231,134,97,0,134,0,0,0.0
2019-04-25,233,125,108,0,125,0,0,0.0
2019-04-26,193,97,96,0,97,0,0,0.0
2019-04-28,21,12,9,0,12,0,0,0.0
2019-04-29,213,117,96,0,117,0,0,0.0
2019-04-30,183,82,101,0,82,0,0,0.0
2019-05-01,235,134,101,0,134,0,0,0.0
2019-05-02,229,124,105,0,124,0,0,0.0
2019-05-03,204,113,91,0,113,0,0,0.0
2019-05-05,27,12,15,0,12,0,0,0.0
2019-05-06,165,79,86,0,79,0,0,0.0
2019-05-07,210,146,64,0,146,0,0,0.0
2019-05-08,180,81,99,0,81,0,0,0.0
2019-05-09,242,134,108,0,134,0,0,0.0
2019-05-10,191,96,95,0,96,0,0,0.0
2019-05-12,17,12,5,0,12,0,0,0.0
2019-05-13,145,94,51,1,93,1,1,6.837142857143419
2019-05-14,219,108,111,0,108,0,0,0.0
2019-05-15,257,153,104,0,153,0,0,0.0
2019-05-16,255,153,102,0,153,0,0,0.0
2019-05-17,204,108,96,0,108,0,0,0.0
2019-05-19,22,12,10,0,12,0,0,0.0
2019-05-20,249,140,109,0,140,0,0,0.0
2019-05-21,231,121,110,0,121,0,0,0.0
2019-05-22,228,135,93,0,135,0,0,0.0
2019-05-23,254,153,101,0,153,0,0,0.0
2019-05-24,204,117,87,0,117,0,0,0.0
2019-05-26,28,12,16,0,12,0,0,0.0
2019-05-27,250,139,111,0,139,0,0,0.0
2019-05-28,188,106,82,0,106,0,0,0.0
2019-05-29,212,115,97,0,115,0,0,0.0
2019-05-30,222,114,108,0,114,0,0,0.0
2019-05-31,210,114,96,0,114,0,0,0.0
2019-06-02,17,12,5,0,12,0,0,0.0
2019-06-03,198,122,76,0,122,0,0,0.0
2019-06-04,186,105,81,0,105,0,0,0.0
2019-06-05,203,122,81,0,122,0,0,0.0
2019-06-06,151,101,50,0,101,0,0,0.0
2019-06-07,184,88,96,1,87,1,1,5.722857142856242
2019-06-09,14,12,2,0,12,0,0,0.0
2019-06-10,179,110,69,0,110,0,0,0.0
2019-06-11,221,122,99,0,122,0,0,0.0
2019-06-12,140,37,103,0,37,0,0,0.0
2019-06-13,242,136,106,0,136,0,0,0.0
2019-06-14,201,105,96,0,105,0,0,0.0
2019-06-16,11,5,6,0,5,0,0,0.0
2019-06-17,227,121,106,0,121,0,0,0.0
2019-06-18,216,108,108,0,108,0,0,0.0
2019-06-19,229,132,97,0,132,0,0,0.0
2019-06-20,215,114,101,0,114,0,0,0.0
2019-06-21,205,127,78,0,127,0,0,0.0
2019-06-23,29,12,17,0,12,0,0,0.0
2019-06-24,242,146,96,0,146,0,0,0.0
2019-06-25,198,107,91,0,107,0,0,0.0
2019-06-26,183,81,102,1,80,1,1,3.8457142857135977
2019-06-27,249,141,108,0,141,0,0,0.0
2019-06-28,206,110,96,0,110,0,0,0.0
2019-06-30,16,12,4,0,12,0,0,0.0
2019-07-01,125,108,17,0,108,0,0,0.0
2019-07-02,153,128,25,0,128,0,0,0.0
2019-07-03,254,141,113,0,141,0,0,0.0
2019-07-04,148,61,87,0,61,0,0,0.0
2019-07-05,191,95,96,0,95,0,0,0.0
2019-07-07,0,0,0,0,0,0,0,0.0
2019-07-08,240,153,87,0,153,0,0,0.0
2019-07-09,192,85,107,0,85,0,0,0.0
2019-07-10,235,127,108,0,127,0,0,0.0
2019-07-11,246,139,107,0,139,0,0,0.0
2019-07-12,209,113,96,0,113,0,0,0.0
2019-07-14,18,12,6,0,12,0,0,0.0
2019-07-15,112,23,89,0,23,0,0,0.0
2019-07-16,217,113,104,0,113,0,0,0.0
2019-07-17,207,120,87,0,120,0,0,0.0
2019-07-18,228,133,95,0,133,0,0,0.0
2019-07-19,106,76,30,0,76,0,0,0.0
2019-07-21,18,2,16,0,2,0,0,0.0
2019-07-22,163,60,103,0,60,0,0,0.0
2019-07-23,205,98,107,0,98,0,0,0.0
2019-07-24,238,133,105,0,133,0,0,0.0
2019-07-25,193,113,80,0,113,0,0,0.0
2019-07-26,120,46,74,0,46,0,0,0.0
2019-07-28,6,0,6,0,0,0,0,0.0
2019-07-29,219,127,92,0,127,0,0,0.0
2019-07-30,234,133,101,0,133,0,0,0.0
2019-07-31,194,88,106,0,88,0,0,0.0
2019-08-01,258,148,110,0,148,0,0,0.0
2019-08-02,181,87,94,1,86,1,0,-3.495714285714257
2019-08-04,15,12,3,0,12,0,0,0.0
2019-08-05,203,104,99,0,104,0,0,0.0
2019-08-06,127,25,102,1,24,1,0,-4.018571428571704
2019-08-07,205,107,98,0,107,0,0,0.0
2019-08-08,135,102,33,0,102,0,0,0.0
2019-08-09,230,137,93,0,137,0,0,0.0
2019-08-11,24,12,12,0,12,0,0,0.0
2019-08-12,207,99,108,1,98,1,0,-5.642857142857338
2019-08-13,255,142,113,0,142,0,0,0.0
2019-08-14,212,100,112,0,100,0,0,0.0
2019-08-15,147,43,104,1,42,1,1,6.66571428571342
2019-08-16,107,26,81,1,25,1,1,5.088571428570788
2019-08-18,16,1,15,0,1,0,0,0.0
2019-08-19,89,61,28,0,61,0,0,0.0
2019-08-20,173,100,73,0,100,0,0,0.0
2019-08-21,243,136,107,0,136,0,0,0.0
2019-08-22,233,128,105,0,128,0,0,0.0
2019-08-23,222,126,96,0,126,0,0,0.0
2019-08-25,21,12,9,0,12,0,0,0.0
2019-08-26,154,50,104,1,49,1,0,-4.76000000000073
2019-08-27,204,100,104,0,100,0,0,0.0
2019-08-28,209,109,100,0,109,0,0,0.0
2019-08-29,226,120,106,0,120,0,0,0.0
2019-08-30,201,106,95,0,106,0,0,0.0
2019-09-01,12,12,0,0,12,0,0,0.0
2019-09-02,235,149,86,0,149,0,0,0.0
2019-09-03,234,129,105,0,129,0,0,0.0
2019-09-04,173,79,94,0,79,0,0,0.0
2019-09-05,234,123,111,0,123,0,0,0.0
2019-09-06,160,81,79,0,81,0,0,0.0
2019-09-08,7,0,7,0,0,0,0,0.0
2019-09-09,166,121,45,0,121,0,0,0.0
2019-09-10,235,133,102,0,133,0,0,0.0
2019-09-11,189,84,105,0,84,0,0,0.0
2019-09-12,226,127,99,0,127,0,0,0.0
2019-09-13,82,35,47,0,35,0,0,0.0
2019-09-15,12,12,0,0,12,0,0,0.0
2019-09-16,167,141,26,0,141,0,0,0.0
2019-09-17,121,23,98,0,23,0,0,0.0
2019-09-18,219,119,100,0,119,0,0,0.0
2019-09-19,197,95,102,0,95,0,0,0.0
2019-09-20,205,109,96,0,109,0,0,0.0
2019-09-22,17,12,5,0,12,0,0,0.0
2019-09-23,103,72,31,0,72,0,0,0.0
2019-09-24,254,147,107,0,147,0,0,0.0
2019-09-25,224,120,104,0,120,0,0,0.0
2019-09-26,209,103,106,0,103,0,0,0.0
2019-09-27,224,131,93,0,131,0,0,0.0
2019-09-29,16,12,4,0,12,0,0,0.0
2019-09-30,155,109,46,0,109,0,0,0.0
2019-10-01,223,128,95,0,128,0,0,0.0
2019-10-02,234,136,98,0,136,0,0,0.0
2019-10-03,248,150,98,0,150,0,0,0.0
2019-10-04,219,125,94,0,125,0,0,0.0
2019-10-06,22,12,10,0,12,0,0,0.0
2019-10-07,181,106,75,0,106,0,0,0.0
2019-10-08,250,137,113,0,137,0,0,0.0
2019-10-09,219,120,99,0,120,0,0,0.0
2019-10-10,188,114,74,0,114,0,0,0.0
2019-10-11,217,133,84,0,133,0,0,0.0
2019-10-13,20,9,11,0,9,0,0,0.0
2019-10-14,229,126,103,0,126,0,0,0.0
2019-10-15,234,145,89,0,145,0,0,0.0
2019-10-16,224,115,109,0,115,0,0,0.0
2019-10-17,169,67,102,0,67,0,0,0.0
2019-10-18,160,69,91,0,69,0,0,0.0
2019-10-20,4,4,0,0,4,0,0,0.0
2019-10-21,210,116,94,0,116,0,0,0.0
2019-10-22,227,131,96,0,131,0,0,0.0
2019-10-23,237,131,106,0,131,0,0,0.0
2019-10-24,153,58,95,0,58,0,0,0.0
2019-10-25,221,127,94,0,127,0,0,0.0
2019-10-27,14,12,2,0,12,0,0,0.0
2019-10-28,249,148,101,0,148,0,0,0.0
2019-10-29,160,109,51,0,109,0,0,0.0
2019-10-30,189,112,77,0,112,0,0,0.0
2019-10-31,212,115,97,1,114,1,1,5.380000000000507
2019-11-01,201,128,73,0,128,0,0,0.0
2019-11-03,2,0,2,0,0,0,0,0.0
2019-11-04,148,116,32,0,116,0,0,0.0
2019-11-05,198,102,96,0,102,0,0,0.0
2019-11-06,175,81,94,0,81,0,0,0.0
2019-11-07,227,131,96,0,131,0,0,0.0
2019-11-08,223,135,88,0,135,0,0,0.0
2019-11-10,13,0,13,0,0,0,0,0.0
2019-11-11,211,119,92,0,119,0,0,0.0
2019-11-12,231,132,99,0,132,0,0,0.0
2019-11-13,193,99,94,0,99,0,0,0.0
2019-11-14,212,125,87,0,125,0,0,0.0
2019-11-15,231,135,96,0,135,0,0,0.0
2019-11-17,12,0,12,0,0,0,0,0.0
2019-11-18,240,138,102,0,138,0,0,0.0
2019-11-19,239,132,107,0,132,0,0,0.0
2019-11-20,206,117,89,0,117,0,0,0.0
2019-11-21,71,41,30,0,41,0,0,0.0
2019-11-22,213,143,70,0,143,0,0,0.0
2019-11-24,13,0,13,0,0,0,0,0.0
2019-11-25,200,91,109,0,91,0,0,0.0
2019-11-26,216,115,101,0,115,0,0,0.0
2019-11-27,242,134,108,0,134,0,0,0.0
2019-11-28,224,132,92,0,132,0,0,0.0
2019-11-29,214,122,92,0,122,0,0,0.0
2019-12-01,9,0,9,0,0,0,0,0.0
2019-12-02,215,117,98,0,117,0,0,0.0
2019-12-03,244,149,95,0,149,0,0,0.0
2019-12-04,234,135,99,0,135,0,0,0.0
2019-12-05,193,119,74,0,119,0,0,0.0
2019-12-06,139,50,89,0,50,0,0,0.0
2019-12-08,11,0,11,0,0,0,0,0.0
2019-12-09,227,134,93,0,134,0,0,0.0
2019-12-10,167,72,95,0,72,0,0,0.0
2019-12-11,108,107,1,0,107,0,0,0.0
2019-12-12,211,134,77,0,134,0,0,0.0
2019-12-13,189,130,59,0,130,0,0,0.0
2019-12-15,9,0,9,0,0,0,0,0.0
2019-12-16,210,105,105,0,105,0,0,0.0
2019-12-17,151,116,35,0,116,0,0,0.0
2019-12-18,152,67,85,0,67,0,0,0.0
2019-12-19,193,138,55,0,138,0,0,0.0
2019-12-20,149,129,20,0,129,0,0,0.0
2019-12-22,12,0,12,0,0,0,0,0.0
2019-12-23,94,78,16,0,78,0,0,0.0
2019-12-24,202,130,72,0,130,0,0,0.0
2019-12-25,98,0,98,0,0,0,0,0.0
2019-12-26,222,126,96,0,126,0,0,0.0
2019-12-27,195,103,92,0,103,0,0,0.0
2019-12-29,3,0,3,0,0,0,0,0.0
2019-12-30,219,126,93,0,126,0,0,0.0
2019-12-31,228,141,87,0,141,0,0,0.0
2020-01-01,0,0,0,0,0,0,0,0.0
2020-01-02,135,115,20,0,115,0,0,0.0
2020-01-03,170,84,86,1,83,1,0,-3.4914285714284006
2020-01-05,14,0,14,0,0,0,0,0.0
2020-01-06,214,105,109,0,105,0,0,0.0
2020-01-07,203,101,102,0,101,0,0,0.0
2020-01-08,227,126,101,0,126,0,0,0.0
2020-01-09,240,144,96,0,144,0,0,0.0
2020-01-10,128,89,39,0,89,0,0,0.0
2020-01-12,12,0,12,0,0,0,0,0.0
2020-01-13,243,140,103,0,140,0,0,0.0
2020-01-14,160,56,104,0,56,0,0,0.0
2020-01-15,199,100,99,0,100,0,0,0.0
2020-01-16,201,93,108,0,93,0,0,0.0
2020-01-17,158,69,89,0,69,0,0,0.0
2020-01-19,5,0,5,0,0,0,0,0.0
2020-01-20,197,128,69,0,128,0,0,0.0
2020-01-21,236,129,107,0,129,0,0,0.0
2020-01-22,238,132,106,0,132,0,0,0.0
2020-01-23,217,106,111,0,106,0,0,0.0
2020-01-24,195,106,89,0,106,0,0,0.0
2020-01-26,13,0,13,0,0,0,0,0.0
2020-01-27,180,117,63,0,117,0,0,0.0
2020-01-28,247,143,104,0,143,0,0,0.0
2020-01-29,164,97,67,0,97,0,0,0.0
2020-01-30,213,106,107,0,106,0,0,0.0
2020-01-31,236,143,93,0,143,0,0,0.0
2020-02-02,0,0,0,0,0,0,0,0.0
2020-02-03,199,96,103,0,96,0,0,0.0
2020-02-04,202,113,89,0,113,0,0,0.0
2020-02-05,109,41,68,0,41,0,0,0.0
2020-02-06,226,122,104,0,122,0,0,0.0
2020-02-07,192,96,96,0,96,0,0,0.0
2020-02-09,16,0,16,0,0,0,0,0.0
2020-02-10,151,56,95,0,56,0,0,0.0
2020-02-11,189,92,97,0,92,0,0,0.0
2020-02-12,206,107,99,0,107,0,0,0.0
2020-02-13,233,129,104,0,129,0,0,0.0
2020-02-14,190,137,53,0,137,0,0,0.0
2020-02-16,0,0,0,0,0,0,0,0.0
2020-02-17,165,142,23,0,142,0,0,0.0
2020-02-18,204,104,100,0,104,0,0,0.0
2020-02-19,267,154,113,0,154,0,0,0.0
2020-02-20,183,82,101,1,81,1,1,4.745714285713632
2020-02-21,194,102,92,1,101,1,0,-5.4371428571433285
2020-02-23,10,0,10,0,0,0,0,0.0
2020-02-24,251,152,99,0,152,0,0,0.0
2020-02-25,200,92,108,1,91,1,1,5.105714285714214
2020-02-26,182,77,105,1,76,1,0,-3.5042857142859702
2020-02-27,193,87,106,1,86,1,0,-6.337142857143363
2020-02-28,169,101,68,1,100,1,0,-5.4371428571433285
2020-03-01,3,0,3,0,0,0,0,0.0
2020-03-02,179,82,97,1,81,1,1,9.160000000000935
2020-03-03,198,88,110,1,87,1,0,-5.055714285714885
2020-03-04,204,100,104,0,100,0,0,0.0
2020-03-05,238,132,106,0,132,0,0,0.0
2020-03-06,144,53,91,1,52,1,1,8.568571428571204
2020-03-08,27,12,15,0,12,0,0,0.0
2020-03-09,174,63,111,1,62,1,0,-11.514285714286132
2020-03-10,172,71,101,1,70,1,1,18.759999999999877
2020-03-11,136,38,98,1,37,1,0,-10.314285714286086
2020-03-12,189,98,91,1,97,1,0,-7.395714285714405
2020-03-13,172,80,92,1,79,1,0,-10.44285714285752
2020-03-15,13,12,1,0,12,0,0,0.0
2020-03-16,188,151,37,0,151,0,0,0.0
2020-03-17,221,118,103,0,118,0,0,0.0
2020-03-18,219,129,90,0,129,0,0,0.0
2020-03-19,233,125,108,0,125,0,0,0.0
2020-03-20,217,124,93,0,124,0,0,0.0
2020-03-22,4,0,4,0,0,0,0,0.0
2020-03-23,231,128,103,1,127,1,0,-13.605714285714498
2020-03-24,248,146,102,0,146,0,0,0.0
2020-03-25,223,135,88,0,135,0,0,0.0
2020-03-26,194,83,111,0,83,0,0,0.0
2020-03-27,210,114,96,0,114,0,0,0.0
2020-03-29,22,12,10,0,12,0,0,0.0
2020-03-30,156,70,86,0,70,0,0,0.0
2020-03-31,242,132,110,0,132,0,0,0.0
2020-04-01,239,139,100,0,139,0,0,0.0
2020-04-02,223,115,108,0,115,0,0,0.0
2020-04-03,120,92,28,0,92,0,0,0.0
2020-04-05,21,10,11,0,10,0,0,0.0
2020-04-06,205,92,113,0,92,0,0,0.0
2020-04-07,235,125,110,0,125,0,0,0.0
2020-04-08,184,90,94,0,90,0,0,0.0
2020-04-09,254,141,113,0,141,0,0,0.0
2020-04-10,199,111,88,0,111,0,0,0.0
2020-04-12,11,10,1,0,10,0,0,0.0
2020-04-13,214,113,101,0,113,0,0,0.0
2020-04-14,240,150,90,0,150,0,0,0.0
2020-04-15,224,119,105,0,119,0,0,0.0
2020-04-16,229,130,99,0,130,0,0,0.0
2020-04-17,203,107,96,0,107,0,0,0.0
2020-04-19,19,3,16,0,3,0,0,0.0
2020-04-20,231,127,104,0,127,0,0,0.0
2020-04-21,153,56,97,0,56,0,0,0.0
2020-04-22,146,54,92,0,54,0,0,0.0
2020-04-23,86,33,53,0,33,0,0,0.0
2020-04-24,211,117,94,0,117,0,0,0.0
2020-04-26,9,2,7,0,2,0,0,0.0
2020-04-27,244,147,97,0,147,0,0,0.0
2020-04-28,261,148,113,0,148,0,0,0.0
2020-04-29,161,65,96,0,65,0,0,0.0
2020-04-30,220,118,102,0,118,0,0,0.0
2020-05-01,174,134,40,0,134,0,0,0.0
2020-05-03,17,11,6,0,11,0,0,0.0
2020-05-04,227,115,112,0,115,0,0,0.0
2020-05-05,212,113,99,0,113,0,0,0.0
2020-05-06,206,97,109,0,97,0,0,0.0
2020-05-07,246,145,101,0,145,0,0,0.0
2020-05-08,130,49,81,0,49,0,0,0.0
2020-05-10,16,6,10,0,6,0,0,0.0
2020-05-11,223,142,81,0,142,0,0,0.0
2020-05-12,229,119,110,0,119,0,0,0.0
2020-05-13,150,55,95,0,55,0,0,0.0
2020-05-14,240,138,102,0,138,0,0,0.0
2020-05-15,195,121,74,0,121,0,0,0.0
2020-05-17,18,12,6,0,12,0,0,0.0
2020-05-18,130,104,26,0,104,0,0,0.0
2020-05-19,230,117,113,0,117,0,0,0.0
2020-05-20,162,108,54,0,108,0,0,0.0
2020-05-21,153,69,84,0,69,0,0,0.0
2020-05-22,142,62,80,0,62,0,0,0.0
2020-05-24,10,0,10,0,0,0,0,0.0
2020-05-25,160,100,60,0,100,0,0,0.0
2020-05-26,168,65,103,0,65,0,0,0.0
2020-05-27,210,134,76,0,134,0,0,0.0
2020-05-28,241,142,99,0,142,0,0,0.0
2020-05-29,201,111,90,0,111,0,0,0.0
2020-05-31,21,12,9,0,12,0,0,0.0
2020-06-01,242,141,101,0,141,0,0,0.0
2020-06-02,224,126,98,0,126,0,0,0.0
2020-06-03,236,127,109,0,127,0,0,0.0
2020-06-04,232,141,91,0,141,0,0,0.0
2020-06-05,159,97,62,0,97,0,0,0.0
2020-06-07,6,4,2,0,4,0,0,0.0
2020-06-08,249,141,108,0,141,0,0,0.0
2020-06-09,254,143,111,0,143,0,0,0.0
2020-06-10,245,141,104,0,141,0,0,0.0
2020-06-11,175,96,79,0,96,0,0,0.0
2020-06-12,178,98,80,0,98,0,0,0.0
2020-06-14,5,1,4,0,1,0,0,0.0
2020-06-15,221,120,101,0,120,0,0,0.0
2020-06-16,196,111,85,0,111,0,0,0.0
2020-06-17,191,94,97,0,94,0,0,0.0
2020-06-18,219,113,106,0,113,0,0,0.0
2020-06-19,145,60,85,0,60,0,0,0.0
2020-06-21,14,12,2,0,12,0,0,0.0
2020-06-22,187,89,98,0,89,0,0,0.0
2020-06-23,168,57,111,0,57,0,0,0.0
2020-06-24,203,113,90,0,113,0,0,0.0
2020-06-25,204,145,59,0,145,0,0,0.0
2020-06-26,217,136,81,0,136,0,0,0.0
2020-06-28,12,10,2,0,10,0,0,0.0
2020-06-29,187,132,55,0,132,0,0,0.0
2020-06-30,230,130,100,0,130,0,0,0.0
2020-07-01,137,36,101,0,36,0,0,0.0
2020-07-02,187,117,70,0,117,0,0,0.0
2020-07-03,147,101,46,0,101,0,0,0.0
2020-07-05,19,12,7,0,12,0,0,0.0
2020-07-06,211,106,105,0,106,0,0,0.0
2020-07-07,240,144,96,0,144,0,0,0.0
2020-07-08,247,151,96,0,151,0,0,0.0
2020-07-09,192,104,88,0,104,0,0,0.0
2020-07-10,197,101,96,0,101,0,0,0.0
2020-07-12,25,12,13,0,12,0,0,0.0
2020-07-13,178,94,84,0,94,0,0,0.0
2020-07-14,240,151,89,0,151,0,0,0.0
2020-07-15,198,137,61,0,137,0,0,0.0
2020-07-16,228,135,93,0,135,0,0,0.0
2020-07-17,201,111,90,0,111,0,0,0.0
2020-07-19,11,10,1,0,10,0,0,0.0
2020-07-20,237,131,106,0,131,0,0,0.0
2020-07-21,251,142,109,0,142,0,0,0.0
2020-07-22,202,134,68,0,134,0,0,0.0
2020-07-23,181,114,67,0,114,0,0,0.0
2020-07-24,169,73,96,0,73,0,0,0.0
2020-07-26,3,0,3,0,0,0,0,0.0
2020-07-27,195,106,89,0,106,0,0,0.0
2020-07-28,205,111,94,0,111,0,0,0.0
2020-07-29,192,107,85,0,107,0,0,0.0
2020-07-30,221,109,112,0,109,0,0,0.0
2020-07-31,221,125,96,0,125,0,0,0.0
2020-08-02,16,12,4,0,12,0,0,0.0
2020-08-03,219,133,86,0,133,0,0,0.0
2020-08-04,237,129,108,0,129,0,0,0.0
2020-08-05,176,77,99,0,77,0,0,0.0
2020-08-06,181,83,98,0,83,0,0,0.0
2020-08-07,200,106,94,0,106,0,0,0.0
2020-08-09,17,11,6,0,11,0,0,0.0
2020-08-10,183,82,101,0,82,0,0,0.0
2020-08-11,237,133,104,0,133,0,0,0.0
2020-08-12,233,134,99,0,134,0,0,0.0
2020-08-13,213,102,111,0,102,0,0,0.0
2020-08-14,192,115,77,0,115,0,0,0.0
2020-08-16,20,11,9,0,11,0,0,0.0
2020-08-17,238,146,92,0,146,0,0,0.0
2020-08-18,138,30,108,0,30,0,0,0.0
2020-08-19,243,139,104,0,139,0,0,0.0
2020-08-20,223,126,97,0,126,0,0,0.0
2020-08-21,233,137,96,0,137,0,0,0.0
2020-08-23,10,5,5,0,5,0,0,0.0
2020-08-24,170,140,30,0,140,0,0,0.0
2020-08-25,174,81,93,0,81,0,0,0.0
2020-08-26,217,115,102,0,115,0,0,0.0
2020-08-27,184,101,83,0,101,0,0,0.0
2020-08-28,189,93,96,0,93,0,0,0.0
2020-08-30,3,3,0,0,3,0,0,0.0
2020-08-31,161,134,27,0,134,0,0,0.0
2020-09-01,192,85,107,0,85,0,0,0.0
2020-09-02,135,25,110,0,25,0,0,0.0
2020-09-03,245,136,109,0,136,0,0,0.0
2020-09-04,161,93,68,0,93,0,0,0.0
2020-09-06,26,12,14,0,12,0,0,0.0
2020-09-07,241,140,101,0,140,0,0,0.0
2020-09-08,204,108,96,0,108,0,0,0.0
2020-09-09,92,72,20,0,72,0,0,0.0
2020-09-10,220,128,92,0,128,0,0,0.0
2020-09-11,131,87,44,0,87,0,0,0.0
2020-09-13,24,12,12,0,12,0,0,0.0
2020-09-14,192,97,95,0,97,0,0,0.0
2020-09-15,219,121,98,0,121,0,0,0.0
2020-09-16,206,93,113,0,93,0,0,0.0
2020-09-17,222,114,108,0,114,0,0,0.0
2020-09-18,194,101,93,0,101,0,0,0.0
2020-09-20,12,12,0,0,12,0,0,0.0
2020-09-21,89,2,87,0,2,0,0,0.0
2020-09-22,243,142,101,0,142,0,0,0.0
2020-09-23,213,115,98,0,115,0,0,0.0
2020-09-24,170,64,106,0,64,0,0,0.0
2020-09-25,216,131,85,0,131,0,0,0.0
2020-09-27,21,12,9,0,12,0,0,0.0
2020-09-28,208,102,106,0,102,0,0,0.0
2020-09-29,139,45,94,0,45,0,0,0.0
2020-09-30,241,141,100,0,141,0,0,0.0
2020-10-01,211,120,91,0,120,0,0,0.0
2020-10-02,184,100,84,0,100,0,0,0.0
2020-10-04,16,4,12,0,4,0,0,0.0
2020-10-05,210,108,102,0,108,0,0,0.0
2020-10-06,202,104,98,0,104,0,0,0.0
2020-10-07,220,131,89,0,131,0,0,0.0
2020-10-08,173,95,78,0,95,0,0,0.0
2020-10-09,202,106,96,0,106,0,0,0.0
2020-10-11,28,11,17,0,11,0,0,0.0
2020-10-12,182,76,106,0,76,0,0,0.0
2020-10-13,179,86,93,0,86,0,0,0.0
2020-10-14,230,132,98,0,132,0,0,0.0
2020-10-15,227,118,109,0,118,0,0,0.0
2020-10-16,194,98,96,0,98,0,0,0.0
2020-10-18,11,0,11,0,0,0,0,0.0
2020-10-19,195,131,64,0,131,0,0,0.0
2020-10-20,249,149,100,0,149,0,0,0.0
2020-10-21,238,131,107,0,131,0,0,0.0
2020-10-22,255,149,106,0,149,0,0,0.0
2020-10-23,141,46,95,0,46,0,0,0.0
2020-10-25,29,12,17,0,12,0,0,0.0
2020-10-26,233,131,102,0,131,0,0,0.0
2020-10-27,245,146,99,0,146,0,0,0.0
2020-10-28,193,97,96,0,97,0,0,0.0
2020-10-29,237,137,100,0,137,0,0,0.0
2020-10-30,185,89,96,0,89,0,0,0.0
2020-11-01,8,0,8,0,0,0,0,0.0
2020-11-02,237,141,96,0,141,0,0,0.0
2020-11-03,185,147,38,0,147,0,0,0.0
2020-11-04,235,136,99,0,136,0,0,0.0
2020-11-05,195,82,113,0,82,0,0,0.0
2020-11-06,158,85,73,0,85,0,0,0.0
2020-11-08,5,0,5,0,0,0,0,0.0
2020-11-09,236,145,91,0,145,0,0,0.0
2020-11-10,160,64,96,0,64,0,0,0.0
2020-11-11,174,81,93,0,81,0,0,0.0
2020-11-12,232,129,103,0,129,0,0,0.0
2020-11-13,229,133,96,0,133,0,0,0.0
2020-11-15,0,0,0,0,0,0,0,0.0
2020-11-16,221,143,78,0,143,0,0,0.0
2020-11-17,169,69,100,0,69,0,0,0.0
2020-11-18,203,99,104,0,99,0,0,0.0
2020-11-19,196,128,68,0,128,0,0,0.0
2020-11-20,157,68,89,0,68,0,0,0.0
2020-11-22,15,0,15,0,0,0,0,0.0
2020-11-23,173,128,45,0,128,0,0,0.0
2020-11-24,196,106,90,0,106,0,0,0.0
2020-11-25,170,70,100,0,70,0,0,0.0
2020-11-26,200,95,105,0,95,0,0,0.0
2020-11-27,222,126,96,0,126,0,0,0.0
2020-11-29,9,0,9,0,0,0,0,0.0
2020-11-30,228,126,102,0,126,0,0,0.0
2020-12-01,191,86,105,0,86,0,0,0.0
2020-12-02,235,128,107,0,128,0,0,0.0
2020-12-03,206,110,96,0,110,0,0,0.0
2020-12-04,166,112,54,0,112,0,0,0.0
2020-12-06,13,0,13,0,0,0,0,0.0
2020-12-07,172,111,61,0,111,0,0,0.0
2020-12-08,146,59,87,0,59,0,0,0.0
2020-12-09,251,148,103,0,148,0,0,0.0
2020-12-10,212,112,100,0,112,0,0,0.0
2020-12-11,218,122,96,0,122,0,0,0.0
2020-12-13,0,0,0,0,0,0,0,0.0
2020-12-14,182,148,34,0,148,0,0,0.0
2020-12-15,211,131,80,0,131,0,0,0.0
2020-12-16,231,126,105,0,126,0,0,0.0
2020-12-17,188,87,101,0,87,0,0,0.0
2020-12-18,167,71,96,0,71,0,0,0.0
2020-12-20,0,0,0,0,0,0,0,0.0
2020-12-21,138,122,16,0,122,0,0,0.0
2020-12-22,218,111,107,0,111,0,0,0.0
2020-12-23,163,55,108,0,55,0,0,0.0
2020-12-24,200,111,89,0,111,0,0,0.0
2020-12-25,54,0,54,0,0,0,0,0.0
2020-12-27,17,0,17,0,0,0,0,0.0
2020-12-28,209,131,78,0,131,0,0,0.0
2020-12-29,205,102,103,0,102,0,0,0.0
2020-12-30,237,145,92,0,145,0,0,0.0
2020-12-31,131,131,0,0,131,0,0,0.0
2021-01-03,9,0,9,0,0,0,0,0.0
2021-01-04,227,125,102,0,125,0,0,0.0
2021-01-05,243,138,105,0,138,0,0,0.0
2021-01-06,217,131,86,0,131,0,0,0.0
2021-01-07,233,141,92,0,141,0,0,0.0
2021-01-08,148,78,70,0,78,0,0,0.0
2021-01-10,14,0,14,0,0,0,0,0.0
2021-01-11,198,96,102,0,96,0,0,0.0
2021-01-12,180,105,75,0,105,0,0,0.0
2021-01-13,174,72,102,0,72,0,0,0.0
2021-01-14,199,100,99,0,100,0,0,0.0
2021-01-15,155,120,35,0,120,0,0,0.0
2021-01-17,5,0,5,0,0,0,0,0.0
2021-01-18,219,116,103,0,116,0,0,0.0
2021-01-19,126,30,96,0,30,0,0,0.0
2021-01-20,234,134,100,0,134,0,0,0.0
2021-01-21,204,110,94,0,110,0,0,0.0
2021-01-22,149,54,95,0,54,0,0,0.0
2021-01-24,1,0,1,0,0,0,0,0.0
2021-01-25,181,111,70,0,111,0,0,0.0
2021-01-26,131,63,68,0,63,0,0,0.0
2021-01-27,246,153,93,0,153,0,0,0.0
2021-01-28,214,111,103,0,111,0,0,0.0
2021-01-29,153,57,96,0,57,0,0,0.0
2021-01-31,11,0,11,0,0,0,0,0.0
2021-02-01,180,81,99,0,81,0,0,0.0
2021-02-02,196,114,82,0,114,0,0,0.0
2021-02-03,113,25,88,0,25,0,0,0.0
2021-02-04,250,150,100,0,150,0,0,0.0
2021-02-05,190,134,56,0,134,0,0,0.0
2021-02-07,11,0,11,0,0,0,0,0.0
2021-02-08,255,151,104,0,151,0,0,0.0
2021-02-09,181,72,109,0,72,0,0,0.0
2021-02-10,139,47,92,0,47,0,0,0.0
2021-02-11,155,132,23,0,132,0,0,0.0
2021-02-12,209,121,88,0,121,0,0,0.0
2021-02-14,9,0,9,0,0,0,0,0.0
2021-02-15,208,105,103,0,105,0,0,0.0
2021-02-16,261,149,112,0,149,0,0,0.0
2021-02-17,197,102,95,0,102,0,0,0.0
2021-02-18,175,86,89,0,86,0,0,0.0
2021-02-19,235,146,89,0,146,0,0,0.0
2021-02-21,14,0,14,0,0,0,0,0.0
2021-02-22,244,145,99,0,145,0,0,0.0
2021-02-23,218,122,96,0,122,0,0,0.0
2021-02-24,219,107,112,0,107,0,0,0.0
2021-02-25,218,113,105,0,113,0,0,0.0
2021-02-26,230,146,84,0,146,0,0,0.0
2021-02-28,6,0,6,0,0,0,0,0.0
2021-03-01,233,142,91,0,142,0,0,0.0
2021-03-02,236,132,104,0,132,0,0,0.0
2021-03-03,223,114,109,0,114,0,0,0.0
2021-03-04,243,136,107,0,136,0,0,0.0
2021-03-05,166,77,89,0,77,0,0,0.0
2021-03-07,13,0,13,0,0,0,0,0.0
2021-03-08,234,146,88,0,146,0,0,0.0
2021-03-09,223,113,110,0,113,0,0,0.0
2021-03-10,176,68,108,0,68,0,0,0.0
2021-03-11,192,88,104,0,88,0,0,0.0
2021-03-12,149,53,96,0,53,0,0,0.0
2021-03-14,18,4,14,0,4,0,0,0.0
2021-03-15,201,115,86,0,115,0,0,0.0
2021-03-16,174,74,100,0,74,0,0,0.0
2021-03-17,252,144,108,0,144,0,0,0.0
2021-03-18,232,142,90,0,142,0,0,0.0
2021-03-19,153,60,93,0,60,0,0,0.0
2021-03-21,12,12,0,0,12,0,0,0.0
2021-03-22,78,65,13,0,65,0,0,0.0
2021-03-23,218,116,102,0,116,0,0,0.0
2021-03-24,125,23,102,0,23,0,0,0.0
2021-03-25,211,104,107,0,104,0,0,0.0
2021-03-26,225,129,96,0,129,0,0,0.0
2021-03-28,28,12,16,0,12,0,0,0.0
2021-03-29,224,129,95,0,129,0,0,0.0
2021-03-30,165,56,109,0,56,0,0,0.0
2021-03-31,197,91,106,0,91,0,0,0.0
2021-04-01,159,79,80,0,79,0,0,0.0
2021-04-02,126,37,89,0,37,0,0,0.0
2021-04-04,12,0,12,0,0,0,0,0.0
2021-04-05,183,125,58,0,125,0,0,0.0
2021-04-06,133,39,94,0,39,0,0,0.0
2021-04-07,159,71,88,0,71,0,0,0.0
2021-04-08,238,142,96,0,142,0,0,0.0
2021-04-09,183,137,46,0,137,0,0,0.0
2021-04-11,26,11,15,0,11,0,0,0.0
2021-04-12,217,115,102,0,115,0,0,0.0
2021-04-13,214,109,105,0,109,0,0,0.0
2021-04-14,175,73,102,0,73,0,0,0.0
2021-04-15,185,82,103,0,82,0,0,0.0
2021-04-16,222,128,94,0,128,0,0,0.0
2021-04-18,28,12,16,0,12,0,0,0.0
2021-04-19,142,40,102,0,40,0,0,0.0
2021-04-20,231,136,95,0,136,0,0,0.0
2021-04-21,238,128,110,0,128,0,0,0.0
2021-04-22,217,108,109,0,108,0,0,0.0
2021-04-23,196,120,76,0,120,0,0,0.0
2021-04-25,13,12,1,0,12,0,0,0.0
2021-04-26,218,122,96,0,122,0,0,0.0
2021-04-27,237,139,98,0,139,0,0,0.0
2021-04-28,213,100,113,0,100,0,0,0.0
2021-04-29,188,88,100,0,88,0,0,0.0
2021-04-30,216,120,96,0,120,0,0,0.0
2021-05-02,13,12,1,0,12,0,0,0.0
2021-05-03,258,150,108,0,150,0,0,0.0
2021-05-04,248,140,108,0,140,0,0,0.0
2021-05-05,111,8,103,0,8,0,0,0.0
2021-05-06,262,154,108,0,154,0,0,0.0
2021-05-07,110,20,90,0,20,0,0,0.0
2021-05-09,0,0,0,0,0,0,0,0.0
2021-05-10,203,106,97,0,106,0,0,0.0
2021-05-11,218,118,100,0,118,0,0,0.0
2021-05-12,244,146,98,0,146,0,0,0.0
2021-05-13,151,73,78,0,73,0,0,0.0
2021-05-14,148,52,96,0,52,0,0,0.0
2021-05-16,18,12,6,0,12,0,0,0.0
2021-05-17,116,75,41,0,75,0,0,0.0
2021-05-18,148,55,93,0,55,0,0,0.0
2021-05-19,228,121,107,0,121,0,0,0.0
2021-05-20,204,91,113,0,91,0,0,0.0
2021-05-21,211,117,94,0,117,0,0,0.0
2021-05-23,13,12,1,0,12,0,0,0.0
2021-05-24,136,59,77,0,59,0,0,0.0
2021-05-25,223,133,90,0,133,0,0,0.0
2021-05-26,215,140,75,0,140,0,0,0.0
2021-05-27,258,150,108,0,150,0,0,0.0
2021-05-28,219,124,95,0,124,0,0,0.0
2021-05-30,22,12,10,0,12,0,0,0.0
2021-05-31,225,114,111,0,114,0,0,0.0
2021-06-01,215,113,102,0,113,0,0,0.0
2021-06-02,240,129,111,0,129,0,0,0.0
2021-06-03,238,127,111,0,127,0,0,0.0
2021-06-04,228,132,96,0,132,0,0,0.0
2021-06-06,29,12,17,0,12,0,0,0.0
2021-06-07,94,26,68,0,26,0,0,0.0
2021-06-08,249,144,105,0,144,0,0,0.0
2021-06-09,212,112,100,0,112,0,0,0.0
2021-06-10,239,144,95,0,144,0,0,0.0
2021-06-11,159,95,64,0,95,0,0,0.0
2021-06-13,2,0,2,0,0,0,0,0.0
2021-06-14,215,127,88,0,127,0,0,0.0
2021-06-15,159,62,97,0,62,0,0,0.0
2021-06-16,210,111,99,0,111,0,0,0.0
2021-06-17,211,141,70,0,141,0,0,0.0
2021-06-18,199,109,90,0,109,0,0,0.0
2021-06-20,12,12,0,0,12,0,0,0.0
2021-06-21,207,109,98,0,109,0,0,0.0
2021-06-22,173,74,99,0,74,0,0,0.0
2021-06-23,237,134,103,0,134,0,0,0.0
2021-06-24,218,124,94,0,124,0,0,0.0
2021-06-25,213,132,81,0,132,0,0,0.0
2021-06-27,12,12,0,0,12,0,0,0.0
2021-06-28,217,126,91,0,126,0,0,0.0
2021-06-29,238,145,93,0,145,0,0,0.0
2021-06-30,204,110,94,0,110,0,0,0.0
2021-07-01,239,145,94,0,145,0,0,0.0
2021-07-02,160,64,96,0,64,0,0,0.0
2021-07-04,26,12,14,0,12,0,0,0.0
2021-07-05,146,82,64,0,82,0,0,0.0
2021-07-06,228,127,101,0,127,0,0,0.0
2021-07-07,137,33,104,0,33,0,0,0.0
2021-07-08,243,131,112,0,131,0,0,0.0
2021-07-09,231,135,96,0,135,0,0,0.0
2021-07-11,12,12,0,0,12,0,0,0.0
2021-07-12,157,133,24,0,133,0,0,0.0
2021-07-13,214,120,94,0,120,0,0,0.0
2021-07-14,225,113,112,0,113,0,0,0.0
2021-07-15,195,91,104,0,91,0,0,0.0
2021-07-16,219,127,92,0,127,0,0,0.0
2021-07-18,26,12,14,0,12,0,0,0.0
2021-07-19,164,56,108,0,56,0,0,0.0
2021-07-20,244,149,95,0,149,0,0,0.0
2021-07-21,112,21,91,0,21,0,0,0.0
2021-07-22,173,70,103,0,70,0,0,0.0
2021-07-23,160,69,91,0,69,0,0,0.0
2021-07-25,2,0,2,0,0,0,0,0.0
2021-07-26,169,63,106,0,63,0,0,0.0
2021-07-27,219,112,107,0,112,0,0,0.0
2021-07-28,234,129,105,0,129,0,0,0.0
2021-07-29,214,104,110,0,104,0,0,0.0
2021-07-30,173,77,96,0,77,0,0,0.0
2021-08-01,16,12,4,0,12,0,0,0.0
2021-08-02,168,137,31,0,137,0,0,0.0
2021-08-03,241,131,110,0,131,0,0,0.0
2021-08-04,194,124,70,0,124,0,0,0.0
2021-08-05,238,135,103,0,135,0,0,0.0
2021-08-06,218,124,94,0,124,0,0,0.0
2021-08-08,11,4,7,0,4,0,0,0.0
2021-08-09,214,135,79,0,135,0,0,0.0
2021-08-10,147,76,71,0,76,0,0,0.0
2021-08-11,157,48,109,0,48,0,0,0.0
2021-08-12,243,134,109,0,134,0,0,0.0
2021-08-13,191,108,83,0,108,0,0,0.0
2021-08-15,12,12,0,0,12,0,0,0.0
2021-08-16,126,14,112,0,14,0,0,0.0
2021-08-17,202,101,101,0,101,0,0,0.0
2021-08-18,206,116,90,0,116,0,0,0.0
2021-08-19,108,6,102,0,6,0,0,0.0
2021-08-20,128,40,88,0,40,0,0,0.0
2021-08-22,27,11,16,0,11,0,0,0.0
2021-08-23,211,104,107,0,104,0,0,0.0
2021-08-24,142,39,103,0,39,0,0,0.0
2021-08-25,219,118,101,0,118,0,0,0.0
2021-08-26,225,132,93,0,132,0,0,0.0
2021-08-27,212,116,96,0,116,0,0,0.0
2021-08-29,18,12,6,0,12,0,0,0.0
2021-08-30,180,99,81,0,99,0,0,0.0
2021-08-31,245,146,99,0,146,0,0,0.0
2021-09-01,175,70,105,0,70,0,0,0.0
2021-09-02,207,103,104,0,103,0,0,0.0
2021-09-03,151,56,95,0,56,0,0,0.0
2021-09-05,4,0,4,0,0,0,0,0.0
2021-09-06,165,62,103,0,62,0,0,0.0
2021-09-07,216,107,109,0,107,0,0,0.0
2021-09-08,143,55,88,0,55,0,0,0.0
2021-09-09,196,99,97,0,99,0,0,0.0
2021-09-10,127,57,70,0,57,0,0,0.0
2021-09-12,9,7,2,0,7,0,0,0.0
2021-09-13,150,51,99,0,51,0,0,0.0
2021-09-14,231,137,94,0,137,0,0,0.0
2021-09-15,191,83,108,0,83,0,0,0.0
2021-09-16,170,73,97,0,73,0,0,0.0
2021-09-17,192,98,94,0,98,0,0,0.0
2021-09-19,13,12,1,0,12,0,0,0.0
2021-09-20,219,126,93,0,126,0,0,0.0
2021-09-21,199,91,108,0,91,0,0,0.0
2021-09-22,203,104,99,0,104,0,0,0.0
2021-09-23,232,136,96,0,136,0,0,0.0
2021-09-24,201,105,96,0,105,0,0,0.0
2021-09-26,10,10,0,0,10,0,0,0.0
2021-09-27,218,131,87,0,131,0,0,0.0
2021-09-28,204,92,112,0,92,0,0,0.0
2021-09-29,245,137,108,0,137,0,0,0.0
2021-09-30,242,135,107,0,135,0,0,0.0
2021-10-01,144,54,90,0,54,0,0,0.0
2021-10-03,12,12,0,0,12,0,0,0.0
2021-10-04,216,145,71,0,145,0,0,0.0
2021-10-05,237,146,91,0,146,0,0,0.0
2021-10-06,200,89,111,0,89,0,0,0.0
2021-10-07,230,119,111,0,119,0,0,0.0
2021-10-08,234,138,96,0,138,0,0,0.0
2021-10-10,14,12,2,0,12,0,0,0.0
2021-10-11,218,128,90,0,128,0,0,0.0
2021-10-12,128,32,96,0,32,0,0,0.0
2021-10-13,184,73,111,0,73,0,0,0.0
2021-10-14,224,119,105,0,119,0,0,0.0
2021-10-15,233,137,96,0,137,0,0,0.0
2021-10-17,12,12,0,0,12,0,0,0.0
2021-10-18,92,43,49,0,43,0,0,0.0
2021-10-19,219,115,104,0,115,0,0,0.0
2021-10-20,144,46,98,0,46,0,0,0.0
2021-10-21,147,49,98,0,49,0,0,0.0
2021-10-22,218,123,95,0,123,0,0,0.0
2021-10-24,23,12,11,0,12,0,0,0.0
2021-10-25,136,36,100,0,36,0,0,0.0
2021-10-26,149,53,96,0,53,0,0,0.0
2021-10-27,213,111,102,0,111,0,0,0.0
2021-10-28,147,56,91,0,56,0,0,0.0
2021-10-29,186,92,94,0,92,0,0,0.0
2021-10-31,18,12,6,0,12,0,0,0.0
2021-11-01,220,131,89,0,131,0,0,0.0
2021-11-02,218,128,90,0,128,0,0,0.0
2021-11-03,225,121,104,0,121,0,0,0.0
2021-11-04,247,150,97,0,150,0,0,0.0
2021-11-05,195,108,87,0,108,0,0,0.0
2021-11-07,15,0,15,0,0,0,0,0.0
2021-11-08,256,148,108,0,148,0,0,0.0
2021-11-09,235,129,106,0,129,0,0,0.0
2021-11-10,222,137,85,0,137,0,0,0.0
2021-11-11,202,102,100,0,102,0,0,0.0
2021-11-12,211,115,96,0,115,0,0,0.0
2021-11-14,13,0,13,0,0,0,0,0.0
2021-11-15,232,138,94,0,138,0,0,0.0
2021-11-16,239,126,113,0,126,0,0,0.0
2021-11-17,229,130,99,0,130,0,0,0.0
2021-11-18,105,42,63,0,42,0,0,0.0
2021-11-19,216,120,96,0,120,0,0,0.0
2021-11-21,12,0,12,0,0,0,0,0.0
2021-11-22,211,111,100,0,111,0,0,0.0
2021-11-23,180,79,101,0,79,0,0,0.0
2021-11-24,239,149,90,0,149,0,0,0.0
2021-11-25,130,89,41,0,89,0,0,0.0
2021-11-26,202,106,96,0,106,0,0,0.0
2021-11-28,10,0,10,0,0,0,0,0.0
2021-11-29,137,81,56,0,81,0,0,0.0
2021-11-30,238,129,109,0,129,0,0,0.0
2021-12-01,224,115,109,0,115,0,0,0.0
2021-12-02,240,128,112,0,128,0,0,0.0
2021-12-03,207,133,74,0,133,0,0,0.0
2021-12-05,13,0,13,0,0,0,0,0.0
2021-12-06,244,133,111,0,133,0,0,0.0
2021-12-07,162,59,103,0,59,0,0,0.0
2021-12-08,180,96,84,0,96,0,0,0.0
2021-12-09,222,115,107,0,115,0,0,0.0
2021-12-10,243,148,95,0,148,0,0,0.0
2021-12-12,17,0,17,0,0,0,0,0.0
2021-12-13,232,135,97,0,135,0,0,0.0
2021-12-14,223,141,82,0,141,0,0,0.0
2021-12-15,194,101,93,0,101,0,0,0.0
2021-12-16,236,131,105,0,131,0,0,0.0
2021-12-17,237,147,90,0,147,0,0,0.0
2021-12-19,6,0,6,0,0,0,0,0.0
2021-12-20,205,119,86,0,119,0,0,0.0
2021-12-21,230,134,96,0,134,0,0,0.0
2021-12-22,143,78,65,0,78,0,0,0.0
2021-12-23,198,91,107,0,91,0,0,0.0
2021-12-24,213,117,96,0,117,0,0,0.0
2021-12-26,1,0,1,0,0,0,0,0.0
2021-12-27,213,147,66,0,147,0,0,0.0
2021-12-28,161,85,76,0,85,0,0,0.0
2021-12-29,162,63,99,0,63,0,0,0.0
2021-12-30,168,60,108,0,60,0,0,0.0
2021-12-31,195,114,81,0,114,0,0,0.0
2022-01-02,13,0,13,0,0,0,0,0.0
2022-01-03,248,147,101,0,147,0,0,0.0
2022-01-04,251,141,110,0,141,0,0,0.0
2022-01-05,233,120,113,0,120,0,0,0.0
2022-01-06,181,70,111,0,70,0,0,0.0
2022-01-07,198,102,96,0,102,0,0,0.0
2022-01-09,6,0,6,0,0,0,0,0.0
2022-01-10,226,123,103,0,123,0,0,0.0
2022-01-11,249,140,109,0,140,0,0,0.0
2022-01-12,242,135,107,0,135,0,0,0.0
2022-01-13,234,138,96,0,138,0,0,0.0
2022-01-14,236,140,96,0,140,0,0,0.0
2022-01-16,16,0,16,0,0,0,0,0.0
2022-01-17,211,105,106,0,105,0,0,0.0
2022-01-18,154,56,98,0,56,0,0,0.0
2022-01-19,248,138,110,0,138,0,0,0.0
2022-01-20,231,124,107,0,124,0,0,0.0
2022-01-21,217,121,96,0,121,0,0,0.0
2022-01-23,14,0,14,0,0,0,0,0.0
2022-01-24,203,91,112,0,91,0,0,0.0
2022-01-25,254,147,107,0,147,0,0,0.0
2022-01-26,235,139,96,0,139,0,0,0.0
2022-01-27,207,106,101,0,106,0,0,0.0
2022-01-28,195,101,94,0,101,0,0,0.0
2022-01-30,7,0,7,0,0,0,0,0.0
2022-01-31,230,121,109,0,121,0,0,0.0
2022-02-01,192,80,112,0,80,0,0,0.0
2022-02-02,229,120,109,0,120,0,0,0.0
2022-02-03,198,110,88,0,110,0,0,0.0
2022-02-04,143,53,90,0,53,0,0,0.0
2022-02-06,2,0,2,0,0,0,0,0.0
2022-02-07,197,141,56,0,141,0,0,0.0
2022-02-08,229,118,111,0,118,0,0,0.0
2022-02-09,199,93,106,0,93,0,0,0.0
2022-02-10,170,67,103,0,67,0,0,0.0
2022-02-11,144,64,80,0,64,0,0,0.0
2022-02-13,15,0,15,0,0,0,0,0.0
2022-02-14,191,125,66,0,125,0,0,0.0
2022-02-15,152,48,104,0,48,0,0,0.0
2022-02-16,209,101,108,0,101,0,0,0.0
2022-02-17,163,60,103,0,60,0,0,0.0
2022-02-18,115,19,96,0,19,0,0,0.0
2022-02-20,17,0,17,0,0,0,0,0.0
2022-02-21,194,89,105,0,89,0,0,0.0
2022-02-22,206,103,103,0,103,0,0,0.0
2022-02-23,168,74,94,0,74,0,0,0.0
2022-02-24,211,104,107,0,104,0,0,0.0
2022-02-25,203,107,96,0,107,0,0,0.0
2022-02-27,0,0,0,0,0,0,0,0.0
2022-02-28,120,103,17,0,103,0,0,0.0
2022-03-01,173,65,108,0,65,0,0,0.0
2022-03-02,230,126,104,0,126,0,0,0.0
2022-03-03,215,110,105,0,110,0,0,0.0
2022-03-04,224,130,94,0,130,0,0,0.0
2022-03-06,2,0,2,0,0,0,0,0.0
2022-03-07,174,120,54,0,120,0,0,0.0
2022-03-08,223,117,106,0,117,0,0,0.0
2022-03-09,188,77,111,0,77,0,0,0.0
2022-03-10,247,138,109,0,138,0,0,0.0
2022-03-11,241,145,96,0,145,0,0,0.0
2022-03-13,20,12,8,0,12,0,0,0.0
2022-03-14,177,90,87,0,90,0,0,0.0
2022-03-15,198,102,96,0,102,0,0,0.0
2022-03-16,200,112,88,0,112,0,0,0.0
2022-03-17,194,134,60,0,134,0,0,0.0
2022-03-18,196,101,95,0,101,0,0,0.0
2022-03-20,24,12,12,0,12,0,0,0.0
2022-03-21,147,121,26,0,121,0,0,0.0
2022-03-22,242,133,109,0,133,0,0,0.0
2022-03-23,207,111,96,0,111,0,0,0.0
2022-03-24,205,111,94,0,111,0,0,0.0
2022-03-25,107,11,96,0,11,0,0,0.0
2022-03-27,17,0,17,0,0,0,0,0.0
2022-03-28,186,79,107,0,79,0,0,0.0
2022-03-29,145,41,104,0,41,0,0,0.0
2022-03-30,155,51,104,0,51,0,0,0.0
2022-03-31,169,65,104,0,65,0,0,0.0
2022-04-01,206,110,96,0,110,0,0,0.0
2022-04-03,13,12,1,0,12,0,0,0.0
2022-04-04,126,82,44,0,82,0,0,0.0
2022-04-05,215,114,101,0,114,0,0,0.0
2022-04-06,216,119,97,0,119,0,0,0.0
2022-04-07,145,38,107,0,38,0,0,0.0
2022-04-08,165,80,85,0,80,0,0,0.0
2022-04-10,27,12,15,0,12,0,0,0.0
2022-04-11,213,103,110,0,103,0,0,0.0
2022-04-12,192,94,98,0,94,0,0,0.0
2022-04-13,215,108,107,0,108,0,0,0.0
2022-04-14,241,132,109,0,132,0,0,0.0
2022-04-15,185,89,96,0,89,0,0,0.0
2022-04-17,10,10,0,0,10,0,0,0.0
2022-04-18,142,120,22,0,120,0,0,0.0
2022-04-19,172,77,95,0,77,0,0,0.0
2022-04-20,203,125,78,0,125,0,0,0.0
2022-04-21,165,85,80,0,85,0,0,0.0
2022-04-22,197,106,91,0,106,0,0,0.0
2022-04-24,0,0,0,0,0,0,0,0.0
2022-04-25,124,55,69,0,55,0,0,0.0
2022-04-26,197,115,82,0,115,0,0,0.0
2022-04-27,216,109,107,0,109,0,0,0.0
2022-04-28,214,112,102,0,112,0,0,0.0
2022-04-29,228,132,96,0,132,0,0,0.0
2022-05-01,12,12,0,0,12,0,0,0.0
2022-05-02,179,128,51,0,128,0,0,0.0
2022-05-03,209,130,79,0,130,0,0,0.0
2022-05-04,137,94,43,0,94,0,0,0.0
2022-05-05,180,117,63,0,117,0,0,0.0
2022-05-06,173,77,96,0,77,0,0,0.0
2022-05-08,0,0,0,0,0,0,0,0.0
2022-05-09,223,122,101,0,122,0,0,0.0
2022-05-10,172,100,72,0,100,0,0,0.0
2022-05-11,195,150,45,0,150,0,0,0.0
2022-05-12,174,77,97,0,77,0,0,0.0
2022-05-13,218,128,90,0,128,0,0,0.0
2022-05-15,10,8,2,0,8,0,0,0.0
2022-05-16,119,27,92,0,27,0,0,0.0
2022-05-17,251,142,109,0,142,0,0,0.0
2022-05-18,245,140,105,0,140,0,0,0.0
2022-05-19,220,125,95,0,125,0,0,0.0
2022-05-20,153,75,78,0,75,0,0,0.0
2022-05-22,2,2,0,0,2,0,0,0.0
2022-05-23,178,85,93,0,85,0,0,0.0
2022-05-24,168,65,103,0,65,0,0,0.0
2022-05-25,197,87,110,0,87,0,0,0.0
2022-05-26,198,89,109,0,89,0,0,0.0
2022-05-27,205,115,90,0,115,0,0,0.0
2022-05-29,22,8,14,0,8,0,0,0.0
2022-05-30,234,126,108,0,126,0,0,0.0
2022-05-31,186,74,112,0,74,0,0,0.0
2022-06-01,226,119,107,0,119,0,0,0.0
2022-06-02,249,143,106,0,143,0,0,0.0
2022-06-03,204,129,75,0,129,0,0,0.0
2022-06-05,21,12,9,0,12,0,0,0.0
2022-06-06,230,126,104,0,126,0,0,0.0
2022-06-07,221,113,108,0,113,0,0,0.0
2022-06-08,198,87,111,0,87,0,0,0.0
2022-06-09,201,120,81,0,120,0,0,0.0
2022-06-10,196,100,96,0,100,0,0,0.0
2022-06-12,21,12,9,0,12,0,0,0.0
2022-06-13,202,106,96,0,106,0,0,0.0
2022-06-14,218,119,99,0,119,0,0,0.0
2022-06-15,243,147,96,0,147,0,0,0.0
2022-06-16,236,134,102,0,134,0,0,0.0
2022-06-17,218,122,96,0,122,0,0,0.0
2022-06-19,19,11,8,0,11,0,0,0.0
2022-06-20,143,52,91,0,52,0,0,0.0
2022-06-21,183,106,77,0,106,0,0,0.0
2022-06-22,175,80,95,0,80,0,0,0.0
2022-06-23,154,60,94,0,60,0,0,0.0
2022-06-24,208,119,89,0,119,0,0,0.0
2022-06-26,12,1,11,0,1,0,0,0.0
2022-06-27,180,82,98,0,82,0,0,0.0
2022-06-28,167,68,99,0,68,0,0,0.0
2022-06-29,137,62,75,0,62,0,0,0.0
2022-06-30,162,88,74,0,88,0,0,0.0
2022-07-01,154,58,96,0,58,0,0,0.0
2022-07-03,9,0,9,0,0,0,0,0.0
2022-07-04,207,109,98,0,109,0,0,0.0
2022-07-05,156,46,110,0,46,0,0,0.0
2022-07-06,225,118,107,0,118,0,0,0.0
2022-07-07,212,125,87,0,125,0,0,0.0
2022-07-08,213,126,87,0,126,0,0,0.0
2022-07-10,24,12,12,0,12,0,0,0.0
2022-07-11,251,150,101,0,150,0,0,0.0
2022-07-12,221,117,104,0,117,0,0,0.0
2022-07-13,219,111,108,0,111,0,0,0.0
2022-07-14,224,123,101,0,123,0,0,0.0
2022-07-15,188,114,74,0,114,0,0,0.0
2022-07-17,22,10,12,0,10,0,0,0.0
2022-07-18,259,147,112,0,147,0,0,0.0
2022-07-19,230,128,102,0,128,0,0,0.0
2022-07-20,215,106,109,0,106,0,0,0.0
2022-07-21,257,149,108,0,149,0,0,0.0
2022-07-22,219,136,83,0,136,0,0,0.0
2022-07-24,25,12,13,0,12,0,0,0.0
2022-07-25,208,119,89,0,119,0,0,0.0
2022-07-26,222,117,105,0,117,0,0,0.0
2022-07-27,233,130,103,0,130,0,0,0.0
2022-07-28,175,72,103,0,72,0,0,0.0
2022-07-29,207,135,72,0,135,0,0,0.0
2022-07-31,25,12,13,0,12,0,0,0.0
2022-08-01,215,116,99,0,116,0,0,0.0
2022-08-02,215,110,105,0,110,0,0,0.0
2022-08-03,216,141,75,0,141,0,0,0.0
2022-08-04,243,133,110,0,133,0,0,0.0
2022-08-05,219,126,93,0,126,0,0,0.0
2022-08-07,16,6,10,0,6,0,0,0.0
2022-08-08,173,115,58,0,115,0,0,0.0
2022-08-09,175,71,104,0,71,0,0,0.0
2022-08-10,189,91,98,0,91,0,0,0.0
2022-08-11,213,120,93,0,120,0,0,0.0
2022-08-12,197,101,96,0,101,0,0,0.0
2022-08-14,23,11,12,0,11,0,0,0.0
2022-08-15,235,131,104,0,131,0,0,0.0
2022-08-16,251,147,104,0,147,0,0,0.0
2022-08-17,193,91,102,0,91,0,0,0.0
2022-08-18,226,130,96,0,130,0,0,0.0
2022-08-19,154,58,96,0,58,0,0,0.0
2022-08-21,10,0,10,0,0,0,0,0.0
2022-08-22,248,140,108,0,140,0,0,0.0
2022-08-23,257,145,112,0,145,0,0,0.0
2022-08-24,160,61,99,0,61,0,0,0.0
2022-08-25,200,94,106,0,94,0,0,0.0
2022-08-26,226,130,96,0,130,0,0,0.0
2022-08-28,24,12,12,0,12,0,0,0.0
2022-08-29,248,148,100,0,148,0,0,0.0
2022-08-30,217,110,107,0,110,0,0,0.0
2022-08-31,163,56,107,0,56,0,0,0.0
2022-09-01,220,112,108,0,112,0,0,0.0
2022-09-02,139,51,88,0,51,0,0,0.0
2022-09-04,16,0,16,0,0,0,0,0.0
2022-09-05,148,78,70,0,78,0,0,0.0
2022-09-06,215,122,93,0,122,0,0,0.0
2022-09-07,252,140,112,0,140,0,0,0.0
2022-09-08,118,33,85,0,33,0,0,0.0
2022-09-09,143,48,95,0,48,0,0,0.0
2022-09-11,15,4,11,0,4,0,0,0.0
2022-09-12,162,73,89,0,73,0,0,0.0
2022-09-13,130,48,82,0,48,0,0,0.0
2022-09-14,173,73,100,0,73,0,0,0.0
2022-09-15,147,59,88,0,59,0,0,0.0
2022-09-16,197,124,73,0,124,0,0,0.0
2022-09-18,25,11,14,0,11,0,0,0.0
2022-09-19,188,90,98,0,90,0,0,0.0
2022-09-20,122,18,104,0,18,0,0,0.0
2022-09-21,229,126,103,0,126,0,0,0.0
2022-09-22,216,119,97,1,118,1,1,52.96000000000117
2022-09-23,195,103,92,1,102,1,0,-5.3887109675547435
2022-09-25,20,12,8,0,12,0,0,0.0
2022-09-26,252,144,108,0,144,0,0,0.0
2022-09-27,228,124,104,0,124,0,0,0.0
2022-09-28,224,118,106,0,118,0,0,0.0
2022-09-29,173,77,96,0,77,0,0,0.0
2022-09-30,208,122,86,0,122,0,0,0.0
2022-10-02,25,9,16,0,9,0,0,0.0
2022-10-03,247,141,106,0,141,0,0,0.0
2022-10-04,230,127,103,0,127,0,0,0.0
2022-10-05,168,92,76,0,92,0,0,0.0
2022-10-06,211,146,65,0,146,0,0,0.0
2022-10-07,176,113,63,0,113,0,0,0.0
2022-10-09,14,6,8,0,6,0,0,0.0
2022-10-10,192,105,87,0,105,0,0,0.0
2022-10-11,197,100,97,0,100,0,0,0.0
2022-10-12,239,127,112,0,127,0,0,0.0
2022-10-13,94,47,47,0,47,0,0,0.0
2022-10-14,227,137,90,0,137,0,0,0.0
2022-10-16,17,12,5,0,12,0,0,0.0
2022-10-17,161,107,54,0,107,0,0,0.0
2022-10-18,241,138,103,0,138,0,0,0.0
2022-10-19,204,140,64,0,140,0,0,0.0
2022-10-20,231,124,107,0,124,0,0,0.0
2022-10-21,226,130,96,0,130,0,0,0.0
2022-10-23,25,11,14,0,11,0,0,0.0
2022-10-24,163,137,26,0,137,0,0,0.0
2022-10-25,135,107,28,0,107,0,0,0.0
2022-10-26,157,115,42,0,115,0,0,0.0
2022-10-27,174,84,90,0,84,0,0,0.0
2022-10-28,147,70,77,0,70,0,0,0.0
2022-10-30,9,6,3,0,6,0,0,0.0
2022-10-31,209,101,108,0,101,0,0,0.0
2022-11-01,240,141,99,0,141,0,0,0.0
2022-11-02,176,63,113,0,63,0,0,0.0
2022-11-03,177,76,101,0,76,0,0,0.0
2022-11-04,114,58,56,0,58,0,0,0.0
2022-11-06,0,0,0,0,0,0,0,0.0
2022-11-07,144,77,67,0,77,0,0,0.0
2022-11-08,250,139,111,0,139,0,0,0.0
2022-11-09,186,84,102,0,84,0,0,0.0
2022-11-10,262,149,113,0,149,0,0,0.0
2022-11-11,194,106,88,1,105,1,1,40.29142857142983
2022-11-13,0,0,0,0,0,0,0,0.0
2022-11-14,115,82,33,1,81,1,0,-9.328571428571763
2022-11-15,163,54,109,0,54,0,0,0.0
2022-11-16,152,41,111,0,41,0,0,0.0
2022-11-17,172,80,92,0,80,0,0,0.0
2022-11-18,184,88,96,0,88,0,0,0.0
2022-11-20,14,0,14,0,0,0,0,0.0
2022-11-21,232,137,95,0,137,0,0,0.0
2022-11-22,216,105,111,0,105,0,0,0.0
2022-11-23,234,126,108,0,126,0,0,0.0
2022-11-24,237,128,109,0,128,0,0,0.0
2022-11-25,223,132,91,0,132,0,0,0.0
2022-11-27,10,0,10,0,0,0,0,0.0
2022-11-28,185,84,101,0,84,0,0,0.0
2022-11-29,216,109,107,0,109,0,0,0.0
2022-11-30,214,118,96,0,118,0,0,0.0
2022-12-01,218,110,108,0,110,0,0,0.0
2022-12-02,146,51,95,0,51,0,0,0.0
2022-12-04,2,0,2,0,0,0,0,0.0
2022-12-05,210,148,62,0,148,0,0,0.0
2022-12-06,250,145,105,0,145,0,0,0.0
2022-12-07,213,108,105,0,108,0,0,0.0
2022-12-08,139,34,105,0,34,0,0,0.0
2022-12-09,154,58,96,0,58,0,0,0.0
2022-12-11,16,0,16,0,0,0,0,0.0
2022-12-12,201,104,97,0,104,0,0,0.0
2022-12-13,160,72,88,0,72,0,0,0.0
2022-12-14,187,110,77,0,110,0,0,0.0
2022-12-15,247,143,104,0,143,0,0,0.0
2022-12-16,203,107,96,0,107,0,0,0.0
2022-12-18,12,0,12,0,0,0,0,0.0
2022-12-19,165,133,32,0,133,0,0,0.0
2022-12-20,228,120,108,0,120,0,0,0.0
2022-12-21,233,137,96,0,137,0,0,0.0
2022-12-22,173,71,102,0,71,0,0,0.0
2022-12-23,105,15,90,0,15,0,0,0.0
2022-12-25,11,0,11,0,0,0,0,0.0
2022-12-26,256,148,108,0,148,0,0,0.0
2022-12-27,178,96,82,0,96,0,0,0.0
2022-12-28,232,122,110,0,122,0,0,0.0
2022-12-29,225,116,109,0,116,0,0,0.0
2022-12-30,191,95,96,0,95,0,0,0.0
2023-01-01,8,0,8,0,0,0,0,0.0
2023-01-02,153,114,39,0,114,0,0,0.0
2023-01-03,166,57,109,0,57,0,0,0.0
2023-01-04,257,146,111,0,146,0,0,0.0
2023-01-05,142,40,102,0,40,0,0,0.0
2023-01-06,216,120,96,0,120,0,0,0.0
2023-01-08,14,0,14,0,0,0,0,0.0
2023-01-09,205,107,98,0,107,0,0,0.0
2023-01-10,162,90,72,0,90,0,0,0.0
2023-01-11,211,109,102,0,109,0,0,0.0
2023-01-12,217,110,107,0,110,0,0,0.0
2023-01-13,207,125,82,0,125,0,0,0.0
2023-01-15,13,0,13,0,0,0,0,0.0
2023-01-16,153,44,109,0,44,0,0,0.0
2023-01-17,225,114,111,0,114,0,0,0.0
2023-01-18,163,62,101,0,62,0,0,0.0
2023-01-19,163,64,99,0,64,0,0,0.0
2023-01-20,239,143,96,0,143,0,0,0.0
2023-01-22,12,0,12,0,0,0,0,0.0
2023-01-23,239,132,107,0,132,0,0,0.0
2023-01-24,254,145,109,0,145,0,0,0.0
2023-01-25,244,134,110,0,134,0,0,0.0
2023-01-26,184,74,110,0,74,0,0,0.0
2023-01-27,124,28,96,0,28,0,0,0.0
2023-01-29,4,0,4,0,0,0,0,0.0
2023-01-30,226,121,105,0,121,0,0,0.0
2023-01-31,166,58,108,0,58,0,0,0.0
2023-02-01,253,145,108,0,145,0,0,0.0
2023-02-02,207,99,108,0,99,0,0,0.0
2023-02-03,229,140,89,0,140,0,0,0.0
2023-02-05,4,0,4,0,0,0,0,0.0
2023-02-06,148,132,16,0,132,0,0,0.0
2023-02-07,198,106,92,0,106,0,0,0.0
2023-02-08,192,101,91,0,101,0,0,0.0
2023-02-09,223,128,95,0,128,0,0,0.0
2023-02-10,182,91,91,1,90,1,0,-16.978571428572764
2023-02-12,12,0,12,0,0,0,0,0.0
2023-02-13,192,88,104,0,88,0,0,0.0
2023-02-14,211,108,103,0,108,0,0,0.0
2023-02-15,206,102,104,0,102,0,0,0.0
2023-02-16,180,75,105,0,75,0,0,0.0
2023-02-17,221,125,96,0,125,0,0,0.0
2023-02-19,12,0,12,0,0,0,0,0.0
2023-02-20,172,74,98,0,74,0,0,0.0
2023-02-21,189,83,106,0,83,0,0,0.0
2023-02-22,223,121,102,0,121,0,0,0.0
2023-02-23,211,113,98,0,113,0,0,0.0
2023-02-24,220,147,73,0,147,0,0,0.0
2023-02-26,11,0,11,0,0,0,0,0.0
2023-02-27,164,68,96,0,68,0,0,0.0
2023-02-28,182,93,89,0,93,0,0,0.0
2023-03-01,256,144,112,0,144,0,0,0.0
2023-03-02,135,38,97,0,38,0,0,0.0
2023-03-03,172,115,57,0,115,0,0,0.0
2023-03-05,15,0,15,0,0,0,0,0.0
2023-03-06,197,86,111,0,86,0,0,0.0
2023-03-07,248,140,108,0,140,0,0,0.0
2023-03-08,178,72,106,0,72,0,0,0.0
2023-03-09,157,46,111,0,46,0,0,0.0
2023-03-10,241,145,96,0,145,0,0,0.0
2023-03-12,16,12,4,0,12,0,0,0.0
2023-03-13,169,147,22,0,147,0,0,0.0
2023-03-14,122,15,107,0,15,0,0,0.0
2023-03-15,207,103,104,0,103,0,0,0.0
2023-03-16,202,95,107,0,95,0,0,0.0
2023-03-17,190,94,96,0,94,0,0,0.0
2023-03-19,19,12,7,0,12,0,0,0.0
2023-03-20,132,77,55,0,77,0,0,0.0
2023-03-21,226,130,96,0,130,0,0,0.0
2023-03-22,197,108,89,0,108,0,0,0.0
2023-03-23,241,133,108,0,133,0,0,0.0
2023-03-24,210,115,95,0,115,0,0,0.0
2023-03-26,15,12,3,0,12,0,0,0.0
2023-03-27,168,109,59,0,109,0,0,0.0
2023-03-28,210,100,110,0,100,0,0,0.0
2023-03-29,231,124,107,0,124,0,0,0.0
2023-03-30,198,100,98,0,100,0,0,0.0
2023-03-31,185,89,96,0,89,0,0,0.0
2023-04-02,13,12,1,0,12,0,0,0.0
2023-04-03,244,146,98,0,146,0,0,0.0
2023-04-04,246,143,103,0,143,0,0,0.0
2023-04-05,203,107,96,0,107,0,0,0.0
2023-04-06,152,72,80,0,72,0,0,0.0
2023-04-07,118,56,62,0,56,0,0,0.0
2023-04-09,4,0,4,0,0,0,0,0.0
2023-04-10,240,140,100,0,140,0,0,0.0
2023-04-11,229,121,108,0,121,0,0,0.0
2023-04-12,229,133,96,0,133,0,0,0.0
2023-04-13,153,105,48,0,105,0,0,0.0
2023-04-14,232,139,93,0,139,0,0,0.0
2023-04-16,26,10,16,0,10,0,0,0.0
2023-04-17,206,124,82,0,124,0,0,0.0
2023-04-18,225,141,84,0,141,0,0,0.0
2023-04-19,221,128,93,0,128,0,0,0.0
2023-04-20,165,88,77,0,88,0,0,0.0
2023-04-21,233,138,95,0,138,0,0,0.0
2023-04-23,26,12,14,0,12,0,0,0.0
2023-04-24,226,137,89,0,137,0,0,0.0
2023-04-25,185,98,87,0,98,0,0,0.0
2023-04-26,201,94,107,0,94,0,0,0.0
2023-04-27,119,41,78,0,41,0,0,0.0
2023-04-28,219,131,88,0,131,0,0,0.0
2023-04-30,23,12,11,0,12,0,0,0.0
2023-05-01,240,133,107,0,133,0,0,0.0
2023-05-02,221,117,104,0,117,0,0,0.0
2023-05-03,188,95,93,0,95,0,0,0.0
2023-05-04,176,141,35,0,141,0,0,0.0
2023-05-05,162,66,96,0,66,0,0,0.0
2023-05-07,15,0,15,0,0,0,0,0.0
2023-05-08,205,124,81,0,124,0,0,0.0
2023-05-09,175,82,93,0,82,0,0,0.0
2023-05-10,166,68,98,0,68,0,0,0.0
2023-05-11,229,137,92,0,137,0,0,0.0
2023-05-12,187,116,71,0,116,0,0,0.0
2023-05-14,18,12,6,0,12,0,0,0.0
2023-05-15,159,63,96,0,63,0,0,0.0
2023-05-16,234,126,108,0,126,0,0,0.0
2023-05-17,224,127,97,0,127,0,0,0.0
2023-05-18,200,116,84,0,116,0,0,0.0
2023-05-19,214,118,96,0,118,0,0,0.0
2023-05-21,21,12,9,0,12,0,0,0.0
2023-05-22,181,120,61,0,120,0,0,0.0
2023-05-23,130,29,101,0,29,0,0,0.0
2023-05-24,226,132,94,0,132,0,0,0.0
2023-05-25,218,129,89,0,129,0,0,0.0
2023-05-26,200,111,89,0,111,0,0,0.0
2023-05-28,14,12,2,0,12,0,0,0.0
2023-05-29,240,150,90,0,150,0,0,0.0
2023-05-30,140,59,81,0,59,0,0,0.0
2023-05-31,199,112,87,0,112,0,0,0.0
2023-06-01,223,133,90,0,133,0,0,0.0
2023-06-02,216,132,84,0,132,0,0,0.0
2023-06-04,24,12,12,0,12,0,0,0.0
2023-06-05,196,106,90,0,106,0,0,0.0
2023-06-06,156,84,72,0,84,0,0,0.0
2023-06-07,255,147,108,0,147,0,0,0.0
2023-06-08,238,129,109,0,129,0,0,0.0
2023-06-09,178,82,96,0,82,0,0,0.0
2023-06-11,11,2,9,0,2,0,0,0.0
2023-06-12,221,139,82,0,139,0,0,0.0
2023-06-13,212,118,94,0,118,0,0,0.0
2023-06-14,215,122,93,0,122,0,0,0.0
2023-06-15,242,133,109,0,133,0,0,0.0
2023-06-16,224,130,94,0,130,0,0,0.0
2023-06-18,20,12,8,0,12,0,0,0.0
2023-06-19,197,132,65,0,132,0,0,0.0
2023-06-20,189,86,103,0,86,0,0,0.0
2023-06-21,233,120,113,0,120,0,0,0.0
2023-06-22,206,133,73,0,133,0,0,0.0
2023-06-23,227,137,90,0,137,0,0,0.0
2023-06-25,24,11,13,0,11,0,0,0.0
2023-06-26,205,98,107,0,98,0,0,0.0
2023-06-27,227,129,98,0,129,0,0,0.0
2023-06-28,162,67,95,0,67,0,0,0.0
2023-06-29,130,48,82,0,48,0,0,0.0
2023-06-30,197,114,83,0,114,0,0,0.0
2023-07-02,24,12,12,0,12,0,0,0.0
2023-07-03,224,126,98,0,126,0,0,0.0
2023-07-04,223,134,89,0,134,0,0,0.0
2023-07-05,226,117,109,0,117,0,0,0.0
2023-07-06,182,73,109,0,73,0,0,0.0
2023-07-07,210,118,92,0,118,0,0,0.0
2023-07-09,10,10,0,0,10,0,0,0.0
2023-07-10,222,124,98,0,124,0,0,0.0
2023-07-11,202,94,108,0,94,0,0,0.0
2023-07-12,221,121,100,0,121,0,0,0.0
2023-07-13,225,124,101,0,124,0,0,0.0
2023-07-14,187,92,95,0,92,0,0,0.0
2023-07-16,14,11,3,0,11,0,0,0.0
2023-07-17,208,103,105,0,103,0,0,0.0
2023-07-18,233,125,108,0,125,0,0,0.0
2023-07-19,208,100,108,0,100,0,0,0.0
2023-07-20,227,120,107,0,120,0,0,0.0
2023-07-21,188,95,93,0,95,0,0,0.0
2023-07-23,22,12,10,0,12,0,0,0.0
2023-07-24,251,144,107,0,144,0,0,0.0
2023-07-25,182,112,70,0,112,0,0,0.0
2023-07-26,209,102,107,0,102,0,0,0.0
2023-07-27,233,139,94,0,139,0,0,0.0
2023-07-28,167,118,49,0,118,0,0,0.0
2023-07-30,25,12,13,0,12,0,0,0.0
2023-07-31,183,80,103,0,80,0,0,0.0
2023-08-01,207,111,96,0,111,0,0,0.0
2023-08-02,189,104,85,0,104,0,0,0.0
2023-08-03,193,95,98,0,95,0,0,0.0
2023-08-04,132,53,79,0,53,0,0,0.0
2023-08-06,14,0,14,0,0,0,0,0.0
2023-08-07,226,122,104,0,122,0,0,0.0
2023-08-08,216,103,113,0,103,0,0,0.0
2023-08-09,230,132,98,0,132,0,0,0.0
2023-08-10,229,120,109,0,120,0,0,0.0
2023-08-11,152,94,58,0,94,0,0,0.0
2023-08-13,19,11,8,0,11,0,0,0.0
2023-08-14,167,120,47,0,120,0,0,0.0
2023-08-15,158,73,85,0,73,0,0,0.0
2023-08-16,207,106,101,0,106,0,0,0.0
2023-08-17,243,131,112,0,131,0,0,0.0
2023-08-18,203,107,96,0,107,0,0,0.0
2023-08-20,15,12,3,0,12,0,0,0.0
2023-08-21,173,119,54,0,119,0,0,0.0
2023-08-22,236,136,100,0,136,0,0,0.0
2023-08-23,242,133,109,0,133,0,0,0.0
2023-08-24,186,78,108,0,78,0,0,0.0
2023-08-25,216,121,95,0,121,0,0,0.0
2023-08-27,27,12,15,0,12,0,0,0.0
2023-08-28,112,18,94,0,18,0,0,0.0
2023-08-29,238,150,88,0,150,0,0,0.0
2023-08-30,215,109,106,0,109,0,0,0.0
2023-08-31,215,120,95,0,120,0,0,0.0
2023-09-01,184,111,73,0,111,0,0,0.0
2023-09-03,25,12,13,0,12,0,0,0.0
2023-09-04,172,90,82,0,90,0,0,0.0
2023-09-05,264,153,111,0,153,0,0,0.0
2023-09-06,244,135,109,0,135,0,0,0.0
2023-09-07,141,47,94,0,47,0,0,0.0
2023-09-08,205,114,91,0,114,0,0,0.0
2023-09-10,12,12,0,0,12,0,0,0.0
2023-09-11,144,68,76,0,68,0,0,0.0
2023-09-12,185,82,103,0,82,0,0,0.0
2023-09-13,154,49,105,0,49,0,0,0.0
2023-09-14,184,84,100,0,84,0,0,0.0
2023-09-15,127,54,73,0,54,0,0,0.0
2023-09-17,29,12,17,0,12,0,0,0.0
2023-09-18,221,121,100,0,121,0,0,0.0
2023-09-19,214,109,105,0,109,0,0,0.0
2023-09-20,253,153,100,0,153,0,0,0.0
2023-09-21,234,137,97,0,137,0,0,0.0
2023-09-22,193,97,96,0,97,0,0,0.0
2023-09-24,18,5,13,0,5,0,0,0.0
2023-09-25,190,130,60,0,130,0,0,0.0
2023-09-26,181,83,98,0,83,0,0,0.0
2023-09-27,210,151,59,0,151,0,0,0.0
2023-09-28,163,61,102,0,61,0,0,0.0
2023-09-29,230,134,96,0,134,0,0,0.0
2023-10-01,27,12,15,0,12,0,0,0.0
2023-10-02,224,118,106,0,118,0,0,0.0
2023-10-03,253,134,119,0,134,0,0,0.0
2023-10-04,210,110,100,0,110,0,0,0.0
2023-10-05,239,132,107,0,132,0,0,0.0
2023-10-06,166,70,96,0,70,0,0,0.0
2023-10-08,16,12,4,0,12,0,0,0.0
2023-10-09,147,136,11,0,136,0,0,0.0
2023-10-10,224,121,103,0,121,0,0,0.0
2023-10-11,211,111,100,0,111,0,0,0.0
2023-10-12,205,114,91,0,114,0,0,0.0
2023-10-13,163,73,90,0,73,0,0,0.0
2023-10-15,25,11,14,0,11,0,0,0.0
2023-10-16,93,47,46,0,47,0,0,0.0
2023-10-17,134,76,58,0,76,0,0,0.0
2023-10-18,241,137,104,0,137,0,0,0.0
2023-10-19,158,89,69,0,89,0,0,0.0
2023-10-20,179,83,96,0,83,0,0,0.0
2023-10-22,14,12,2,0,12,0,0,0.0
2023-10-23,231,148,83,0,148,0,0,0.0
2023-10-24,212,127,85,0,127,0,0,0.0
2023-10-25,197,129,68,0,129,0,0,0.0
2023-10-26,226,129,97,0,129,0,0,0.0
2023-10-27,186,94,92,0,94,0,0,0.0
2023-10-29,28,12,16,0,12,0,0,0.0
2023-10-30,205,136,69,0,136,0,0,0.0
2023-10-31,256,145,111,0,145,0,0,0.0
2023-11-01,257,144,113,0,144,0,0,0.0
2023-11-02,247,145,102,0,145,0,0,0.0
2023-11-03,151,69,82,0,69,0,0,0.0
2023-11-05,12,0,12,0,0,0,0,0.0
2023-11-06,178,72,106,0,72,0,0,0.0
2023-11-07,168,79,89,0,79,0,0,0.0
2023-11-08,214,120,94,0,120,0,0,0.0
2023-11-09,149,107,42,0,107,0,0,0.0
2023-11-10,223,148,75,0,148,0,0,0.0
2023-11-12,17,0,17,0,0,0,0,0.0
2023-11-13,214,117,97,0,117,0,0,0.0
2023-11-14,199,133,66,0,133,0,0,0.0
2023-11-15,251,154,97,0,154,0,0,0.0
2023-11-16,199,152,47,0,152,0,0,0.0
2023-11-17,179,154,25,0,154,0,0,0.0
2023-11-19,17,0,17,0,0,0,0,0.0
2023-11-20,179,81,98,0,81,0,0,0.0
2023-11-21,242,133,109,0,133,0,0,0.0
2023-11-22,224,131,93,0,131,0,0,0.0
2023-11-23,207,99,108,0,99,0,0,0.0
2023-11-24,175,101,74,0,101,0,0,0.0
2023-11-26,12,0,12,0,0,0,0,0.0
2023-11-27,209,103,106,0,103,0,0,0.0
2023-11-28,223,115,108,0,115,0,0,0.0
2023-11-29,215,104,111,0,104,0,0,0.0
2023-11-30,236,149,87,0,149,0,0,0.0
2023-12-01,211,115,96,0,115,0,0,0.0
2023-12-03,13,0,13,0,0,0,0,0.0
2023-12-04,246,147,99,0,147,0,0,0.0
2023-12-05,227,145,82,0,145,0,0,0.0
2023-12-06,192,99,93,0,99,0,0,0.0
2023-12-07,255,148,107,0,148,0,0,0.0
2023-12-08,145,61,84,0,61,0,0,0.0
2023-12-10,6,0,6,0,0,0,0,0.0
2023-12-11,173,65,108,0,65,0,0,0.0
2023-12-12,208,99,109,0,99,0,0,0.0
2023-12-13,215,124,91,0,124,0,0,0.0
2023-12-14,151,50,101,0,50,0,0,0.0
2023-12-15,146,53,93,0,53,0,0,0.0
2023-12-17,16,0,16,0,0,0,0,0.0
2023-12-18,238,130,108,0,130,0,0,0.0
2023-12-19,230,118,112,0,118,0,0,0.0
2023-12-20,224,131,93,0,131,0,0,0.0
2023-12-21,215,123,92,0,123,0,0,0.0
2023-12-22,211,121,90,0,121,0,0,0.0
2023-12-24,0,0,0,0,0,0,0,0.0
2023-12-25,84,0,84,0,0,0,0,0.0
2023-12-26,193,121,72,0,121,0,0,0.0
2023-12-27,195,93,102,0,93,0,0,0.0
2023-12-28,220,114,106,0,114,0,0,0.0
2023-12-29,225,143,82,0,143,0,0,0.0
2024-01-01,8,0,8,0,0,0,0,0.0
2024-01-02,200,90,110,0,90,0,0,0.0
2024-01-03,227,142,85,0,142,0,0,0.0
2024-01-04,257,149,108,0,149,0,0,0.0
2024-01-05,230,134,96,0,134,0,0,0.0
2024-01-07,12,0,12,0,0,0,0,0.0
2024-01-08,179,115,64,0,115,0,0,0.0
2024-01-09,239,129,110,0,129,0,0,0.0
2024-01-10,234,132,102,0,132,0,0,0.0
2024-01-11,140,33,107,0,33,0,0,0.0
2024-01-12,161,66,95,0,66,0,0,0.0
2024-01-14,16,0,16,0,0,0,0,0.0
2024-01-15,219,110,109,0,110,0,0,0.0
2024-01-16,239,128,111,0,128,0,0,0.0
2024-01-17,218,122,96,0,122,0,0,0.0
2024-01-18,155,60,95,0,60,0,0,0.0
2024-01-19,219,124,95,0,124,0,0,0.0
2024-01-21,1,0,1,0,0,0,0,0.0
2024-01-22,187,118,69,0,118,0,0,0.0
2024-01-23,228,138,90,0,138,0,0,0.0
2024-01-24,202,95,107,0,95,0,0,0.0
2024-01-25,177,69,108,0,69,0,0,0.0
2024-01-26,198,128,70,0,128,0,0,0.0
2024-01-28,15,0,15,0,0,0,0,0.0
2024-01-29,207,98,109,0,98,0,0,0.0
2024-01-30,203,100,103,0,100,0,0,0.0
2024-01-31,255,150,105,0,150,0,0,0.0
2024-02-01,221,123,98,0,123,0,0,0.0
2024-02-02,166,143,23,0,143,0,0,0.0
2024-02-04,12,0,12,0,0,0,0,0.0
2024-02-05,146,86,60,0,86,0,0,0.0
2024-02-06,248,140,108,0,140,0,0,0.0
2024-02-07,166,76,90,0,76,0,0,0.0
2024-02-08,139,40,99,0,40,0,0,0.0
2024-02-09,108,21,87,0,21,0,0,0.0
2024-02-11,12,0,12,0,0,0,0,0.0
2024-02-12,209,124,85,0,124,0,0,0.0
2024-02-13,243,137,106,0,137,0,0,0.0
2024-02-14,213,108,105,0,108,0,0,0.0
2024-02-15,150,46,104,0,46,0,0,0.0
2024-02-16,186,90,96,0,90,0,0,0.0
2024-02-18,3,0,3,0,0,0,0,0.0
2024-02-19,208,102,106,0,102,0,0,0.0
2024-02-20,244,139,105,0,139,0,0,0.0
2024-02-21,233,143,90,0,143,0,0,0.0
2024-02-22,143,49,94,0,49,0,0,0.0
2024-02-23,167,94,73,0,94,0,0,0.0
2024-02-25,11,0,11,0,0,0,0,0.0
2024-02-26,173,149,24,0,149,0,0,0.0
2024-02-27,222,119,103,0,119,0,0,0.0
2024-02-28,169,75,94,0,75,0,0,0.0
2024-02-29,180,75,105,0,75,0,0,0.0
2024-03-01,227,131,96,0,131,0,0,0.0
2024-03-03,15,0,15,0,0,0,0,0.0
2024-03-04,154,52,102,0,52,0,0,0.0
2024-03-05,176,99,77,0,99,0,0,0.0
2024-03-06,204,103,101,0,103,0,0,0.0
2024-03-07,213,112,101,0,112,0,0,0.0
2024-03-08,108,52,56,0,52,0,0,0.0
2024-03-10,12,0,12,0,0,0,0,0.0
2024-03-11,194,122,72,0,122,0,0,0.0
2024-03-12,129,30,99,0,30,0,0,0.0
2024-03-13,231,135,96,0,135,0,0,0.0
2024-03-14,237,131,106,0,131,0,0,0.0
2024-03-15,174,81,93,0,81,0,0,0.0
2024-03-17,12,11,1,0,11,0,0,0.0
2024-03-18,200,104,96,0,104,0,0,0.0
2024-03-19,248,140,108,0,140,0,0,0.0
2024-03-20,257,145,112,0,145,0,0,0.0
2024-03-21,231,132,99,0,132,0,0,0.0
2024-03-22,212,120,92,0,120,0,0,0.0
2024-03-24,24,11,13,0,11,0,0,0.0
2024-03-25,215,121,94,0,121,0,0,0.0
2024-03-26,213,119,94,0,119,0,0,0.0
2024-03-27,222,123,99,0,123,0,0,0.0
2024-03-28,143,92,51,0,92,0,0,0.0
2024-03-29,176,92,84,0,92,0,0,0.0
2024-03-31,22,5,17,0,5,0,0,0.0
2024-04-01,237,145,92,0,145,0,0,0.0
2024-04-02,176,77,99,0,77,0,0,0.0
2024-04-03,229,148,81,0,148,0,0,0.0
2024-04-04,173,88,85,0,88,0,0,0.0
2024-04-05,156,90,66,0,90,0,0,0.0
2024-04-07,12,12,0,0,12,0,0,0.0
2024-04-08,193,93,100,0,93,0,0,0.0
2024-04-09,200,103,97,0,103,0,0,0.0
2024-04-10,199,131,68,0,131,0,0,0.0
2024-04-11,216,134,82,0,134,0,0,0.0
2024-04-12,186,116,70,0,116,0,0,0.0
2024-04-14,10,0,10,0,0,0,0,0.0
2024-04-15,122,24,98,0,24,0,0,0.0
2024-04-16,138,40,98,0,40,0,0,0.0
2024-04-17,191,107,84,0,107,0,0,0.0
2024-04-18,216,144,72,0,144,0,0,0.0
2024-04-19,159,74,85,0,74,0,0,0.0
2024-04-21,7,7,0,0,7,0,0,0.0
2024-04-22,199,140,59,0,140,0,0,0.0
2024-04-23,201,106,95,0,106,0,0,0.0
2024-04-24,230,135,95,0,135,0,0,0.0
2024-04-25,143,42,101,0,42,0,0,0.0
2024-04-26,204,120,84,0,120,0,0,0.0
2024-04-28,12,12,0,0,12,0,0,0.0
2024-04-29,202,113,89,0,113,0,0,0.0
2024-04-30,205,109,96,0,109,0,0,0.0
2024-05-01,192,83,109,0,83,0,0,0.0
2024-05-02,258,150,108,0,150,0,0,0.0
2024-05-03,229,133,96,0,133,0,0,0.0
2024-05-05,29,12,17,0,12,0,0,0.0
2024-05-06,230,118,112,0,118,0,0,0.0
2024-05-07,249,137,112,0,137,0,0,0.0
2024-05-08,183,74,109,0,74,0,0,0.0
2024-05-09,224,139,85,0,139,0,0,0.0
2024-05-10,172,77,95,0,77,0,0,0.0
2024-05-12,17,1,16,0,1,0,0,0.0
2024-05-13,207,109,98,0,109,0,0,0.0
2024-05-14,130,28,102,0,28,0,0,0.0
2024-05-15,210,120,90,0,120,0,0,0.0
2024-05-16,157,58,99,0,58,0,0,0.0
2024-05-17,186,93,93,0,93,0,0,0.0
2024-05-19,22,12,10,0,12,0,0,0.0
2024-05-20,181,93,88,0,93,0,0,0.0
2024-05-21,179,72,107,0,72,0,0,0.0
2024-05-22,181,84,97,0,84,0,0,0.0
2024-05-23,195,147,48,0,147,0,0,0.0
2024-05-24,227,133,94,0,133,0,0,0.0
2024-05-26,12,12,0,0,12,0,0,0.0
2024-05-27,182,115,67,0,115,0,0,0.0
2024-05-28,235,139,96,0,139,0,0,0.0
2024-05-29,233,137,96,0,137,0,0,0.0
2024-05-30,225,119,106,0,119,0,0,0.0
2024-05-31,195,118,77,0,118,0,0,0.0
2024-06-02,17,12,5,0,12,0,0,0.0
2024-06-03,208,142,66,0,142,0,0,0.0
2024-06-04,243,138,105,0,138,0,0,0.0
2024-06-05,168,58,110,0,58,0,0,0.0
2024-06-06,229,125,104,0,125,0,0,0.0
2024-06-07,163,68,95,0,68,0,0,0.0
2024-06-09,2,2,0,0,2,0,0,0.0
2024-06-10,190,95,95,0,95,0,0,0.0
2024-06-11,221,110,111,0,110,0,0,0.0
2024-06-12,228,116,112,0,116,0,0,0.0
2024-06-13,200,88,112,0,88,0,0,0.0
2024-06-14,156,60,96,0,60,0,0,0.0
2024-06-16,15,5,10,0,5,0,0,0.0
2024-06-17,121,105,16,0,105,0,0,0.0
2024-06-18,125,41,84,0,41,0,0,0.0
2024-06-19,206,140,66,0,140,0,0,0.0
2024-06-20,208,108,100,0,108,0,0,0.0
2024-06-21,218,138,80,0,138,0,0,0.0
2024-06-23,22,12,10,0,12,0,0,0.0
2024-06-24,187,144,43,0,144,0,0,0.0
2024-06-25,175,71,104,0,71,0,0,0.0
2024-06-26,241,135,106,0,135,0,0,0.0
2024-06-27,251,148,103,0,148,0,0,0.0
2024-06-28,226,133,93,0,133,0,0,0.0
2024-06-30,19,12,7,0,12,0,0,0.0
2024-07-01,200,126,74,0,126,0,0,0.0
2024-07-02,181,71,110,0,71,0,0,0.0
2024-07-03,211,105,106,0,105,0,0,0.0
2024-07-04,197,94,103,0,94,0,0,0.0
2024-07-05,172,76,96,0,76,0,0,0.0
2024-07-07,15,10,5,0,10,0,0,0.0
2024-07-08,178,74,104,0,74,0,0,0.0
2024-07-09,248,136,112,0,136,0,0,0.0
2024-07-10,225,123,102,0,123,0,0,0.0
2024-07-11,146,44,102,0,44,0,0,0.0
2024-07-12,65,25,40,0,25,0,0,0.0
2024-07-14,16,0,16,0,0,0,0,0.0
2024-07-15,162,106,56,0,106,0,0,0.0
2024-07-16,225,128,97,0,128,0,0,0.0
2024-07-17,145,49,96,0,49,0,0,0.0
2024-07-18,202,112,90,0,112,0,0,0.0
2024-07-19,182,87,95,0,87,0,0,0.0
2024-07-21,27,12,15,0,12,0,0,0.0
2024-07-22,191,123,68,0,123,0,0,0.0
2024-07-23,212,101,111,0,101,0,0,0.0
2024-07-24,203,102,101,0,102,0,0,0.0
2024-07-25,157,47,110,0,47,0,0,0.0
2024-07-26,134,38,96,0,38,0,0,0.0
2024-07-28,20,4,16,0,4,0,0,0.0
2024-07-29,129,20,109,0,20,0,0,0.0
2024-07-30,205,104,101,0,104,0,0,0.0
2024-07-31,169,92,77,0,92,0,0,0.0
2024-08-01,224,134,90,0,134,0,0,0.0
2024-08-02,173,105,68,0,105,0,0,0.0
2024-08-04,18,12,6,0,12,0,0,0.0
2024-08-05,249,136,113,0,136,0,0,0.0
2024-08-06,178,80,98,0,80,0,0,0.0
2024-08-07,246,140,106,0,140,0,0,0.0
2024-08-08,140,52,88,0,52,0,0,0.0
2024-08-09,127,38,89,0,38,0,0,0.0
2024-08-11,20,7,13,0,7,0,0,0.0
2024-08-12,173,108,65,0,108,0,0,0.0
2024-08-13,202,99,103,0,99,0,0,0.0
2024-08-14,201,94,107,0,94,0,0,0.0
2024-08-15,120,33,87,0,33,0,0,0.0
2024-08-16,181,97,84,0,97,0,0,0.0
2024-08-18,22,12,10,0,12,0,0,0.0
2024-08-19,173,74,99,0,74,0,0,0.0
2024-08-20,210,101,109,0,101,0,0,0.0
2024-08-21,230,126,104,0,126,0,0,0.0
2024-08-22,242,142,100,0,142,0,0,0.0
2024-08-23,234,139,95,0,139,0,0,0.0
2024-08-25,27,12,15,0,12,0,0,0.0
2024-08-26,239,142,97,0,142,0,0,0.0
2024-08-27,241,143,98,0,143,0,0,0.0
2024-08-28,217,113,104,0,113,0,0,0.0
2024-08-29,197,103,94,0,103,0,0,0.0
2024-08-30,207,130,77,0,130,0,0,0.0
2024-09-01,28,11,17,0,11,0,0,0.0
2024-09-02,166,104,62,0,104,0,0,0.0
2024-09-03,160,53,107,0,53,0,0,0.0
2024-09-04,182,113,69,0,113,0,0,0.0
2024-09-05,235,142,93,0,142,0,0,0.0
2024-09-06,226,130,96,0,130,0,0,0.0
2024-09-08,22,12,10,0,12,0,0,0.0
2024-09-09,210,104,106,0,104,0,0,0.0
2024-09-10,247,148,99,0,148,0,0,0.0
2024-09-11,181,69,112,0,69,0,0,0.0
2024-09-12,200,92,108,0,92,0,0,0.0
2024-09-13,167,71,96,0,71,0,0,0.0
2024-09-15,21,10,11,0,10,0,0,0.0
2024-09-16,213,134,79,0,134,0,0,0.0
2024-09-17,210,116,94,0,116,0,0,0.0
2024-09-18,221,108,113,0,108,0,0,0.0
2024-09-19,241,132,109,0,132,0,0,0.0
2024-09-20,169,74,95,0,74,0,0,0.0
2024-09-22,2,0,2,0,0,0,0,0.0
2024-09-23,215,118,97,0,118,0,0,0.0
2024-09-24,244,145,99,0,145,0,0,0.0
2024-09-25,240,138,102,0,138,0,0,0.0
2024-09-26,234,127,107,0,127,0,0,0.0
2024-09-27,169,73,96,0,73,0,0,0.0
2024-09-29,23,9,14,0,9,0,0,0.0
2024-09-30,216,145,71,0,145,0,0,0.0
2024-10-01,139,31,108,0,31,0,0,0.0
2024-10-02,243,148,95,0,148,0,0,0.0
2024-10-03,146,112,34,0,112,0,0,0.0
2024-10-04,194,100,94,0,100,0,0,0.0
2024-10-06,1,1,0,0,1,0,0,0.0
2024-10-07,143,42,101,0,42,0,0,0.0
2024-10-08,194,119,75,0,119,0,0,0.0
2024-10-09,214,126,88,0,126,0,0,0.0
2024-10-10,150,75,75,0,75,0,0,0.0
2024-10-11,165,73,92,0,73,0,0,0.0
2024-10-13,16,3,13,0,3,0,0,0.0
2024-10-14,137,91,46,0,91,0,0,0.0
2024-10-15,209,100,109,0,100,0,0,0.0
2024-10-16,217,126,91,0,126,0,0,0.0
2024-10-17,242,145,97,0,145,0,0,0.0
2024-10-18,205,109,96,0,109,0,0,0.0
2024-10-20,18,12,6,0,12,0,0,0.0
2024-10-21,238,133,105,0,133,0,0,0.0
2024-10-22,213,110,103,0,110,0,0,0.0
2024-10-23,222,119,103,0,119,0,0,0.0
2024-10-24,234,126,108,0,126,0,0,0.0
2024-10-25,172,82,90,0,82,0,0,0.0
2024-10-27,12,12,0,0,12,0,0,0.0
2024-10-28,249,149,100,0,149,0,0,0.0
2024-10-29,248,146,102,0,146,0,0,0.0
2024-10-30,117,80,37,0,80,0,0,0.0
2024-10-31,250,142,108,0,142,0,0,0.0
2024-11-01,217,126,91,0,126,0,0,0.0
2024-11-03,4,0,4,0,0,0,0,0.0
2024-11-04,221,112,109,0,112,0,0,0.0
2024-11-05,252,141,111,0,141,0,0,0.0
2024-11-06,215,107,108,0,107,0,0,0.0
2024-11-07,220,115,105,0,115,0,0,0.0
2024-11-08,149,67,82,0,67,0,0,0.0
2024-11-10,12,0,12,0,0,0,0,0.0
2024-11-11,153,40,113,0,40,0,0,0.0
2024-11-12,250,149,101,0,149,0,0,0.0
2024-11-13,236,137,99,0,137,0,0,0.0
2024-11-14,214,101,113,0,101,0,0,0.0
2024-11-15,215,119,96,0,119,0,0,0.0
2024-11-17,14,0,14,0,0,0,0,0.0
2024-11-18,239,144,95,0,144,0,0,0.0
2024-11-19,218,111,107,0,111,0,0,0.0
2024-11-20,239,131,108,0,131,0,0,0.0
2024-11-21,173,65,108,0,65,0,0,0.0
2024-11-22,209,131,78,0,131,0,0,0.0
2024-11-24,3,0,3,0,0,0,0,0.0
2024-11-25,179,95,84,0,95,0,0,0.0
2024-11-26,187,82,105,0,82,0,0,0.0
2024-11-27,235,126,109,0,126,0,0,0.0
2024-11-28,246,137,109,0,137,0,0,0.0
2024-11-29,196,100,96,0,100,0,0,0.0
2024-12-01,14,0,14,0,0,0,0,0.0
2024-12-02,244,133,111,0,133,0,0,0.0
2024-12-03,197,86,111,0,86,0,0,0.0
2024-12-04,247,137,110,0,137,0,0,0.0
2024-12-05,239,126,113,0,126,0,0,0.0
2024-12-06,193,112,81,0,112,0,0,0.0
2024-12-08,0,0,0,0,0,0,0,0.0
2024-12-09,151,101,50,0,101,0,0,0.0
2024-12-10,183,97,86,0,97,0,0,0.0
2024-12-11,170,70,100,0,70,0,0,0.0
2024-12-12,161,79,82,0,79,0,0,0.0
2024-12-13,245,149,96,0,149,0,0,0.0
2024-12-15,15,0,15,0,0,0,0,0.0
2024-12-16,234,141,93,0,141,0,0,0.0
2024-12-17,238,149,89,0,149,0,0,0.0
2024-12-18,206,131,75,0,131,0,0,0.0
2024-12-19,224,111,113,0,111,0,0,0.0
2024-12-20,194,99,95,0,99,0,0,0.0
2024-12-22,13,0,13,0,0,0,0,0.0
2024-12-23,164,70,94,0,70,0,0,0.0
2024-12-24,165,107,58,0,107,0,0,0.0
2024-12-25,109,0,109,0,0,0,0,0.0
2024-12-26,260,151,109,0,151,0,0,0.0
2024-12-27,202,106,96,0,106,0,0,0.0
2024-12-29,12,0,12,0,0,0,0,0.0
2024-12-30,243,140,103,0,140,0,0,0.0
2024-12-31,239,145,94,0,145,0,0,0.0
